Municipio,AÃ±o,Mes,Departamento,Estrato 1,Estrato 2,Estrato 3,Estrato 4,Estrato 5,Estrato 6,Total Residencial,Industrial,Comercial,Oficial,Otros,Total No Residencial
ABEJORRAL,2018,1,ANTIOQUIA,2627,4168,393,31,2,0,7221,58,482,125,9,674
ABEJORRAL,2018,10,ANTIOQUIA,2657,4259,392,30,2,0,7340,57,478,124,9,668
ABEJORRAL,2018,11,ANTIOQUIA,2660,4261,393,28,2,0,7344,57,478,124,9,668
ABEJORRAL,2018,12,ANTIOQUIA,2661,4265,393,28,2,0,7349,58,478,124,9,669
ABEJORRAL,2018,2,ANTIOQUIA,2643,4204,393,31,2,0,7273,58,482,125,9,674
ABEJORRAL,2018,3,ANTIOQUIA,2648,4219,393,32,2,0,7294,58,482,125,9,674
ABEJORRAL,2018,4,ANTIOQUIA,2652,4222,392,32,2,0,7300,58,482,125,9,674
ABEJORRAL,2018,5,ANTIOQUIA,2653,4208,391,31,2,0,7285,57,481,124,9,671
ABEJORRAL,2018,6,ANTIOQUIA,2657,4229,390,31,2,0,7309,57,480,124,9,670
ABEJORRAL,2018,7,ANTIOQUIA,2656,4241,391,33,2,0,7323,57,477,124,9,667
ABEJORRAL,2018,8,ANTIOQUIA,2660,4255,392,31,2,0,7340,57,478,124,9,668
ABEJORRAL,2018,9,ANTIOQUIA,2654,4255,392,30,2,0,7333,57,478,124,9,668
ABEJORRAL,2019,1,ANTIOQUIA,2670,4344,396,28,2,0,7440,59,481,124,9,673
ABEJORRAL,2019,10,ANTIOQUIA,2733,4535,406,31,2,0,7707,63,491,124,9,687
ABEJORRAL,2019,11,ANTIOQUIA,2717,4415,400,31,2,0,7565,58,486,124,9,677
ABEJORRAL,2019,12,ANTIOQUIA,2742,4542,407,32,2,0,7725,65,490,124,9,688
ABEJORRAL,2019,2,ANTIOQUIA,2675,4408,401,28,2,0,7514,63,486,124,9,682
ABEJORRAL,2019,3,ANTIOQUIA,2674,4369,397,31,2,0,7473,58,480,124,9,671
ABEJORRAL,2019,4,ANTIOQUIA,2679,4428,403,30,2,0,7542,62,485,124,9,680
ABEJORRAL,2019,5,ANTIOQUIA,2680,4396,397,31,2,0,7506,59,483,124,9,675
ABEJORRAL,2019,6,ANTIOQUIA,2682,4448,403,31,2,0,7566,62,487,124,9,682
ABEJORRAL,2019,7,ANTIOQUIA,2679,4396,398,31,2,0,7506,58,483,124,9,674
ABEJORRAL,2019,8,ANTIOQUIA,2699,4455,404,31,2,0,7591,63,487,124,9,683
ABEJORRAL,2019,9,ANTIOQUIA,2706,4411,399,31,2,0,7549,58,483,125,8,674
ABEJORRAL,2020,1,ANTIOQUIA,2742,4540,409,41,2,0,7734,64,489,124,9,686
ABEJORRAL,2020,10,ANTIOQUIA,2784,4616,409,32,2,0,7843,67,494,126,96,783
ABEJORRAL,2020,11,ANTIOQUIA,2784,4624,409,31,2,0,7850,67,494,126,96,783
ABEJORRAL,2020,12,ANTIOQUIA,2787,4637,409,30,2,0,7865,67,494,126,96,783
ABEJORRAL,2020,2,ANTIOQUIA,2718,4338,398,42,4,0,7500,60,481,130,96,767
ABEJORRAL,2020,3,ANTIOQUIA,2718,4342,398,42,4,0,7504,60,483,130,96,769
ABEJORRAL,2020,4,ANTIOQUIA,2719,4354,398,31,4,0,7506,60,489,124,96,769
ABEJORRAL,2020,5,ANTIOQUIA,2744,4419,401,31,2,0,7597,62,491,125,96,774
ABEJORRAL,2020,6,ANTIOQUIA,2759,4521,406,31,2,0,7719,65,495,124,96,780
ABEJORRAL,2020,7,ANTIOQUIA,2768,4589,408,32,2,0,7799,67,495,124,96,782
ABEJORRAL,2020,8,ANTIOQUIA,2777,4588,408,32,2,0,7807,67,495,124,96,782
ABEJORRAL,2020,9,ANTIOQUIA,2782,4607,408,33,2,0,7832,67,495,126,96,784
ABEJORRAL,2021,1,ANTIOQUIA,2785,4641,409,30,2,0,7867,67,495,126,96,784
ABEJORRAL,2021,10,ANTIOQUIA,2808,4691,414,31,2,0,7946,71,491,126,96,784
ABEJORRAL,2021,11,ANTIOQUIA,2809,4700,414,30,2,0,7955,71,491,126,96,784
ABEJORRAL,2021,12,ANTIOQUIA,2810,4704,414,31,2,0,7961,71,491,125,96,783
ABEJORRAL,2021,2,ANTIOQUIA,2789,4645,409,31,2,0,7876,67,496,126,96,785
ABEJORRAL,2021,3,ANTIOQUIA,2793,4653,409,30,2,0,7887,67,496,126,96,785
ABEJORRAL,2021,4,ANTIOQUIA,2794,4653,409,30,2,0,7888,67,496,126,96,785
ABEJORRAL,2021,5,ANTIOQUIA,2795,4658,410,30,2,0,7895,67,496,126,96,785
ABEJORRAL,2021,6,ANTIOQUIA,2797,4667,411,30,2,0,7907,68,496,126,96,786
ABEJORRAL,2021,7,ANTIOQUIA,2796,4679,412,31,2,0,7920,68,495,126,96,785
ABEJORRAL,2021,8,ANTIOQUIA,2801,4679,412,31,2,0,7925,69,494,126,96,785
ABEJORRAL,2021,9,ANTIOQUIA,2804,4686,413,31,2,0,7936,71,492,126,96,785
ABEJORRAL,2022,1,ANTIOQUIA,2816,4713,414,31,2,0,7976,71,490,125,96,782
ABEJORRAL,2022,10,ANTIOQUIA,2749,4705,406,33,2,0,7895,72,492,126,95,785
ABEJORRAL,2022,11,ANTIOQUIA,2754,4728,405,36,2,0,7925,72,492,125,95,784
ABEJORRAL,2022,12,ANTIOQUIA,2756,4730,406,36,1,0,7929,72,492,125,95,784
ABEJORRAL,2022,2,ANTIOQUIA,2818,4727,415,31,2,0,7993,71,491,125,96,783
ABEJORRAL,2022,3,ANTIOQUIA,2820,4738,413,32,2,0,8005,70,491,127,95,783
ABEJORRAL,2022,4,ANTIOQUIA,2823,4746,414,32,2,0,8017,70,493,127,95,785
ABEJORRAL,2022,5,ANTIOQUIA,2825,4753,414,32,2,0,8026,70,495,127,95,787
ABEJORRAL,2022,6,ANTIOQUIA,2827,4757,414,32,2,0,8032,70,494,127,95,786
ABEJORRAL,2022,7,ANTIOQUIA,2741,4669,407,32,2,0,7851,71,494,126,95,786
ABEJORRAL,2022,8,ANTIOQUIA,2746,4680,405,32,2,0,7865,71,494,126,95,786
ABEJORRAL,2022,9,ANTIOQUIA,2747,4693,405,32,2,0,7879,72,493,126,95,786
ABEJORRAL,2023,1,ANTIOQUIA,2760,4741,406,36,1,0,7944,71,492,125,95,783
ABEJORRAL,2023,2,ANTIOQUIA,2767,4753,406,35,1,0,7962,72,492,125,95,784
ABEJORRAL,2023,3,ANTIOQUIA,2780,4763,407,35,1,0,7986,72,494,125,95,786
ABEJORRAL,2023,4,ANTIOQUIA,2786,4773,408,35,1,0,8003,72,494,126,95,787
ABEJORRAL,2023,5,ANTIOQUIA,2790,4787,407,34,1,0,8019,72,494,125,95,786
ABEJORRAL,2023,6,ANTIOQUIA,2795,4792,408,34,1,0,8030,72,498,125,95,790
ABEJORRAL,2023,7,ANTIOQUIA,2798,4789,408,34,1,0,8030,72,498,125,95,790
ABEJORRAL,2023,8,ANTIOQUIA,2804,4802,407,34,1,0,8048,72,497,125,95,789
ABEJORRAL,2023,9,ANTIOQUIA,2823,4817,407,34,1,0,8082,72,498,125,95,790
ABRIAQUI,2018,1,ANTIOQUIA,219,557,99,0,0,1,876,8,48,25,1,82
ABRIAQUI,2018,10,ANTIOQUIA,225,565,98,0,0,1,889,7,53,25,1,86
ABRIAQUI,2018,11,ANTIOQUIA,225,568,98,0,0,1,892,7,53,25,1,86
ABRIAQUI,2018,12,ANTIOQUIA,225,568,98,0,0,1,892,7,53,25,1,86
ABRIAQUI,2018,2,ANTIOQUIA,219,556,99,0,0,1,875,7,49,25,1,82
ABRIAQUI,2018,3,ANTIOQUIA,221,558,99,0,0,1,879,7,49,25,1,82
ABRIAQUI,2018,4,ANTIOQUIA,221,559,98,0,0,1,879,7,49,25,1,82
ABRIAQUI,2018,5,ANTIOQUIA,219,559,98,0,0,1,877,7,49,25,1,82
ABRIAQUI,2018,6,ANTIOQUIA,220,560,98,0,0,1,879,7,50,25,1,83
ABRIAQUI,2018,7,ANTIOQUIA,223,560,98,0,0,1,882,7,50,25,1,83
ABRIAQUI,2018,8,ANTIOQUIA,223,560,98,0,0,1,882,7,50,25,1,83
ABRIAQUI,2018,9,ANTIOQUIA,224,559,98,0,0,1,882,7,53,25,1,86
ABRIAQUI,2019,1,ANTIOQUIA,225,569,98,0,0,1,893,7,53,25,1,86
ABRIAQUI,2019,10,ANTIOQUIA,248,572,96,0,0,1,917,7,50,31,1,89
ABRIAQUI,2019,11,ANTIOQUIA,252,573,96,0,0,1,922,7,50,31,1,89
ABRIAQUI,2019,12,ANTIOQUIA,257,576,95,0,0,1,929,7,50,31,1,89
ABRIAQUI,2019,2,ANTIOQUIA,245,569,98,0,0,1,913,7,53,25,1,86
ABRIAQUI,2019,3,ANTIOQUIA,245,569,98,0,0,1,913,7,53,25,1,86
ABRIAQUI,2019,4,ANTIOQUIA,245,571,98,0,0,1,915,7,53,25,1,86
ABRIAQUI,2019,5,ANTIOQUIA,246,572,98,0,0,1,917,7,53,25,1,86
ABRIAQUI,2019,6,ANTIOQUIA,245,570,97,0,0,1,913,7,49,31,1,88
ABRIAQUI,2019,7,ANTIOQUIA,245,570,98,0,0,1,914,7,49,31,1,88
ABRIAQUI,2019,8,ANTIOQUIA,245,571,97,0,0,1,914,7,49,31,1,88
ABRIAQUI,2019,9,ANTIOQUIA,245,571,97,0,0,1,914,7,49,31,1,88
ABRIAQUI,2020,1,ANTIOQUIA,256,577,94,0,0,1,928,7,50,31,1,89
ABRIAQUI,2020,10,ANTIOQUIA,263,591,94,0,0,1,949,8,50,31,21,110
ABRIAQUI,2020,11,ANTIOQUIA,263,591,94,1,0,1,950,8,50,31,21,110
ABRIAQUI,2020,12,ANTIOQUIA,264,591,94,1,0,1,951,8,50,31,21,110
ABRIAQUI,2020,2,ANTIOQUIA,257,587,94,1,0,1,940,7,50,31,21,109
ABRIAQUI,2020,3,ANTIOQUIA,258,588,94,1,0,1,942,7,50,31,21,109
ABRIAQUI,2020,4,ANTIOQUIA,258,589,94,0,0,1,942,7,50,31,21,109
ABRIAQUI,2020,5,ANTIOQUIA,260,590,94,0,0,1,945,8,50,31,21,110
ABRIAQUI,2020,6,ANTIOQUIA,260,590,94,0,0,1,945,8,50,31,21,110
ABRIAQUI,2020,7,ANTIOQUIA,261,590,94,0,0,1,946,8,50,31,21,110
ABRIAQUI,2020,8,ANTIOQUIA,261,590,94,0,0,1,946,8,50,31,21,110
ABRIAQUI,2020,9,ANTIOQUIA,263,590,94,0,0,1,948,8,50,31,21,110
ABRIAQUI,2021,1,ANTIOQUIA,263,591,94,1,0,1,950,8,50,31,21,110
ABRIAQUI,2021,10,ANTIOQUIA,268,597,94,2,0,1,962,8,51,31,21,111
ABRIAQUI,2021,11,ANTIOQUIA,268,597,94,2,0,1,962,8,51,31,21,111
ABRIAQUI,2021,12,ANTIOQUIA,268,597,94,2,0,1,962,8,51,31,21,111
ABRIAQUI,2021,2,ANTIOQUIA,263,594,93,1,0,1,952,8,50,31,21,110
ABRIAQUI,2021,3,ANTIOQUIA,263,594,93,1,0,1,952,8,50,31,21,110
ABRIAQUI,2021,4,ANTIOQUIA,265,594,94,1,0,1,955,8,50,31,21,110
ABRIAQUI,2021,5,ANTIOQUIA,265,595,94,1,0,1,956,8,50,31,21,110
ABRIAQUI,2021,6,ANTIOQUIA,267,596,94,2,0,1,960,8,50,31,21,110
ABRIAQUI,2021,7,ANTIOQUIA,268,596,94,2,0,1,961,8,50,31,21,110
ABRIAQUI,2021,8,ANTIOQUIA,267,597,94,2,0,1,961,8,51,31,21,111
ABRIAQUI,2021,9,ANTIOQUIA,268,597,94,2,0,1,962,8,51,31,21,111
ABRIAQUI,2022,1,ANTIOQUIA,269,597,94,2,0,1,963,7,51,31,21,110
ABRIAQUI,2022,10,ANTIOQUIA,272,592,91,2,0,1,958,7,50,31,21,109
ABRIAQUI,2022,11,ANTIOQUIA,272,595,91,2,0,1,961,7,50,31,21,109
ABRIAQUI,2022,12,ANTIOQUIA,272,597,91,2,0,1,963,7,51,31,21,110
ABRIAQUI,2022,2,ANTIOQUIA,269,597,94,2,0,1,963,7,51,31,21,110
ABRIAQUI,2022,3,ANTIOQUIA,269,597,94,2,0,1,963,8,51,31,21,111
ABRIAQUI,2022,4,ANTIOQUIA,269,597,94,2,0,1,963,8,51,31,21,111
ABRIAQUI,2022,5,ANTIOQUIA,268,600,94,2,0,1,965,8,51,31,21,111
ABRIAQUI,2022,6,ANTIOQUIA,270,597,94,2,0,1,964,8,52,31,21,112
ABRIAQUI,2022,7,ANTIOQUIA,269,588,92,2,0,1,952,7,50,31,21,109
ABRIAQUI,2022,8,ANTIOQUIA,270,590,91,2,0,1,954,7,50,31,21,109
ABRIAQUI,2022,9,ANTIOQUIA,272,591,91,2,0,1,957,7,50,31,21,109
ABRIAQUI,2023,1,ANTIOQUIA,272,599,91,2,0,1,965,7,50,31,21,109
ABRIAQUI,2023,2,ANTIOQUIA,274,599,91,2,0,1,967,7,50,31,21,109
ABRIAQUI,2023,3,ANTIOQUIA,274,603,91,2,0,1,971,7,51,31,21,110
ABRIAQUI,2023,4,ANTIOQUIA,274,606,91,2,0,1,974,7,51,31,21,110
ABRIAQUI,2023,5,ANTIOQUIA,275,609,90,3,0,1,978,7,51,31,21,110
ABRIAQUI,2023,6,ANTIOQUIA,275,611,91,3,0,1,981,7,51,31,21,110
ABRIAQUI,2023,7,ANTIOQUIA,275,612,90,2,0,1,980,7,51,31,22,111
ABRIAQUI,2023,8,ANTIOQUIA,274,614,90,2,0,1,981,7,51,31,22,111
ABRIAQUI,2023,9,ANTIOQUIA,275,615,90,2,0,1,983,7,50,31,22,110
ALEJANDRIA,2018,1,ANTIOQUIA,434,1199,247,10,0,1,1891,8,155,36,3,202
ALEJANDRIA,2018,10,ANTIOQUIA,434,1215,250,12,0,1,1912,8,156,35,3,202
ALEJANDRIA,2018,11,ANTIOQUIA,435,1217,250,12,0,1,1915,8,156,35,3,202
ALEJANDRIA,2018,12,ANTIOQUIA,437,1221,251,12,0,1,1922,8,156,35,3,202
ALEJANDRIA,2018,2,ANTIOQUIA,432,1206,247,10,0,1,1896,8,155,36,3,202
ALEJANDRIA,2018,3,ANTIOQUIA,432,1207,247,10,0,1,1897,8,156,36,3,203
ALEJANDRIA,2018,4,ANTIOQUIA,433,1208,252,10,0,1,1904,8,156,36,3,203
ALEJANDRIA,2018,5,ANTIOQUIA,431,1202,251,10,0,1,1895,8,156,36,3,203
ALEJANDRIA,2018,6,ANTIOQUIA,433,1208,250,11,0,1,1903,8,156,36,3,203
ALEJANDRIA,2018,7,ANTIOQUIA,433,1211,250,12,0,1,1907,8,156,35,3,202
ALEJANDRIA,2018,8,ANTIOQUIA,433,1217,250,12,0,1,1913,8,157,35,3,203
ALEJANDRIA,2018,9,ANTIOQUIA,433,1212,250,12,0,1,1908,8,156,35,3,202
ALEJANDRIA,2019,1,ANTIOQUIA,437,1223,251,12,0,1,1924,8,156,35,3,202
ALEJANDRIA,2019,10,ANTIOQUIA,440,1244,250,15,0,1,1950,8,155,36,3,202
ALEJANDRIA,2019,11,ANTIOQUIA,440,1246,249,15,0,1,1951,8,155,36,3,202
ALEJANDRIA,2019,12,ANTIOQUIA,440,1246,249,15,0,1,1951,8,155,36,3,202
ALEJANDRIA,2019,2,ANTIOQUIA,438,1227,251,12,0,1,1929,8,156,35,3,202
ALEJANDRIA,2019,3,ANTIOQUIA,438,1233,251,13,0,1,1936,8,156,35,3,202
ALEJANDRIA,2019,4,ANTIOQUIA,438,1235,251,13,0,1,1938,8,156,35,3,202
ALEJANDRIA,2019,5,ANTIOQUIA,440,1244,251,13,0,1,1949,8,156,35,3,202
ALEJANDRIA,2019,6,ANTIOQUIA,438,1239,252,13,0,1,1943,8,155,35,3,201
ALEJANDRIA,2019,7,ANTIOQUIA,439,1240,250,14,0,1,1944,8,155,36,3,202
ALEJANDRIA,2019,8,ANTIOQUIA,440,1243,250,14,0,1,1948,8,155,36,3,202
ALEJANDRIA,2019,9,ANTIOQUIA,440,1244,250,15,0,1,1950,8,155,36,3,202
ALEJANDRIA,2020,1,ANTIOQUIA,440,1248,248,15,0,1,1952,8,155,36,3,202
ALEJANDRIA,2020,10,ANTIOQUIA,447,1271,249,16,0,1,1984,9,156,36,36,237
ALEJANDRIA,2020,11,ANTIOQUIA,446,1275,249,16,0,1,1987,9,156,36,36,237
ALEJANDRIA,2020,12,ANTIOQUIA,449,1274,250,16,0,1,1990,9,156,36,36,237
ALEJANDRIA,2020,2,ANTIOQUIA,440,1249,247,15,0,1,1952,9,155,37,36,237
ALEJANDRIA,2020,3,ANTIOQUIA,440,1249,247,15,0,1,1952,9,155,37,36,237
ALEJANDRIA,2020,4,ANTIOQUIA,440,1250,248,15,0,1,1954,9,156,36,36,237
ALEJANDRIA,2020,5,ANTIOQUIA,444,1256,249,15,0,1,1965,9,157,36,36,238
ALEJANDRIA,2020,6,ANTIOQUIA,442,1256,249,15,0,1,1963,9,155,36,36,236
ALEJANDRIA,2020,7,ANTIOQUIA,442,1261,249,15,0,1,1968,9,157,36,36,238
ALEJANDRIA,2020,8,ANTIOQUIA,446,1268,249,16,0,1,1980,9,156,36,36,237
ALEJANDRIA,2020,9,ANTIOQUIA,446,1270,249,16,0,1,1982,9,156,36,36,237
ALEJANDRIA,2021,1,ANTIOQUIA,449,1276,250,15,0,1,1991,9,156,36,36,237
ALEJANDRIA,2021,10,ANTIOQUIA,463,1293,250,14,0,1,2021,10,156,34,36,236
ALEJANDRIA,2021,11,ANTIOQUIA,463,1295,250,13,0,1,2022,10,156,34,36,236
ALEJANDRIA,2021,12,ANTIOQUIA,463,1295,250,13,0,1,2022,10,156,34,36,236
ALEJANDRIA,2021,2,ANTIOQUIA,452,1277,250,15,0,1,1995,10,156,36,36,238
ALEJANDRIA,2021,3,ANTIOQUIA,458,1282,251,14,0,1,2006,10,156,36,36,238
ALEJANDRIA,2021,4,ANTIOQUIA,458,1285,251,14,0,1,2009,10,156,36,36,238
ALEJANDRIA,2021,5,ANTIOQUIA,461,1287,251,14,0,1,2014,10,156,36,36,238
ALEJANDRIA,2021,6,ANTIOQUIA,462,1295,251,14,0,1,2023,10,156,35,36,237
ALEJANDRIA,2021,7,ANTIOQUIA,461,1294,251,14,0,1,2021,10,156,34,36,236
ALEJANDRIA,2021,8,ANTIOQUIA,462,1293,251,14,0,1,2021,10,156,34,36,236
ALEJANDRIA,2021,9,ANTIOQUIA,462,1293,251,14,0,1,2021,10,156,34,36,236
ALEJANDRIA,2022,1,ANTIOQUIA,464,1298,250,13,0,1,2026,10,156,34,36,236
ALEJANDRIA,2022,10,ANTIOQUIA,469,1310,247,14,0,1,2041,9,155,35,36,235
ALEJANDRIA,2022,11,ANTIOQUIA,469,1311,247,13,0,1,2041,9,155,35,36,235
ALEJANDRIA,2022,12,ANTIOQUIA,470,1319,246,12,0,1,2048,8,157,35,36,236
ALEJANDRIA,2022,2,ANTIOQUIA,465,1298,250,13,0,1,2027,10,156,34,36,236
ALEJANDRIA,2022,3,ANTIOQUIA,470,1301,249,13,0,1,2034,9,157,35,36,237
ALEJANDRIA,2022,4,ANTIOQUIA,471,1302,249,13,0,1,2036,9,157,35,36,237
ALEJANDRIA,2022,5,ANTIOQUIA,470,1303,248,13,0,1,2035,9,156,35,36,236
ALEJANDRIA,2022,6,ANTIOQUIA,471,1305,249,13,0,1,2039,9,156,35,36,236
ALEJANDRIA,2022,7,ANTIOQUIA,467,1303,246,13,0,1,2030,9,156,35,36,236
ALEJANDRIA,2022,8,ANTIOQUIA,469,1302,246,13,0,1,2031,9,155,35,36,235
ALEJANDRIA,2022,9,ANTIOQUIA,468,1310,246,14,0,1,2039,9,155,35,36,235
ALEJANDRIA,2023,1,ANTIOQUIA,471,1327,246,12,0,1,2057,8,157,35,36,236
ALEJANDRIA,2023,2,ANTIOQUIA,471,1332,249,12,0,1,2065,8,158,35,36,237
ALEJANDRIA,2023,3,ANTIOQUIA,472,1338,249,12,0,1,2072,9,158,35,36,238
ALEJANDRIA,2023,4,ANTIOQUIA,472,1340,248,12,0,1,2073,9,158,35,36,238
ALEJANDRIA,2023,5,ANTIOQUIA,475,1341,248,12,0,1,2077,9,159,35,36,239
ALEJANDRIA,2023,6,ANTIOQUIA,477,1346,248,12,0,1,2084,9,158,35,36,238
ALEJANDRIA,2023,7,ANTIOQUIA,478,1347,248,12,0,1,2086,9,158,35,36,238
ALEJANDRIA,2023,8,ANTIOQUIA,485,1358,247,12,0,1,2103,9,158,35,36,238
ALEJANDRIA,2023,9,ANTIOQUIA,486,1363,247,12,0,1,2109,9,157,35,36,237
AMAGA,2018,1,ANTIOQUIA,3472,5289,685,148,109,38,9741,141,766,58,17,982
AMAGA,2018,10,ANTIOQUIA,3509,5455,679,139,108,37,9927,140,778,59,16,993
AMAGA,2018,11,ANTIOQUIA,3508,5458,674,138,107,36,9921,139,778,59,16,992
AMAGA,2018,12,ANTIOQUIA,3508,5462,681,138,107,36,9932,140,779,59,16,994
AMAGA,2018,2,ANTIOQUIA,3478,5304,685,148,109,38,9762,141,765,58,17,981
AMAGA,2018,3,ANTIOQUIA,3480,5320,689,149,109,37,9784,141,767,58,17,983
AMAGA,2018,4,ANTIOQUIA,3489,5337,690,146,109,38,9809,142,768,59,16,985
AMAGA,2018,5,ANTIOQUIA,3482,5348,690,144,109,38,9811,141,769,59,16,985
AMAGA,2018,6,ANTIOQUIA,3495,5373,691,144,108,38,9849,140,765,59,16,980
AMAGA,2018,7,ANTIOQUIA,3497,5381,691,142,108,38,9857,141,771,59,16,987
AMAGA,2018,8,ANTIOQUIA,3502,5393,692,142,108,38,9875,143,774,59,16,992
AMAGA,2018,9,ANTIOQUIA,3506,5412,702,140,108,37,9905,139,777,59,16,991
AMAGA,2019,1,ANTIOQUIA,3505,5462,682,136,107,36,9928,141,786,59,16,1002
AMAGA,2019,10,ANTIOQUIA,3594,5573,689,130,107,37,10130,144,797,60,16,1017
AMAGA,2019,11,ANTIOQUIA,3595,5583,698,130,107,37,10150,148,797,59,16,1020
AMAGA,2019,12,ANTIOQUIA,3622,5606,700,129,107,37,10201,149,803,60,16,1028
AMAGA,2019,2,ANTIOQUIA,3519,5473,681,135,107,36,9951,142,789,59,16,1006
AMAGA,2019,3,ANTIOQUIA,3525,5482,681,136,106,36,9966,145,786,59,16,1006
AMAGA,2019,4,ANTIOQUIA,3517,5487,679,137,107,36,9963,146,786,59,16,1007
AMAGA,2019,5,ANTIOQUIA,3537,5503,682,139,107,36,10004,145,790,59,16,1010
AMAGA,2019,6,ANTIOQUIA,3545,5516,682,138,107,36,10024,143,791,59,16,1009
AMAGA,2019,7,ANTIOQUIA,3539,5521,683,137,106,35,10021,143,790,60,16,1009
AMAGA,2019,8,ANTIOQUIA,3559,5534,687,136,107,37,10060,144,794,60,16,1014
AMAGA,2019,9,ANTIOQUIA,3573,5547,688,129,107,37,10081,143,798,60,16,1017
AMAGA,2020,1,ANTIOQUIA,3603,5609,699,138,106,36,10191,152,803,60,16,1031
AMAGA,2020,10,ANTIOQUIA,3633,5700,701,136,106,38,10314,157,812,58,423,1450
AMAGA,2020,11,ANTIOQUIA,3632,5701,700,134,106,38,10311,161,820,58,423,1462
AMAGA,2020,12,ANTIOQUIA,3636,5721,696,136,106,38,10333,163,821,58,423,1465
AMAGA,2020,2,ANTIOQUIA,3607,5608,701,156,106,36,10214,155,799,69,423,1446
AMAGA,2020,3,ANTIOQUIA,3611,5628,702,159,106,36,10242,156,798,69,423,1446
AMAGA,2020,4,ANTIOQUIA,3618,5641,702,134,106,37,10238,154,803,59,423,1439
AMAGA,2020,5,ANTIOQUIA,3620,5655,704,134,106,37,10256,151,808,58,423,1440
AMAGA,2020,6,ANTIOQUIA,3616,5656,702,136,107,37,10254,156,808,58,423,1445
AMAGA,2020,7,ANTIOQUIA,3617,5667,701,135,107,37,10264,157,805,58,423,1443
AMAGA,2020,8,ANTIOQUIA,3614,5672,701,136,106,37,10266,156,804,58,423,1441
AMAGA,2020,9,ANTIOQUIA,3625,5679,702,136,106,38,10286,157,807,58,423,1445
AMAGA,2021,1,ANTIOQUIA,3640,5732,699,137,106,38,10352,164,824,57,423,1468
AMAGA,2021,10,ANTIOQUIA,3697,5849,728,143,104,39,10560,172,837,58,423,1490
AMAGA,2021,11,ANTIOQUIA,3706,5862,731,151,104,40,10594,172,861,58,423,1514
AMAGA,2021,12,ANTIOQUIA,3718,5892,733,154,104,40,10641,176,864,58,423,1521
AMAGA,2021,2,ANTIOQUIA,3648,5742,698,137,106,38,10369,162,828,57,423,1470
AMAGA,2021,3,ANTIOQUIA,3662,5756,704,137,106,38,10403,162,833,58,423,1476
AMAGA,2021,4,ANTIOQUIA,3663,5762,703,139,105,38,10410,164,839,58,423,1484
AMAGA,2021,5,ANTIOQUIA,3668,5775,709,139,104,38,10433,167,840,59,422,1488
AMAGA,2021,6,ANTIOQUIA,3669,5781,712,142,105,38,10447,167,838,58,423,1486
AMAGA,2021,7,ANTIOQUIA,3678,5794,716,144,105,39,10476,166,838,58,423,1485
AMAGA,2021,8,ANTIOQUIA,3681,5803,722,143,104,39,10492,167,836,58,423,1484
AMAGA,2021,9,ANTIOQUIA,3688,5809,727,143,104,39,10510,171,837,58,423,1489
AMAGA,2022,1,ANTIOQUIA,3719,5918,739,152,104,40,10672,176,868,58,423,1525
AMAGA,2022,10,ANTIOQUIA,3788,6147,773,143,102,40,10993,180,893,61,421,1555
AMAGA,2022,11,ANTIOQUIA,3794,6164,775,144,102,40,11019,178,891,61,422,1552
AMAGA,2022,12,ANTIOQUIA,3799,6183,775,144,102,40,11043,179,894,62,422,1557
AMAGA,2022,2,ANTIOQUIA,3737,5929,738,153,104,40,10701,179,874,58,423,1534
AMAGA,2022,3,ANTIOQUIA,3745,5963,743,158,104,41,10754,178,887,61,419,1545
AMAGA,2022,4,ANTIOQUIA,3748,5980,749,159,104,41,10781,178,887,61,419,1545
AMAGA,2022,5,ANTIOQUIA,3737,6032,763,149,104,41,10826,178,890,61,419,1548
AMAGA,2022,6,ANTIOQUIA,3761,6043,764,146,104,41,10859,176,887,61,419,1543
AMAGA,2022,7,ANTIOQUIA,3779,6060,778,146,104,40,10907,177,888,61,420,1546
AMAGA,2022,8,ANTIOQUIA,3778,6087,781,145,103,40,10934,177,891,61,420,1549
AMAGA,2022,9,ANTIOQUIA,3785,6128,772,141,103,40,10969,179,892,61,421,1553
AMAGA,2023,1,ANTIOQUIA,3804,6198,778,145,102,40,11067,177,893,62,422,1554
AMAGA,2023,2,ANTIOQUIA,3810,6213,778,143,102,40,11086,177,891,62,422,1552
AMAGA,2023,3,ANTIOQUIA,3823,6248,782,143,102,40,11138,178,897,62,422,1559
AMAGA,2023,4,ANTIOQUIA,3834,6252,782,143,100,40,11151,179,899,62,422,1562
AMAGA,2023,5,ANTIOQUIA,3847,6275,782,144,101,40,11189,181,897,62,423,1563
AMAGA,2023,6,ANTIOQUIA,3839,6288,789,142,98,40,11196,178,897,62,423,1560
AMAGA,2023,7,ANTIOQUIA,3845,6292,791,142,99,40,11209,186,898,62,424,1570
AMAGA,2023,8,ANTIOQUIA,3861,6307,792,142,99,40,11241,192,899,62,424,1577
AMAGA,2023,9,ANTIOQUIA,3865,6321,800,141,99,40,11266,182,898,62,425,1567
AMALFI,2018,1,ANTIOQUIA,2813,2782,2009,35,18,12,7669,42,505,109,13,669
AMALFI,2018,10,ANTIOQUIA,2812,2815,2011,35,17,12,7702,41,509,110,13,673
AMALFI,2018,11,ANTIOQUIA,2816,2817,2010,35,18,12,7708,40,509,110,14,673
AMALFI,2018,12,ANTIOQUIA,2833,2851,2011,35,17,12,7759,41,511,111,14,677
AMALFI,2018,2,ANTIOQUIA,2816,2789,2009,35,18,12,7679,42,506,109,13,670
AMALFI,2018,3,ANTIOQUIA,2793,2791,2010,34,18,12,7658,42,505,109,13,669
AMALFI,2018,4,ANTIOQUIA,2822,2795,2009,34,18,12,7690,42,506,110,13,671
AMALFI,2018,5,ANTIOQUIA,2789,2793,2007,33,18,12,7652,42,504,109,13,668
AMALFI,2018,6,ANTIOQUIA,2787,2796,2007,33,18,12,7653,42,504,109,13,668
AMALFI,2018,7,ANTIOQUIA,2798,2801,2002,34,18,12,7665,42,514,109,13,678
AMALFI,2018,8,ANTIOQUIA,2812,2806,2006,36,18,12,7690,42,514,109,13,678
AMALFI,2018,9,ANTIOQUIA,2808,2810,2007,35,17,12,7689,41,511,110,13,675
AMALFI,2019,1,ANTIOQUIA,2840,2855,2011,35,17,12,7770,41,510,111,14,676
AMALFI,2019,10,ANTIOQUIA,2914,2870,2019,37,17,12,7869,41,512,112,13,678
AMALFI,2019,11,ANTIOQUIA,2919,2875,2018,36,17,12,7877,41,513,112,13,679
AMALFI,2019,12,ANTIOQUIA,2931,2879,2025,36,17,13,7901,41,513,113,13,680
AMALFI,2019,2,ANTIOQUIA,2850,2860,2013,35,18,12,7788,42,510,111,14,677
AMALFI,2019,3,ANTIOQUIA,2887,2859,2015,35,17,12,7825,42,511,111,14,678
AMALFI,2019,4,ANTIOQUIA,2887,2860,2017,35,17,12,7828,42,511,111,14,678
AMALFI,2019,5,ANTIOQUIA,2910,2860,2018,35,17,12,7852,43,509,111,14,677
AMALFI,2019,6,ANTIOQUIA,2901,2858,2016,35,17,12,7839,42,510,111,13,676
AMALFI,2019,7,ANTIOQUIA,2909,2861,2019,35,17,12,7853,41,511,112,13,677
AMALFI,2019,8,ANTIOQUIA,2908,2863,2022,37,17,12,7859,41,510,111,13,675
AMALFI,2019,9,ANTIOQUIA,2910,2870,2020,37,17,12,7866,41,511,111,13,676
AMALFI,2020,1,ANTIOQUIA,2925,2879,2019,38,17,12,7890,41,518,113,13,685
AMALFI,2020,10,ANTIOQUIA,2955,2904,2020,36,18,12,7945,41,540,114,100,795
AMALFI,2020,11,ANTIOQUIA,2960,2902,2010,37,18,12,7939,42,548,114,100,804
AMALFI,2020,12,ANTIOQUIA,2961,2924,2011,40,18,12,7966,41,548,114,100,803
AMALFI,2020,2,ANTIOQUIA,2926,2885,2018,43,17,12,7901,42,520,125,100,787
AMALFI,2020,3,ANTIOQUIA,2927,2884,2018,42,17,12,7900,42,520,125,100,787
AMALFI,2020,4,ANTIOQUIA,2933,2886,2021,35,17,12,7904,42,531,114,100,787
AMALFI,2020,5,ANTIOQUIA,2957,2894,2022,35,18,12,7938,42,532,114,100,788
AMALFI,2020,6,ANTIOQUIA,2937,2893,2022,35,18,12,7917,42,531,114,100,787
AMALFI,2020,7,ANTIOQUIA,2939,2895,2022,35,18,12,7921,42,530,114,100,786
AMALFI,2020,8,ANTIOQUIA,2977,2897,2021,35,18,12,7960,41,531,114,100,786
AMALFI,2020,9,ANTIOQUIA,2957,2908,2024,35,18,12,7954,41,530,114,100,785
AMALFI,2021,1,ANTIOQUIA,2963,2928,2012,37,18,12,7970,41,548,114,100,803
AMALFI,2021,10,ANTIOQUIA,3065,2971,2034,38,18,13,8139,42,546,117,100,805
AMALFI,2021,11,ANTIOQUIA,3065,2975,2035,38,18,13,8144,42,547,117,100,806
AMALFI,2021,12,ANTIOQUIA,3070,2977,2036,38,18,13,8152,43,548,117,100,808
AMALFI,2021,2,ANTIOQUIA,2965,2932,2013,40,18,12,7980,40,548,114,100,802
AMALFI,2021,3,ANTIOQUIA,2978,2952,2031,41,18,12,8032,40,547,115,100,802
AMALFI,2021,4,ANTIOQUIA,2999,2959,2032,37,18,12,8057,40,546,115,100,801
AMALFI,2021,5,ANTIOQUIA,3003,2962,2031,68,18,12,8094,41,546,115,99,801
AMALFI,2021,6,ANTIOQUIA,3026,2955,2030,69,18,12,8110,41,546,116,100,803
AMALFI,2021,7,ANTIOQUIA,3062,2960,2031,39,18,12,8122,41,546,116,100,803
AMALFI,2021,8,ANTIOQUIA,3060,2968,2032,39,18,13,8130,41,545,116,100,802
AMALFI,2021,9,ANTIOQUIA,3063,2973,2033,38,18,13,8138,41,546,116,100,803
AMALFI,2022,1,ANTIOQUIA,3077,2981,2037,38,18,13,8164,43,548,117,100,808
AMALFI,2022,10,ANTIOQUIA,3098,2994,2029,40,18,14,8193,42,555,117,99,813
AMALFI,2022,11,ANTIOQUIA,3115,3007,2030,40,18,14,8224,42,557,117,99,815
AMALFI,2022,12,ANTIOQUIA,3116,3008,2031,40,18,14,8227,42,556,117,99,814
AMALFI,2022,2,ANTIOQUIA,3079,2983,2036,38,18,13,8167,43,549,117,100,809
AMALFI,2022,3,ANTIOQUIA,3081,2986,2039,38,18,13,8175,43,550,117,99,809
AMALFI,2022,4,ANTIOQUIA,3085,2985,2037,38,18,14,8177,43,550,117,99,809
AMALFI,2022,5,ANTIOQUIA,3086,2989,2040,38,18,14,8185,42,552,117,99,810
AMALFI,2022,6,ANTIOQUIA,3095,2991,2040,38,18,14,8196,42,552,117,99,810
AMALFI,2022,7,ANTIOQUIA,3082,2969,2027,39,18,14,8149,42,553,117,99,811
AMALFI,2022,8,ANTIOQUIA,3088,2978,2028,39,18,14,8165,42,553,117,99,811
AMALFI,2022,9,ANTIOQUIA,3092,2988,2029,39,18,14,8180,42,554,117,99,812
AMALFI,2023,1,ANTIOQUIA,3124,3017,2031,39,18,14,8243,42,555,117,99,813
AMALFI,2023,2,ANTIOQUIA,3142,3020,2035,40,18,15,8270,42,557,117,99,815
AMALFI,2023,3,ANTIOQUIA,3148,3027,2038,40,18,15,8286,42,555,117,99,813
AMALFI,2023,4,ANTIOQUIA,3150,3029,2042,41,18,15,8295,43,555,117,99,814
AMALFI,2023,5,ANTIOQUIA,3163,3035,2042,39,18,15,8312,42,556,117,99,814
AMALFI,2023,6,ANTIOQUIA,3178,3038,2041,40,18,15,8330,43,555,117,99,814
AMALFI,2023,7,ANTIOQUIA,3187,3046,2041,40,18,15,8347,43,553,117,99,812
AMALFI,2023,8,ANTIOQUIA,3195,3048,2040,40,18,15,8356,44,555,117,99,815
AMALFI,2023,9,ANTIOQUIA,3204,3055,2042,40,18,15,8374,41,557,117,99,814
ANDES,2018,1,ANTIOQUIA,2659,9134,1781,96,4,0,13674,188,1130,123,20,1461
ANDES,2018,10,ANTIOQUIA,2701,9310,1762,111,4,0,13888,189,1149,123,25,1486
ANDES,2018,11,ANTIOQUIA,2717,9303,1779,114,4,0,13917,188,1149,123,21,1481
ANDES,2018,12,ANTIOQUIA,2718,9324,1782,114,4,0,13942,189,1149,123,21,1482
ANDES,2018,2,ANTIOQUIA,2672,9167,1781,104,4,0,13728,188,1131,123,20,1462
ANDES,2018,3,ANTIOQUIA,2662,9182,1776,107,4,0,13731,189,1138,123,20,1470
ANDES,2018,4,ANTIOQUIA,2667,9199,1778,109,4,0,13757,188,1138,123,20,1469
ANDES,2018,5,ANTIOQUIA,2662,9196,1766,109,4,0,13737,188,1141,123,21,1473
ANDES,2018,6,ANTIOQUIA,2667,9228,1766,109,4,0,13774,188,1142,123,21,1474
ANDES,2018,7,ANTIOQUIA,2680,9253,1762,109,4,0,13808,187,1142,123,21,1473
ANDES,2018,8,ANTIOQUIA,2698,9258,1762,109,4,0,13831,187,1144,123,21,1475
ANDES,2018,9,ANTIOQUIA,2689,9278,1762,108,4,0,13841,189,1144,123,21,1477
ANDES,2019,1,ANTIOQUIA,2723,9329,1782,115,4,0,13953,189,1148,123,21,1481
ANDES,2019,10,ANTIOQUIA,2790,9493,1802,115,4,0,14204,198,1189,124,20,1531
ANDES,2019,11,ANTIOQUIA,2804,9534,1805,116,4,0,14263,199,1200,125,20,1544
ANDES,2019,12,ANTIOQUIA,2806,9558,1807,118,4,0,14293,197,1206,125,20,1548
ANDES,2019,2,ANTIOQUIA,2732,9358,1779,115,4,0,13988,189,1152,123,21,1485
ANDES,2019,3,ANTIOQUIA,2739,9401,1775,115,4,0,14034,190,1152,123,21,1486
ANDES,2019,4,ANTIOQUIA,2740,9411,1776,115,4,0,14046,191,1166,123,20,1500
ANDES,2019,5,ANTIOQUIA,2751,9427,1778,115,4,0,14075,190,1171,123,20,1504
ANDES,2019,6,ANTIOQUIA,2755,9437,1771,115,4,0,14082,191,1174,123,20,1508
ANDES,2019,7,ANTIOQUIA,2775,9451,1771,114,4,0,14115,189,1176,123,20,1508
ANDES,2019,8,ANTIOQUIA,2788,9460,1765,111,4,0,14128,191,1176,123,20,1510
ANDES,2019,9,ANTIOQUIA,2781,9485,1778,112,5,0,14161,194,1186,124,20,1524
ANDES,2020,1,ANTIOQUIA,2811,9633,1803,127,4,0,14378,197,1203,126,20,1546
ANDES,2020,10,ANTIOQUIA,2809,9401,1751,115,4,0,14080,185,1278,120,208,1791
ANDES,2020,11,ANTIOQUIA,2820,9407,1747,116,4,0,14094,185,1280,120,208,1793
ANDES,2020,12,ANTIOQUIA,2821,9433,1748,114,4,0,14120,186,1284,120,208,1798
ANDES,2020,2,ANTIOQUIA,2816,9626,1797,129,4,0,14372,200,1232,134,208,1774
ANDES,2020,3,ANTIOQUIA,2820,9644,1799,134,4,0,14401,201,1234,134,208,1777
ANDES,2020,4,ANTIOQUIA,2815,9649,1787,116,4,0,14371,200,1270,125,208,1803
ANDES,2020,5,ANTIOQUIA,2832,9659,1785,118,4,0,14398,202,1275,125,208,1810
ANDES,2020,6,ANTIOQUIA,2822,9673,1789,117,4,0,14405,203,1277,125,208,1813
ANDES,2020,7,ANTIOQUIA,2830,9685,1789,118,4,0,14426,202,1279,125,208,1814
ANDES,2020,8,ANTIOQUIA,2843,9689,1788,117,4,0,14441,204,1278,125,208,1815
ANDES,2020,9,ANTIOQUIA,2807,9409,1752,116,4,0,14088,185,1276,120,208,1789
ANDES,2021,1,ANTIOQUIA,2827,9448,1747,114,4,0,14140,186,1288,120,208,1802
ANDES,2021,10,ANTIOQUIA,2945,9573,1757,153,4,0,14432,196,1305,123,210,1834
ANDES,2021,11,ANTIOQUIA,2960,9580,1756,153,4,0,14453,198,1309,123,210,1840
ANDES,2021,12,ANTIOQUIA,2971,9604,1758,154,4,0,14491,198,1309,123,210,1840
ANDES,2021,2,ANTIOQUIA,2835,9456,1746,114,4,0,14155,187,1293,120,208,1808
ANDES,2021,3,ANTIOQUIA,2831,9478,1757,115,4,0,14185,194,1297,120,208,1819
ANDES,2021,4,ANTIOQUIA,2907,9501,1764,114,4,0,14290,197,1300,120,208,1825
ANDES,2021,5,ANTIOQUIA,2922,9509,1764,118,4,0,14317,197,1300,122,208,1827
ANDES,2021,6,ANTIOQUIA,2919,9527,1760,118,4,0,14328,196,1302,122,208,1828
ANDES,2021,7,ANTIOQUIA,2925,9534,1761,126,4,0,14350,196,1301,122,210,1829
ANDES,2021,8,ANTIOQUIA,2939,9544,1761,127,4,0,14375,197,1305,123,210,1835
ANDES,2021,9,ANTIOQUIA,2935,9560,1756,128,4,0,14383,198,1302,123,210,1833
ANDES,2022,1,ANTIOQUIA,2973,9612,1759,152,4,0,14500,197,1311,123,210,1841
ANDES,2022,10,ANTIOQUIA,3031,9746,1755,234,4,0,14770,199,1321,125,207,1852
ANDES,2022,11,ANTIOQUIA,3068,9768,1761,203,4,0,14804,200,1322,125,207,1854
ANDES,2022,12,ANTIOQUIA,3012,9791,1878,147,4,0,14832,201,1321,125,207,1854
ANDES,2022,2,ANTIOQUIA,2986,9615,1765,154,4,0,14524,200,1312,122,210,1844
ANDES,2022,3,ANTIOQUIA,2989,9637,1762,151,4,0,14543,197,1318,127,206,1848
ANDES,2022,4,ANTIOQUIA,2972,9667,1764,151,4,0,14558,199,1320,127,206,1852
ANDES,2022,5,ANTIOQUIA,2973,9698,1762,150,4,0,14587,201,1320,128,206,1855
ANDES,2022,6,ANTIOQUIA,2993,9699,1763,149,4,0,14608,201,1320,127,206,1854
ANDES,2022,7,ANTIOQUIA,3003,9723,1764,151,4,0,14645,200,1318,128,206,1852
ANDES,2022,8,ANTIOQUIA,3009,9703,1757,150,4,0,14623,198,1317,127,206,1848
ANDES,2022,9,ANTIOQUIA,3023,9731,1758,208,4,0,14724,197,1317,126,207,1847
ANDES,2023,1,ANTIOQUIA,3016,9798,1877,147,4,0,14842,205,1324,124,207,1860
ANDES,2023,2,ANTIOQUIA,3027,9821,1864,147,4,0,14863,205,1333,125,207,1870
ANDES,2023,3,ANTIOQUIA,3037,9927,1788,145,4,0,14901,204,1334,126,207,1871
ANDES,2023,4,ANTIOQUIA,3038,9935,1789,145,4,0,14911,208,1331,126,207,1872
ANDES,2023,5,ANTIOQUIA,3041,9955,1790,146,4,0,14936,207,1331,127,207,1872
ANDES,2023,6,ANTIOQUIA,3036,9936,1789,145,4,0,14910,202,1330,128,207,1867
ANDES,2023,7,ANTIOQUIA,3036,9949,1789,144,4,0,14922,202,1330,128,207,1867
ANDES,2023,8,ANTIOQUIA,2896,9312,2553,188,4,0,14953,202,1331,128,207,1868
ANDES,2023,9,ANTIOQUIA,3194,9041,2533,188,4,0,14960,202,1330,128,207,1867
ANGELOPOLIS,2018,1,ANTIOQUIA,721,999,227,13,1,0,1961,69,128,42,3,242
ANGELOPOLIS,2018,10,ANTIOQUIA,725,1018,230,16,1,0,1990,66,127,42,3,238
ANGELOPOLIS,2018,11,ANTIOQUIA,727,1011,231,17,1,0,1987,66,128,42,3,239
ANGELOPOLIS,2018,12,ANTIOQUIA,727,1011,231,17,1,0,1987,65,129,42,3,239
ANGELOPOLIS,2018,2,ANTIOQUIA,724,1001,227,13,1,0,1966,67,127,42,3,239
ANGELOPOLIS,2018,3,ANTIOQUIA,724,1002,227,13,1,0,1967,69,127,42,3,241
ANGELOPOLIS,2018,4,ANTIOQUIA,726,1003,229,13,1,0,1972,68,127,42,3,240
ANGELOPOLIS,2018,5,ANTIOQUIA,724,1002,229,13,1,0,1969,67,127,42,3,239
ANGELOPOLIS,2018,6,ANTIOQUIA,725,1007,229,13,1,0,1975,66,127,42,3,238
ANGELOPOLIS,2018,7,ANTIOQUIA,725,1009,231,15,1,0,1981,67,127,42,3,239
ANGELOPOLIS,2018,8,ANTIOQUIA,724,1010,231,15,1,0,1981,66,128,42,3,239
ANGELOPOLIS,2018,9,ANTIOQUIA,726,1012,230,16,1,0,1985,65,127,42,3,237
ANGELOPOLIS,2019,1,ANTIOQUIA,727,1013,232,17,1,0,1990,65,131,42,3,241
ANGELOPOLIS,2019,10,ANTIOQUIA,736,1029,231,18,1,0,2015,69,132,43,3,247
ANGELOPOLIS,2019,11,ANTIOQUIA,737,1030,231,18,1,0,2017,69,132,44,3,248
ANGELOPOLIS,2019,12,ANTIOQUIA,737,1034,232,18,1,0,2022,70,132,45,3,250
ANGELOPOLIS,2019,2,ANTIOQUIA,730,1014,232,17,1,0,1994,66,130,42,3,241
ANGELOPOLIS,2019,3,ANTIOQUIA,730,1013,232,18,1,0,1994,66,129,42,3,240
ANGELOPOLIS,2019,4,ANTIOQUIA,730,1016,232,18,1,0,1997,67,129,42,3,241
ANGELOPOLIS,2019,5,ANTIOQUIA,731,1017,232,18,1,0,1999,67,129,43,3,242
ANGELOPOLIS,2019,6,ANTIOQUIA,731,1017,232,19,1,0,2000,67,130,43,3,243
ANGELOPOLIS,2019,7,ANTIOQUIA,731,1018,232,18,1,0,2000,67,130,43,3,243
ANGELOPOLIS,2019,8,ANTIOQUIA,732,1023,232,18,1,0,2006,68,132,43,3,246
ANGELOPOLIS,2019,9,ANTIOQUIA,733,1027,231,18,1,0,2010,69,132,43,3,247
ANGELOPOLIS,2020,1,ANTIOQUIA,737,1032,231,20,1,0,2021,69,132,45,3,249
ANGELOPOLIS,2020,10,ANTIOQUIA,749,1054,233,16,2,0,2054,73,137,45,78,333
ANGELOPOLIS,2020,11,ANTIOQUIA,749,1052,236,15,2,0,2054,73,142,45,78,338
ANGELOPOLIS,2020,12,ANTIOQUIA,748,1055,236,16,2,0,2057,73,144,45,78,340
ANGELOPOLIS,2020,2,ANTIOQUIA,737,1033,231,21,1,0,2023,70,132,46,78,326
ANGELOPOLIS,2020,3,ANTIOQUIA,737,1036,232,21,1,0,2027,71,132,46,78,327
ANGELOPOLIS,2020,4,ANTIOQUIA,741,1036,233,16,1,0,2027,71,134,45,78,328
ANGELOPOLIS,2020,5,ANTIOQUIA,744,1037,233,16,1,0,2031,71,135,45,78,329
ANGELOPOLIS,2020,6,ANTIOQUIA,746,1037,233,16,1,0,2033,71,135,45,78,329
ANGELOPOLIS,2020,7,ANTIOQUIA,749,1038,234,17,1,0,2039,70,135,45,78,328
ANGELOPOLIS,2020,8,ANTIOQUIA,748,1044,232,17,1,0,2042,70,135,45,78,328
ANGELOPOLIS,2020,9,ANTIOQUIA,748,1045,234,16,1,0,2044,72,135,45,78,330
ANGELOPOLIS,2021,1,ANTIOQUIA,751,1055,237,16,1,0,2060,74,145,45,78,342
ANGELOPOLIS,2021,10,ANTIOQUIA,762,1079,243,19,1,0,2104,72,142,45,78,337
ANGELOPOLIS,2021,11,ANTIOQUIA,765,1076,242,19,1,0,2103,74,141,45,78,338
ANGELOPOLIS,2021,12,ANTIOQUIA,770,1083,242,18,1,0,2114,75,142,45,78,340
ANGELOPOLIS,2021,2,ANTIOQUIA,752,1059,237,16,1,0,2065,74,145,45,78,342
ANGELOPOLIS,2021,3,ANTIOQUIA,758,1061,239,16,1,0,2075,74,145,45,78,342
ANGELOPOLIS,2021,4,ANTIOQUIA,759,1067,243,16,1,0,2086,73,145,45,78,341
ANGELOPOLIS,2021,5,ANTIOQUIA,761,1067,242,19,1,0,2090,71,144,45,78,338
ANGELOPOLIS,2021,6,ANTIOQUIA,761,1069,242,19,1,0,2092,71,144,45,78,338
ANGELOPOLIS,2021,7,ANTIOQUIA,761,1069,242,20,1,0,2093,72,144,45,78,339
ANGELOPOLIS,2021,8,ANTIOQUIA,762,1076,242,19,1,0,2100,72,144,45,78,339
ANGELOPOLIS,2021,9,ANTIOQUIA,762,1076,243,19,1,0,2101,72,143,45,78,338
ANGELOPOLIS,2022,1,ANTIOQUIA,772,1083,242,18,1,0,2116,75,142,45,78,340
ANGELOPOLIS,2022,10,ANTIOQUIA,804,1100,238,16,1,0,2159,69,145,46,78,338
ANGELOPOLIS,2022,11,ANTIOQUIA,808,1101,238,16,1,0,2164,69,145,46,78,338
ANGELOPOLIS,2022,12,ANTIOQUIA,810,1103,238,16,1,0,2168,69,145,46,78,338
ANGELOPOLIS,2022,2,ANTIOQUIA,777,1088,242,18,1,0,2126,74,140,45,78,337
ANGELOPOLIS,2022,3,ANTIOQUIA,783,1091,242,15,1,0,2132,72,142,46,78,338
ANGELOPOLIS,2022,4,ANTIOQUIA,781,1098,242,15,1,0,2137,72,142,46,78,338
ANGELOPOLIS,2022,5,ANTIOQUIA,782,1099,242,15,1,0,2139,71,142,46,78,337
ANGELOPOLIS,2022,6,ANTIOQUIA,793,1093,239,15,1,0,2141,71,143,46,78,338
ANGELOPOLIS,2022,7,ANTIOQUIA,797,1093,239,15,1,0,2145,71,143,46,78,338
ANGELOPOLIS,2022,8,ANTIOQUIA,797,1094,238,15,1,0,2145,69,144,46,78,337
ANGELOPOLIS,2022,9,ANTIOQUIA,797,1096,238,15,1,0,2147,69,144,47,78,338
ANGELOPOLIS,2023,1,ANTIOQUIA,814,1108,238,16,1,0,2177,69,145,46,78,338
ANGELOPOLIS,2023,2,ANTIOQUIA,816,1113,238,17,1,0,2185,70,143,46,78,337
ANGELOPOLIS,2023,3,ANTIOQUIA,823,1117,238,16,1,0,2195,69,144,46,79,338
ANGELOPOLIS,2023,4,ANTIOQUIA,831,1117,238,16,1,0,2203,70,144,46,79,339
ANGELOPOLIS,2023,5,ANTIOQUIA,842,1124,238,16,1,0,2221,70,143,46,79,338
ANGELOPOLIS,2023,6,ANTIOQUIA,844,1119,238,16,1,0,2218,63,141,46,79,329
ANGELOPOLIS,2023,7,ANTIOQUIA,847,1124,238,16,1,0,2226,63,141,46,79,329
ANGELOPOLIS,2023,8,ANTIOQUIA,853,1128,237,15,1,0,2234,63,141,46,79,329
ANGELOPOLIS,2023,9,ANTIOQUIA,859,1127,238,15,1,0,2240,63,141,46,79,329
ANGOSTURA,2018,1,ANTIOQUIA,2187,1652,310,5,0,0,4154,59,234,73,3,369
ANGOSTURA,2018,10,ANTIOQUIA,2211,1653,309,4,0,0,4177,59,240,73,3,375
ANGOSTURA,2018,11,ANTIOQUIA,2207,1653,310,4,0,0,4174,59,240,73,3,375
ANGOSTURA,2018,12,ANTIOQUIA,2213,1652,310,4,0,0,4179,60,240,73,3,376
ANGOSTURA,2018,2,ANTIOQUIA,2189,1651,309,5,0,0,4154,59,234,73,3,369
ANGOSTURA,2018,3,ANTIOQUIA,2192,1651,309,5,0,0,4157,59,234,73,3,369
ANGOSTURA,2018,4,ANTIOQUIA,2194,1651,310,5,0,0,4160,59,234,73,3,369
ANGOSTURA,2018,5,ANTIOQUIA,2201,1648,310,4,0,0,4163,59,235,73,3,370
ANGOSTURA,2018,6,ANTIOQUIA,2204,1645,310,4,0,0,4163,59,235,73,3,370
ANGOSTURA,2018,7,ANTIOQUIA,2206,1647,308,4,0,0,4165,60,238,73,3,374
ANGOSTURA,2018,8,ANTIOQUIA,2211,1652,311,4,0,0,4178,60,238,73,3,374
ANGOSTURA,2018,9,ANTIOQUIA,2205,1648,311,4,0,0,4168,59,237,73,3,372
ANGOSTURA,2019,1,ANTIOQUIA,2211,1652,310,4,0,0,4177,62,241,73,3,379
ANGOSTURA,2019,10,ANTIOQUIA,2340,1668,319,5,0,0,4332,63,248,74,3,388
ANGOSTURA,2019,11,ANTIOQUIA,2345,1667,330,4,0,0,4346,63,248,74,3,388
ANGOSTURA,2019,12,ANTIOQUIA,2357,1673,329,6,0,0,4365,65,250,74,3,392
ANGOSTURA,2019,2,ANTIOQUIA,2214,1656,311,4,0,0,4185,60,241,73,3,377
ANGOSTURA,2019,3,ANTIOQUIA,2257,1658,313,4,0,0,4232,60,243,73,3,379
ANGOSTURA,2019,4,ANTIOQUIA,2310,1659,314,4,0,0,4287,60,244,73,3,380
ANGOSTURA,2019,5,ANTIOQUIA,2348,1666,318,4,0,0,4336,63,247,74,3,387
ANGOSTURA,2019,6,ANTIOQUIA,2332,1663,318,4,0,0,4317,62,248,74,3,387
ANGOSTURA,2019,7,ANTIOQUIA,2332,1665,316,4,0,0,4317,62,249,74,3,388
ANGOSTURA,2019,8,ANTIOQUIA,2337,1664,316,4,0,0,4321,63,249,74,3,389
ANGOSTURA,2019,9,ANTIOQUIA,2340,1666,317,5,0,0,4328,65,248,74,3,390
ANGOSTURA,2020,1,ANTIOQUIA,2349,1669,328,7,0,0,4353,65,248,74,3,390
ANGOSTURA,2020,10,ANTIOQUIA,2426,1693,330,22,0,0,4471,67,247,74,59,447
ANGOSTURA,2020,11,ANTIOQUIA,2426,1694,330,20,0,0,4470,67,249,74,59,449
ANGOSTURA,2020,12,ANTIOQUIA,2429,1696,331,24,0,0,4480,67,248,74,59,448
ANGOSTURA,2020,2,ANTIOQUIA,2355,1676,330,11,0,0,4372,66,247,76,59,448
ANGOSTURA,2020,3,ANTIOQUIA,2361,1677,330,11,0,0,4379,66,247,76,58,447
ANGOSTURA,2020,4,ANTIOQUIA,2363,1675,329,6,0,0,4373,66,249,74,59,448
ANGOSTURA,2020,5,ANTIOQUIA,2389,1679,330,6,0,0,4404,66,249,74,59,448
ANGOSTURA,2020,6,ANTIOQUIA,2389,1682,330,9,0,0,4410,66,248,74,59,447
ANGOSTURA,2020,7,ANTIOQUIA,2396,1685,331,8,0,0,4420,66,249,74,59,448
ANGOSTURA,2020,8,ANTIOQUIA,2414,1687,331,9,0,0,4441,66,248,74,59,447
ANGOSTURA,2020,9,ANTIOQUIA,2426,1690,330,14,0,0,4460,66,248,74,59,447
ANGOSTURA,2021,1,ANTIOQUIA,2431,1704,330,16,0,0,4481,67,251,74,59,451
ANGOSTURA,2021,10,ANTIOQUIA,2443,1722,331,20,0,0,4516,68,252,74,59,453
ANGOSTURA,2021,11,ANTIOQUIA,2443,1722,331,20,0,0,4516,68,250,74,59,451
ANGOSTURA,2021,12,ANTIOQUIA,2453,1723,332,20,0,0,4528,68,250,74,59,451
ANGOSTURA,2021,2,ANTIOQUIA,2436,1708,330,22,0,0,4496,67,251,74,59,451
ANGOSTURA,2021,3,ANTIOQUIA,2440,1711,330,21,0,0,4502,67,251,74,59,451
ANGOSTURA,2021,4,ANTIOQUIA,2443,1712,331,18,0,0,4504,67,252,74,59,452
ANGOSTURA,2021,5,ANTIOQUIA,2443,1718,331,18,0,0,4510,67,252,74,59,452
ANGOSTURA,2021,6,ANTIOQUIA,2444,1716,331,17,0,0,4508,67,252,74,59,452
ANGOSTURA,2021,7,ANTIOQUIA,2447,1717,330,17,0,0,4511,68,252,74,59,453
ANGOSTURA,2021,8,ANTIOQUIA,2443,1719,330,18,0,0,4510,68,252,74,58,452
ANGOSTURA,2021,9,ANTIOQUIA,2445,1721,331,19,0,0,4516,68,252,74,59,453
ANGOSTURA,2022,1,ANTIOQUIA,2452,1723,332,22,0,0,4529,68,251,75,59,453
ANGOSTURA,2022,10,ANTIOQUIA,2362,1506,304,15,0,0,4187,62,235,72,59,428
ANGOSTURA,2022,11,ANTIOQUIA,2355,1507,304,32,0,0,4198,62,235,72,59,428
ANGOSTURA,2022,12,ANTIOQUIA,2355,1506,305,32,0,0,4198,62,234,72,59,427
ANGOSTURA,2022,2,ANTIOQUIA,2458,1725,332,21,0,0,4536,68,249,75,59,451
ANGOSTURA,2022,3,ANTIOQUIA,2465,1728,334,18,0,0,4545,68,248,75,59,450
ANGOSTURA,2022,4,ANTIOQUIA,2472,1732,335,17,0,0,4556,68,249,75,59,451
ANGOSTURA,2022,5,ANTIOQUIA,2439,1628,328,15,0,0,4410,65,239,72,59,435
ANGOSTURA,2022,6,ANTIOQUIA,2390,1494,306,18,0,0,4208,62,234,72,59,427
ANGOSTURA,2022,7,ANTIOQUIA,2352,1494,304,17,0,0,4167,62,233,72,59,426
ANGOSTURA,2022,8,ANTIOQUIA,2360,1500,304,15,0,0,4179,62,234,72,59,427
ANGOSTURA,2022,9,ANTIOQUIA,2361,1501,305,15,0,0,4182,62,234,72,59,427
ANGOSTURA,2023,1,ANTIOQUIA,2355,1509,305,39,0,0,4208,62,234,72,59,427
ANGOSTURA,2023,2,ANTIOQUIA,2365,1521,308,31,0,0,4225,62,234,72,59,427
ANGOSTURA,2023,3,ANTIOQUIA,2373,1524,306,34,0,0,4237,62,233,72,59,426
ANGOSTURA,2023,4,ANTIOQUIA,2377,1525,306,37,0,0,4245,62,235,72,59,428
ANGOSTURA,2023,5,ANTIOQUIA,2381,1530,315,36,0,0,4262,61,234,73,59,427
ANGOSTURA,2023,6,ANTIOQUIA,2393,1538,314,37,0,0,4282,61,234,72,59,426
ANGOSTURA,2023,7,ANTIOQUIA,2395,1535,314,34,0,0,4278,61,234,73,60,428
ANGOSTURA,2023,8,ANTIOQUIA,2394,1541,313,34,0,0,4282,63,235,72,60,430
ANGOSTURA,2023,9,ANTIOQUIA,2400,1541,313,37,0,0,4291,63,235,72,60,430
ANORI,2018,1,ANTIOQUIA,1784,2038,640,10,1,0,4473,37,366,96,9,508
ANORI,2018,10,ANTIOQUIA,1999,2175,638,17,0,0,4829,36,375,98,7,516
ANORI,2018,11,ANTIOQUIA,1991,2173,638,18,0,0,4820,36,372,99,8,515
ANORI,2018,12,ANTIOQUIA,1982,2175,638,19,0,0,4814,35,370,99,8,512
ANORI,2018,2,ANTIOQUIA,1789,2043,642,10,1,0,4485,36,364,96,9,505
ANORI,2018,3,ANTIOQUIA,1796,2050,643,9,1,0,4499,36,363,96,9,504
ANORI,2018,4,ANTIOQUIA,1796,2050,643,9,1,0,4499,36,363,95,9,503
ANORI,2018,5,ANTIOQUIA,1782,2053,643,9,0,0,4487,36,361,96,9,502
ANORI,2018,6,ANTIOQUIA,1856,2077,642,9,0,0,4584,36,363,95,9,503
ANORI,2018,7,ANTIOQUIA,1882,2117,642,12,0,0,4653,36,369,96,9,510
ANORI,2018,8,ANTIOQUIA,2026,2151,641,20,0,0,4838,36,376,96,9,517
ANORI,2018,9,ANTIOQUIA,1988,2158,636,15,0,0,4797,37,375,97,7,516
ANORI,2019,1,ANTIOQUIA,1999,2180,639,17,0,0,4835,35,371,99,8,513
ANORI,2019,10,ANTIOQUIA,2136,2235,646,18,0,0,5035,34,369,103,9,515
ANORI,2019,11,ANTIOQUIA,2134,2243,646,19,0,0,5042,35,367,103,9,514
ANORI,2019,12,ANTIOQUIA,2145,2251,646,20,0,0,5062,36,368,103,9,516
ANORI,2019,2,ANTIOQUIA,1997,2186,640,16,0,0,4839,36,370,100,8,514
ANORI,2019,3,ANTIOQUIA,2050,2197,640,16,0,0,4903,36,372,101,8,517
ANORI,2019,4,ANTIOQUIA,2079,2202,641,16,0,0,4938,35,368,101,9,513
ANORI,2019,5,ANTIOQUIA,2094,2207,645,16,0,0,4962,35,369,102,9,515
ANORI,2019,6,ANTIOQUIA,2119,2205,644,16,0,0,4984,36,369,101,9,515
ANORI,2019,7,ANTIOQUIA,2127,2213,646,17,0,0,5003,35,370,102,9,516
ANORI,2019,8,ANTIOQUIA,2126,2216,644,17,0,0,5003,34,367,102,9,512
ANORI,2019,9,ANTIOQUIA,2137,2229,646,17,0,0,5029,35,368,103,9,515
ANORI,2020,1,ANTIOQUIA,2143,2253,645,27,0,0,5068,35,367,103,9,514
ANORI,2020,10,ANTIOQUIA,2213,2365,631,20,0,0,5229,36,385,104,53,578
ANORI,2020,11,ANTIOQUIA,2208,2364,627,19,0,0,5218,36,392,104,53,585
ANORI,2020,12,ANTIOQUIA,2208,2373,627,19,0,0,5227,36,391,104,53,584
ANORI,2020,2,ANTIOQUIA,2143,2258,645,33,0,0,5079,37,368,110,53,568
ANORI,2020,3,ANTIOQUIA,2145,2258,646,33,0,0,5082,36,368,111,53,568
ANORI,2020,4,ANTIOQUIA,2144,2267,644,21,0,0,5076,36,375,104,53,568
ANORI,2020,5,ANTIOQUIA,2243,2273,644,22,0,0,5182,36,378,105,53,572
ANORI,2020,6,ANTIOQUIA,2154,2293,644,20,0,0,5111,36,378,104,53,571
ANORI,2020,7,ANTIOQUIA,2161,2339,644,19,0,0,5163,36,377,104,53,570
ANORI,2020,8,ANTIOQUIA,2252,2356,641,19,0,0,5268,36,376,104,53,569
ANORI,2020,9,ANTIOQUIA,2233,2359,639,20,0,0,5251,36,377,104,53,570
ANORI,2021,1,ANTIOQUIA,2246,2378,626,19,0,0,5269,36,390,104,53,583
ANORI,2021,10,ANTIOQUIA,2322,2490,618,20,0,0,5450,36,394,104,53,587
ANORI,2021,11,ANTIOQUIA,2325,2490,616,21,0,0,5452,36,394,104,53,587
ANORI,2021,12,ANTIOQUIA,2338,2508,616,21,0,0,5483,36,395,104,53,588
ANORI,2021,2,ANTIOQUIA,2249,2400,626,17,0,0,5292,36,391,104,53,584
ANORI,2021,3,ANTIOQUIA,2254,2408,626,18,0,0,5306,36,391,104,53,584
ANORI,2021,4,ANTIOQUIA,2266,2451,624,18,0,0,5359,36,391,104,53,584
ANORI,2021,5,ANTIOQUIA,2265,2464,623,18,0,0,5370,36,391,104,53,584
ANORI,2021,6,ANTIOQUIA,2292,2473,625,18,0,0,5408,36,392,104,53,585
ANORI,2021,7,ANTIOQUIA,2315,2467,624,20,0,0,5426,36,393,104,53,586
ANORI,2021,8,ANTIOQUIA,2322,2475,623,22,0,0,5442,36,394,104,52,586
ANORI,2021,9,ANTIOQUIA,2321,2490,619,20,0,0,5450,36,394,104,53,587
ANORI,2022,1,ANTIOQUIA,2336,2511,615,21,0,0,5483,36,395,104,53,588
ANORI,2022,10,ANTIOQUIA,2359,2578,610,23,0,0,5570,34,406,106,54,600
ANORI,2022,11,ANTIOQUIA,2366,2581,610,22,0,0,5579,34,406,100,54,594
ANORI,2022,12,ANTIOQUIA,2369,2583,611,23,0,0,5586,32,406,100,54,592
ANORI,2022,2,ANTIOQUIA,2339,2530,614,23,0,0,5506,36,399,104,53,592
ANORI,2022,3,ANTIOQUIA,2342,2536,612,22,0,0,5512,35,399,105,53,592
ANORI,2022,4,ANTIOQUIA,2346,2543,613,29,0,0,5531,35,400,105,53,593
ANORI,2022,5,ANTIOQUIA,2348,2555,612,27,0,0,5542,35,399,105,53,592
ANORI,2022,6,ANTIOQUIA,2349,2560,611,28,0,0,5548,35,398,105,53,591
ANORI,2022,7,ANTIOQUIA,2350,2555,610,29,0,0,5544,35,398,105,53,591
ANORI,2022,8,ANTIOQUIA,2356,2574,611,24,0,0,5565,35,402,105,53,595
ANORI,2022,9,ANTIOQUIA,2354,2572,611,24,0,0,5561,35,403,103,54,595
ANORI,2023,1,ANTIOQUIA,2377,2599,608,22,0,0,5606,32,410,99,54,595
ANORI,2023,2,ANTIOQUIA,2403,2612,604,27,0,0,5646,31,412,99,54,596
ANORI,2023,3,ANTIOQUIA,2410,2629,603,27,0,0,5669,31,414,99,54,598
ANORI,2023,4,ANTIOQUIA,2417,2638,600,28,0,0,5683,31,413,99,54,597
ANORI,2023,5,ANTIOQUIA,2429,2663,593,28,0,0,5713,31,409,99,54,593
ANORI,2023,6,ANTIOQUIA,2438,2673,596,28,0,0,5735,31,413,99,54,597
ANORI,2023,7,ANTIOQUIA,2443,2684,595,30,0,0,5752,31,412,99,54,596
ANORI,2023,8,ANTIOQUIA,2452,2689,596,30,0,0,5767,31,413,99,54,597
ANORI,2023,9,ANTIOQUIA,2462,2695,596,30,0,0,5783,31,413,99,54,597
ANZA,2018,1,ANTIOQUIA,1064,1198,331,7,0,1,2601,9,123,46,8,186
ANZA,2018,10,ANTIOQUIA,1128,1226,333,8,1,1,2697,9,121,46,8,184
ANZA,2018,11,ANTIOQUIA,1137,1226,336,8,1,1,2709,7,120,46,8,181
ANZA,2018,12,ANTIOQUIA,1302,1155,252,7,1,1,2718,7,120,46,8,181
ANZA,2018,2,ANTIOQUIA,1069,1197,333,8,1,1,2609,9,122,46,8,185
ANZA,2018,3,ANTIOQUIA,1073,1200,332,8,1,1,2615,9,122,46,8,185
ANZA,2018,4,ANTIOQUIA,1077,1208,332,8,1,1,2627,9,122,46,8,185
ANZA,2018,5,ANTIOQUIA,1063,1210,333,8,1,1,2616,9,121,46,8,184
ANZA,2018,6,ANTIOQUIA,1073,1209,330,8,1,1,2622,9,120,46,8,183
ANZA,2018,7,ANTIOQUIA,1078,1216,331,7,1,1,2634,9,121,46,8,184
ANZA,2018,8,ANTIOQUIA,1103,1220,332,7,1,1,2664,9,121,46,8,184
ANZA,2018,9,ANTIOQUIA,1114,1224,333,7,1,1,2680,7,121,46,8,182
ANZA,2019,1,ANTIOQUIA,1303,1157,252,8,1,1,2722,8,120,46,8,182
ANZA,2019,10,ANTIOQUIA,1334,1168,250,8,1,1,2762,6,120,47,7,180
ANZA,2019,11,ANTIOQUIA,1334,1171,250,8,1,1,2765,6,120,47,7,180
ANZA,2019,12,ANTIOQUIA,1342,1172,249,8,1,1,2773,6,120,47,7,180
ANZA,2019,2,ANTIOQUIA,1307,1157,254,8,1,1,2728,8,120,46,8,182
ANZA,2019,3,ANTIOQUIA,1313,1154,253,8,1,1,2730,7,121,46,8,182
ANZA,2019,4,ANTIOQUIA,1315,1154,252,8,1,1,2731,6,121,46,8,181
ANZA,2019,5,ANTIOQUIA,1315,1168,252,8,1,1,2745,6,121,46,8,181
ANZA,2019,6,ANTIOQUIA,1316,1165,251,8,1,1,2742,6,121,46,7,180
ANZA,2019,7,ANTIOQUIA,1319,1167,249,7,1,1,2744,6,121,46,7,180
ANZA,2019,8,ANTIOQUIA,1323,1170,249,7,1,1,2751,6,121,46,7,180
ANZA,2019,9,ANTIOQUIA,1331,1167,249,7,1,1,2756,6,120,47,7,180
ANZA,2020,1,ANTIOQUIA,1341,1172,248,13,1,1,2776,6,120,47,7,180
ANZA,2020,10,ANTIOQUIA,1372,1198,249,8,1,1,2829,8,125,47,36,216
ANZA,2020,11,ANTIOQUIA,1373,1200,249,8,1,1,2832,8,125,47,36,216
ANZA,2020,12,ANTIOQUIA,1383,1199,250,8,1,1,2842,9,125,47,36,217
ANZA,2020,2,ANTIOQUIA,1336,1177,247,16,1,1,2778,7,120,52,36,215
ANZA,2020,3,ANTIOQUIA,1337,1179,247,16,1,1,2781,7,120,52,35,214
ANZA,2020,4,ANTIOQUIA,1342,1180,248,8,1,1,2780,7,125,47,36,215
ANZA,2020,5,ANTIOQUIA,1377,1197,249,8,1,1,2833,8,125,47,36,216
ANZA,2020,6,ANTIOQUIA,1356,1186,248,8,1,1,2800,8,125,47,36,216
ANZA,2020,7,ANTIOQUIA,1370,1194,248,8,1,1,2822,8,125,47,36,216
ANZA,2020,8,ANTIOQUIA,1372,1195,249,8,1,1,2826,8,125,47,36,216
ANZA,2020,9,ANTIOQUIA,1374,1193,249,8,1,1,2826,8,125,47,36,216
ANZA,2021,1,ANTIOQUIA,1382,1204,250,8,1,1,2846,9,125,47,36,217
ANZA,2021,10,ANTIOQUIA,1405,1227,252,8,1,1,2894,9,128,48,36,221
ANZA,2021,11,ANTIOQUIA,1409,1229,252,7,1,1,2899,9,128,48,36,221
ANZA,2021,12,ANTIOQUIA,1414,1228,252,8,1,1,2904,9,128,48,36,221
ANZA,2021,2,ANTIOQUIA,1388,1209,251,8,1,1,2858,9,125,47,36,217
ANZA,2021,3,ANTIOQUIA,1391,1208,251,8,1,1,2860,9,125,48,36,218
ANZA,2021,4,ANTIOQUIA,1392,1212,251,8,1,1,2865,9,125,48,36,218
ANZA,2021,5,ANTIOQUIA,1395,1223,251,8,1,1,2879,9,127,48,35,219
ANZA,2021,6,ANTIOQUIA,1398,1223,251,8,1,1,2882,9,127,48,36,220
ANZA,2021,7,ANTIOQUIA,1397,1224,251,8,1,1,2882,9,127,48,36,220
ANZA,2021,8,ANTIOQUIA,1395,1224,251,8,1,1,2880,9,128,48,36,221
ANZA,2021,9,ANTIOQUIA,1400,1224,251,8,1,1,2885,9,128,48,36,221
ANZA,2022,1,ANTIOQUIA,1418,1233,254,8,1,1,2915,9,130,48,36,223
ANZA,2022,10,ANTIOQUIA,1456,1252,255,7,1,1,2972,8,130,50,36,224
ANZA,2022,11,ANTIOQUIA,1459,1255,255,8,1,1,2979,8,132,50,36,226
ANZA,2022,12,ANTIOQUIA,1460,1257,255,8,1,1,2982,8,132,50,36,226
ANZA,2022,2,ANTIOQUIA,1421,1237,256,8,1,1,2924,9,129,48,36,222
ANZA,2022,3,ANTIOQUIA,1425,1242,257,7,1,1,2933,8,129,49,36,222
ANZA,2022,4,ANTIOQUIA,1429,1247,256,8,1,1,2942,8,129,49,36,222
ANZA,2022,5,ANTIOQUIA,1429,1256,257,8,1,1,2952,8,130,49,36,223
ANZA,2022,6,ANTIOQUIA,1447,1254,257,7,1,1,2967,8,130,49,36,223
ANZA,2022,7,ANTIOQUIA,1443,1248,255,7,1,1,2955,8,131,49,36,224
ANZA,2022,8,ANTIOQUIA,1442,1249,255,6,1,1,2954,8,131,49,36,224
ANZA,2022,9,ANTIOQUIA,1449,1247,255,6,1,1,2959,8,131,49,36,224
ANZA,2023,1,ANTIOQUIA,1463,1264,256,8,1,1,2993,8,134,50,36,228
ANZA,2023,2,ANTIOQUIA,1462,1272,257,6,1,1,2999,8,134,50,36,228
ANZA,2023,3,ANTIOQUIA,1475,1276,258,6,1,1,3017,9,135,50,36,230
ANZA,2023,4,ANTIOQUIA,1481,1285,260,6,1,1,3034,9,136,50,36,231
ANZA,2023,5,ANTIOQUIA,1486,1286,260,7,1,1,3041,9,135,50,36,230
ANZA,2023,6,ANTIOQUIA,1480,1291,259,7,1,1,3039,8,134,50,36,228
ANZA,2023,7,ANTIOQUIA,1489,1292,260,7,1,1,3050,8,135,50,36,229
ANZA,2023,8,ANTIOQUIA,1484,1295,260,7,1,1,3048,8,134,50,36,228
ANZA,2023,9,ANTIOQUIA,1486,1293,260,7,1,1,3048,8,135,50,36,229
APARTADO,2018,1,ANTIOQUIA,17065,10680,6729,1437,1,0,35912,196,3479,544,61,4280
APARTADO,2018,10,ANTIOQUIA,17655,10973,6873,1452,1,0,36954,198,3612,529,64,4403
APARTADO,2018,11,ANTIOQUIA,17759,10990,6874,1454,1,0,37078,197,3670,529,63,4459
APARTADO,2018,12,ANTIOQUIA,17904,11020,6898,1456,1,0,37279,204,3711,530,63,4508
APARTADO,2018,2,ANTIOQUIA,17157,10729,6760,1441,1,0,36088,194,3509,543,61,4307
APARTADO,2018,3,ANTIOQUIA,17192,10756,6784,1446,1,0,36179,190,3525,544,61,4320
APARTADO,2018,4,ANTIOQUIA,17304,10803,6794,1449,1,0,36351,192,3542,527,61,4322
APARTADO,2018,5,ANTIOQUIA,17295,10811,6801,1441,1,0,36349,189,3526,527,63,4305
APARTADO,2018,6,ANTIOQUIA,17377,10836,6819,1443,1,0,36476,189,3521,527,62,4299
APARTADO,2018,7,ANTIOQUIA,17449,10858,6831,1442,1,0,36581,190,3540,528,62,4320
APARTADO,2018,8,ANTIOQUIA,17537,10896,6846,1441,1,0,36721,192,3627,530,63,4412
APARTADO,2018,9,ANTIOQUIA,17516,10909,6854,1448,1,0,36728,193,3600,529,61,4383
APARTADO,2019,1,ANTIOQUIA,17971,11054,6905,1460,1,0,37391,205,3724,530,62,4521
APARTADO,2019,10,ANTIOQUIA,18556,11169,7085,1511,1,0,38322,215,3797,535,61,4608
APARTADO,2019,11,ANTIOQUIA,18666,11208,7084,1513,1,0,38472,218,3805,535,61,4619
APARTADO,2019,12,ANTIOQUIA,18860,11345,7122,1518,1,0,38846,225,3866,534,61,4686
APARTADO,2019,2,ANTIOQUIA,18024,11081,6919,1461,1,0,37486,204,3726,531,62,4523
APARTADO,2019,3,ANTIOQUIA,18077,11100,6926,1467,1,0,37571,207,3735,531,62,4535
APARTADO,2019,4,ANTIOQUIA,18133,11120,6942,1473,1,0,37669,204,3734,531,62,4531
APARTADO,2019,5,ANTIOQUIA,18229,11139,6953,1480,1,0,37802,212,3741,530,64,4547
APARTADO,2019,6,ANTIOQUIA,18313,11155,6962,1483,1,0,37914,210,3752,531,63,4556
APARTADO,2019,7,ANTIOQUIA,18374,11189,6971,1504,1,0,38039,211,3749,535,63,4558
APARTADO,2019,8,ANTIOQUIA,18439,11209,6977,1504,1,0,38130,212,3763,535,63,4573
APARTADO,2019,9,ANTIOQUIA,18506,11232,6984,1508,1,0,38231,213,3789,535,62,4599
APARTADO,2020,1,ANTIOQUIA,18814,11331,7105,1551,1,0,38802,214,3820,534,61,4629
APARTADO,2020,10,ANTIOQUIA,19601,11713,7200,1704,1,0,40219,221,3961,533,804,5519
APARTADO,2020,11,ANTIOQUIA,19660,11803,7211,1710,1,0,40385,225,3993,534,804,5556
APARTADO,2020,12,ANTIOQUIA,19728,11831,7213,1710,1,0,40483,225,3999,534,803,5561
APARTADO,2020,2,ANTIOQUIA,18862,11358,7124,1555,1,0,38900,215,4148,281,803,5447
APARTADO,2020,3,ANTIOQUIA,18932,11382,7132,1560,1,0,39007,217,4147,281,803,5448
APARTADO,2020,4,ANTIOQUIA,19038,11467,7131,1525,1,0,39162,219,3912,534,803,5468
APARTADO,2020,5,ANTIOQUIA,19230,11521,7142,1551,3,0,39447,228,4238,230,803,5499
APARTADO,2020,6,ANTIOQUIA,19222,11575,7145,1682,1,0,39625,220,3927,534,803,5484
APARTADO,2020,7,ANTIOQUIA,19308,11623,7183,1679,1,0,39794,220,3932,534,803,5489
APARTADO,2020,8,ANTIOQUIA,19427,11645,7184,1678,1,0,39935,220,3935,533,803,5491
APARTADO,2020,9,ANTIOQUIA,19526,11696,7194,1695,1,0,40112,222,3951,533,804,5510
APARTADO,2021,1,ANTIOQUIA,19807,11862,7222,1706,1,0,40598,225,4014,535,802,5576
APARTADO,2021,10,ANTIOQUIA,20567,12414,7309,1639,1,0,41930,227,4128,534,798,5687
APARTADO,2021,11,ANTIOQUIA,20568,12427,7320,1641,1,0,41957,226,4128,534,798,5686
APARTADO,2021,12,ANTIOQUIA,20689,12555,7340,1635,1,0,42220,227,4155,532,798,5712
APARTADO,2021,2,ANTIOQUIA,19899,11879,7226,1711,1,1,40717,228,4026,535,801,5590
APARTADO,2021,3,ANTIOQUIA,20010,11923,7251,1715,1,1,40901,229,4043,535,801,5608
APARTADO,2021,4,ANTIOQUIA,20081,11950,7256,1740,1,1,41029,228,4048,535,801,5612
APARTADO,2021,5,ANTIOQUIA,20164,11991,7260,1740,1,1,41157,229,4063,535,800,5627
APARTADO,2021,6,ANTIOQUIA,20257,12056,7271,1739,1,0,41324,226,4067,535,800,5628
APARTADO,2021,7,ANTIOQUIA,20350,12185,7284,1742,1,0,41562,227,4070,535,800,5632
APARTADO,2021,8,ANTIOQUIA,20434,12330,7293,1640,1,0,41698,227,4105,534,798,5664
APARTADO,2021,9,ANTIOQUIA,20478,12370,7306,1641,1,0,41796,226,4111,534,799,5670
APARTADO,2022,1,ANTIOQUIA,20771,12581,7343,1639,1,0,42335,230,4159,537,798,5724
APARTADO,2022,10,ANTIOQUIA,21493,13043,7466,1670,1,0,43673,236,4234,538,798,5806
APARTADO,2022,11,ANTIOQUIA,21571,13083,7518,1668,1,0,43841,238,4247,538,798,5821
APARTADO,2022,12,ANTIOQUIA,21630,13104,7522,1671,1,0,43928,239,4256,538,798,5831
APARTADO,2022,2,ANTIOQUIA,20845,12604,7343,1640,1,0,42433,230,4172,537,798,5737
APARTADO,2022,3,ANTIOQUIA,20952,12658,7347,1647,1,0,42605,227,4170,539,796,5732
APARTADO,2022,4,ANTIOQUIA,21037,12688,7356,1657,1,0,42739,228,4185,539,796,5748
APARTADO,2022,5,ANTIOQUIA,21078,12730,7366,1657,1,0,42832,229,4169,539,798,5735
APARTADO,2022,6,ANTIOQUIA,21164,12809,7422,1660,1,0,43056,234,4171,539,798,5742
APARTADO,2022,7,ANTIOQUIA,21239,12831,7440,1661,1,0,43172,233,4183,538,797,5751
APARTADO,2022,8,ANTIOQUIA,21350,12885,7447,1659,1,0,43342,233,4200,538,797,5768
APARTADO,2022,9,ANTIOQUIA,21442,13031,7454,1666,1,0,43594,234,4209,538,797,5778
APARTADO,2023,1,ANTIOQUIA,21670,13383,7520,1671,1,0,44245,237,4259,539,798,5833
APARTADO,2023,2,ANTIOQUIA,21764,13421,7532,1672,1,0,44390,236,4277,539,798,5850
APARTADO,2023,3,ANTIOQUIA,21907,13451,7537,1665,1,0,44561,237,4296,539,799,5871
APARTADO,2023,4,ANTIOQUIA,22125,13463,7536,1667,1,0,44792,241,4310,541,799,5891
APARTADO,2023,5,ANTIOQUIA,22213,13601,7559,1660,1,0,45034,241,4330,541,800,5912
APARTADO,2023,6,ANTIOQUIA,22214,13486,7549,1737,1,0,44987,239,4310,540,801,5890
APARTADO,2023,7,ANTIOQUIA,22266,13493,7550,1733,1,0,45043,240,4318,542,801,5901
APARTADO,2023,8,ANTIOQUIA,22417,13500,7555,1727,1,0,45200,243,4342,542,803,5930
APARTADO,2023,9,ANTIOQUIA,22485,13524,7559,1733,1,0,45302,240,4349,542,807,5938
ARBOLETES,2018,1,ANTIOQUIA,5985,1831,365,32,5,1,8219,10,337,75,33,455
ARBOLETES,2018,10,ANTIOQUIA,6173,1877,364,37,5,1,8457,10,335,74,33,452
ARBOLETES,2018,11,ANTIOQUIA,6170,1875,364,37,5,1,8452,10,329,75,33,447
ARBOLETES,2018,12,ANTIOQUIA,6189,1879,366,37,5,1,8477,10,331,75,33,449
ARBOLETES,2018,2,ANTIOQUIA,6017,1838,369,32,5,1,8262,10,329,76,33,448
ARBOLETES,2018,3,ANTIOQUIA,6060,1839,369,32,5,1,8306,10,336,76,33,455
ARBOLETES,2018,4,ANTIOQUIA,6110,1852,371,33,5,1,8372,10,335,76,33,454
ARBOLETES,2018,5,ANTIOQUIA,6045,1846,367,34,5,1,8298,10,334,75,33,452
ARBOLETES,2018,6,ANTIOQUIA,6096,1853,369,34,5,1,8358,10,333,74,33,450
ARBOLETES,2018,7,ANTIOQUIA,6137,1859,372,34,5,1,8408,10,335,74,33,452
ARBOLETES,2018,8,ANTIOQUIA,6164,1865,367,35,5,1,8437,10,338,74,33,455
ARBOLETES,2018,9,ANTIOQUIA,6147,1870,364,37,5,1,8424,10,335,74,33,452
ARBOLETES,2019,1,ANTIOQUIA,6183,1880,366,38,5,1,8473,10,329,75,33,447
ARBOLETES,2019,10,ANTIOQUIA,6619,1954,358,40,5,1,8977,9,338,77,33,457
ARBOLETES,2019,11,ANTIOQUIA,6648,1960,356,39,5,1,9009,9,337,77,33,456
ARBOLETES,2019,12,ANTIOQUIA,6732,1977,362,41,5,1,9118,9,351,77,34,471
ARBOLETES,2019,2,ANTIOQUIA,6276,1887,367,37,5,1,8573,10,328,76,33,447
ARBOLETES,2019,3,ANTIOQUIA,6301,1894,365,37,5,1,8603,10,333,76,33,452
ARBOLETES,2019,4,ANTIOQUIA,6467,1899,366,38,5,1,8776,9,332,76,33,450
ARBOLETES,2019,5,ANTIOQUIA,6625,1928,366,39,5,1,8964,9,338,76,33,456
ARBOLETES,2019,6,ANTIOQUIA,6536,1926,364,41,5,1,8873,9,337,76,33,455
ARBOLETES,2019,7,ANTIOQUIA,6563,1936,365,40,5,1,8910,9,334,76,33,452
ARBOLETES,2019,8,ANTIOQUIA,6565,1941,361,39,5,1,8912,9,336,77,33,455
ARBOLETES,2019,9,ANTIOQUIA,6602,1949,359,39,5,1,8955,9,337,77,33,456
ARBOLETES,2020,1,ANTIOQUIA,6690,1967,356,43,5,1,9062,10,336,77,33,456
ARBOLETES,2020,10,ANTIOQUIA,6854,1999,357,48,5,1,9264,13,370,78,355,816
ARBOLETES,2020,11,ANTIOQUIA,6870,2004,355,47,5,1,9282,13,371,78,355,817
ARBOLETES,2020,12,ANTIOQUIA,7007,2005,354,48,5,1,9420,14,372,78,355,819
ARBOLETES,2020,2,ANTIOQUIA,6730,2013,386,46,5,1,9181,12,356,109,355,832
ARBOLETES,2020,3,ANTIOQUIA,6785,2019,386,50,5,1,9246,12,356,109,355,832
ARBOLETES,2020,4,ANTIOQUIA,6714,1981,355,43,5,1,9099,12,367,77,355,811
ARBOLETES,2020,5,ANTIOQUIA,6722,1983,356,43,5,1,9110,12,366,77,354,809
ARBOLETES,2020,6,ANTIOQUIA,6710,1986,356,48,5,1,9106,12,368,77,355,812
ARBOLETES,2020,7,ANTIOQUIA,6732,1989,357,48,5,1,9132,12,367,77,355,811
ARBOLETES,2020,8,ANTIOQUIA,6836,1990,356,49,5,1,9237,12,369,78,355,814
ARBOLETES,2020,9,ANTIOQUIA,6881,1989,358,48,5,1,9282,12,368,78,355,813
ARBOLETES,2021,1,ANTIOQUIA,7040,2010,355,46,5,1,9457,16,370,78,355,819
ARBOLETES,2021,10,ANTIOQUIA,7449,2048,353,46,5,1,9902,17,390,75,355,837
ARBOLETES,2021,11,ANTIOQUIA,7447,2055,355,47,5,1,9910,17,392,74,355,838
ARBOLETES,2021,12,ANTIOQUIA,7499,2074,358,47,5,1,9984,17,396,74,355,842
ARBOLETES,2021,2,ANTIOQUIA,7137,2015,354,46,5,1,9558,16,372,78,355,821
ARBOLETES,2021,3,ANTIOQUIA,7295,2023,354,47,5,1,9725,17,372,78,355,822
ARBOLETES,2021,4,ANTIOQUIA,7441,2021,354,50,5,1,9872,17,372,78,355,822
ARBOLETES,2021,5,ANTIOQUIA,7463,2025,353,50,5,1,9897,17,377,77,355,826
ARBOLETES,2021,6,ANTIOQUIA,7466,2027,354,46,5,1,9899,17,377,77,355,826
ARBOLETES,2021,7,ANTIOQUIA,7479,2038,353,46,5,1,9922,17,381,77,355,830
ARBOLETES,2021,8,ANTIOQUIA,7457,2041,352,46,5,1,9902,17,384,77,355,833
ARBOLETES,2021,9,ANTIOQUIA,7441,2045,353,46,5,1,9891,17,389,77,355,838
ARBOLETES,2022,1,ANTIOQUIA,7480,2074,358,47,5,1,9965,17,395,74,355,841
ARBOLETES,2022,10,ANTIOQUIA,7663,2135,358,53,5,1,10215,14,409,75,356,854
ARBOLETES,2022,11,ANTIOQUIA,7687,2145,358,52,5,1,10248,13,413,75,356,857
ARBOLETES,2022,12,ANTIOQUIA,7704,2155,359,53,5,1,10277,13,412,75,356,856
ARBOLETES,2022,2,ANTIOQUIA,7500,2079,358,46,5,1,9989,16,395,74,355,840
ARBOLETES,2022,3,ANTIOQUIA,7524,2089,359,46,5,1,10024,14,394,76,355,839
ARBOLETES,2022,4,ANTIOQUIA,7551,2094,358,86,5,1,10095,14,397,76,356,843
ARBOLETES,2022,5,ANTIOQUIA,7534,2088,356,86,5,1,10070,14,394,76,356,840
ARBOLETES,2022,6,ANTIOQUIA,7558,2097,360,79,5,1,10100,14,396,76,356,842
ARBOLETES,2022,7,ANTIOQUIA,7580,2112,361,67,5,1,10126,14,397,75,356,842
ARBOLETES,2022,8,ANTIOQUIA,7620,2123,360,59,5,1,10168,14,398,76,356,844
ARBOLETES,2022,9,ANTIOQUIA,7638,2129,359,54,5,1,10186,14,404,75,356,849
ARBOLETES,2023,1,ANTIOQUIA,7725,2166,359,55,5,1,10311,13,416,74,356,859
ARBOLETES,2023,2,ANTIOQUIA,7788,2173,360,53,5,1,10380,14,418,74,356,862
ARBOLETES,2023,3,ANTIOQUIA,7812,2175,359,53,5,1,10405,13,419,75,355,862
ARBOLETES,2023,4,ANTIOQUIA,7824,2181,359,51,5,1,10421,13,422,75,355,865
ARBOLETES,2023,5,ANTIOQUIA,7842,2181,357,51,5,1,10437,15,425,76,355,871
ARBOLETES,2023,6,ANTIOQUIA,7868,2200,357,51,5,1,10482,14,425,76,355,870
ARBOLETES,2023,7,ANTIOQUIA,7891,2197,355,53,5,1,10502,14,427,76,356,873
ARBOLETES,2023,8,ANTIOQUIA,7926,2206,354,49,5,1,10541,16,432,76,356,880
ARBOLETES,2023,9,ANTIOQUIA,7932,2211,353,51,5,1,10553,16,433,76,356,881
ARGELIA,2018,1,ANTIOQUIA,1313,1296,98,1,0,0,2708,4,169,72,6,251
ARGELIA,2018,10,ANTIOQUIA,1353,1312,80,1,0,0,2746,5,167,70,5,247
ARGELIA,2018,11,ANTIOQUIA,1354,1312,81,1,0,0,2748,5,167,70,5,247
ARGELIA,2018,12,ANTIOQUIA,1357,1312,81,2,0,0,2752,5,168,70,5,248
ARGELIA,2018,2,ANTIOQUIA,1316,1297,97,1,0,0,2711,4,169,72,6,251
ARGELIA,2018,3,ANTIOQUIA,1323,1300,95,1,0,0,2719,4,170,71,6,251
ARGELIA,2018,4,ANTIOQUIA,1328,1303,92,1,0,0,2724,4,171,72,6,253
ARGELIA,2018,5,ANTIOQUIA,1331,1303,89,1,0,0,2724,4,171,70,6,251
ARGELIA,2018,6,ANTIOQUIA,1342,1300,87,1,0,0,2730,4,170,70,6,250
ARGELIA,2018,7,ANTIOQUIA,1348,1306,86,1,0,0,2741,4,170,70,6,250
ARGELIA,2018,8,ANTIOQUIA,1349,1309,85,1,0,0,2744,5,168,70,6,249
ARGELIA,2018,9,ANTIOQUIA,1350,1309,82,1,0,0,2742,5,167,70,5,247
ARGELIA,2019,1,ANTIOQUIA,1359,1315,80,2,0,0,2756,5,169,69,5,248
ARGELIA,2019,10,ANTIOQUIA,1384,1334,78,3,0,0,2799,6,171,69,5,251
ARGELIA,2019,11,ANTIOQUIA,1389,1338,77,3,0,0,2807,6,171,69,5,251
ARGELIA,2019,12,ANTIOQUIA,1394,1342,78,3,0,0,2817,6,172,69,5,252
ARGELIA,2019,2,ANTIOQUIA,1360,1320,80,2,0,0,2762,5,169,69,5,248
ARGELIA,2019,3,ANTIOQUIA,1367,1322,79,2,0,0,2770,5,170,69,5,249
ARGELIA,2019,4,ANTIOQUIA,1373,1319,79,2,0,0,2773,5,171,69,5,250
ARGELIA,2019,5,ANTIOQUIA,1384,1332,81,2,0,0,2799,5,171,69,5,250
ARGELIA,2019,6,ANTIOQUIA,1382,1322,77,2,0,0,2783,5,172,69,5,251
ARGELIA,2019,7,ANTIOQUIA,1381,1324,77,2,0,0,2784,5,172,69,5,251
ARGELIA,2019,8,ANTIOQUIA,1383,1331,77,2,0,0,2793,5,172,69,5,251
ARGELIA,2019,9,ANTIOQUIA,1384,1332,78,3,0,0,2797,6,171,69,5,251
ARGELIA,2020,1,ANTIOQUIA,1392,1340,76,7,0,0,2815,6,171,69,5,251
ARGELIA,2020,10,ANTIOQUIA,1430,1381,76,2,0,0,2889,7,176,69,33,285
ARGELIA,2020,11,ANTIOQUIA,1426,1378,76,3,0,0,2883,7,177,69,33,286
ARGELIA,2020,12,ANTIOQUIA,1430,1388,76,5,0,0,2899,7,177,69,33,286
ARGELIA,2020,2,ANTIOQUIA,1395,1342,76,7,0,0,2820,7,172,72,33,284
ARGELIA,2020,3,ANTIOQUIA,1395,1343,76,7,0,0,2821,7,172,72,33,284
ARGELIA,2020,4,ANTIOQUIA,1398,1348,75,2,0,0,2823,7,175,69,33,284
ARGELIA,2020,5,ANTIOQUIA,1407,1352,76,2,0,0,2837,7,175,69,33,284
ARGELIA,2020,6,ANTIOQUIA,1400,1350,75,2,0,0,2827,7,175,69,33,284
ARGELIA,2020,7,ANTIOQUIA,1410,1355,75,2,0,0,2842,7,175,69,33,284
ARGELIA,2020,8,ANTIOQUIA,1410,1357,75,2,0,0,2844,7,175,69,33,284
ARGELIA,2020,9,ANTIOQUIA,1417,1368,75,2,0,0,2862,7,175,69,33,284
ARGELIA,2021,1,ANTIOQUIA,1432,1393,76,5,0,0,2906,7,177,69,33,286
ARGELIA,2021,10,ANTIOQUIA,1483,1432,72,6,0,0,2993,7,180,68,33,288
ARGELIA,2021,11,ANTIOQUIA,1486,1435,72,6,0,0,2999,7,180,68,33,288
ARGELIA,2021,12,ANTIOQUIA,1489,1436,72,6,0,0,3003,7,180,68,33,288
ARGELIA,2021,2,ANTIOQUIA,1438,1402,76,9,0,0,2925,7,179,69,33,288
ARGELIA,2021,3,ANTIOQUIA,1443,1414,75,9,0,0,2941,7,180,69,33,289
ARGELIA,2021,4,ANTIOQUIA,1449,1410,75,9,0,0,2943,7,181,69,33,290
ARGELIA,2021,5,ANTIOQUIA,1452,1417,75,6,0,0,2950,7,181,69,33,290
ARGELIA,2021,6,ANTIOQUIA,1458,1424,75,8,0,0,2965,7,180,69,33,289
ARGELIA,2021,7,ANTIOQUIA,1467,1424,75,7,0,0,2973,7,179,69,33,288
ARGELIA,2021,8,ANTIOQUIA,1476,1423,75,6,0,0,2980,7,179,69,33,288
ARGELIA,2021,9,ANTIOQUIA,1477,1424,74,6,0,0,2981,7,179,69,33,288
ARGELIA,2022,1,ANTIOQUIA,1492,1437,72,6,0,0,3007,7,180,68,33,288
ARGELIA,2022,10,ANTIOQUIA,1507,1431,70,6,0,0,3014,6,179,69,33,287
ARGELIA,2022,11,ANTIOQUIA,1508,1435,70,6,0,0,3019,6,180,70,33,289
ARGELIA,2022,12,ANTIOQUIA,1513,1434,68,6,0,0,3021,6,180,69,33,288
ARGELIA,2022,2,ANTIOQUIA,1493,1438,72,6,0,0,3009,7,180,68,33,288
ARGELIA,2022,3,ANTIOQUIA,1494,1440,72,6,0,0,3012,6,180,69,33,288
ARGELIA,2022,4,ANTIOQUIA,1495,1441,72,6,0,0,3014,6,180,69,33,288
ARGELIA,2022,5,ANTIOQUIA,1498,1444,72,6,0,0,3020,6,179,69,33,287
ARGELIA,2022,6,ANTIOQUIA,1499,1444,72,6,0,0,3021,6,179,69,33,287
ARGELIA,2022,7,ANTIOQUIA,1495,1428,70,6,0,0,2999,6,179,69,33,287
ARGELIA,2022,8,ANTIOQUIA,1501,1428,70,6,0,0,3005,6,179,69,33,287
ARGELIA,2022,9,ANTIOQUIA,1506,1430,70,6,0,0,3012,6,179,69,33,287
ARGELIA,2023,1,ANTIOQUIA,1514,1435,68,6,0,0,3023,6,188,69,34,297
ARGELIA,2023,2,ANTIOQUIA,1515,1435,68,6,0,0,3024,6,189,69,34,298
ARGELIA,2023,3,ANTIOQUIA,1518,1437,68,6,0,0,3029,6,189,69,34,298
ARGELIA,2023,4,ANTIOQUIA,1520,1437,67,5,0,0,3029,6,189,69,34,298
ARGELIA,2023,5,ANTIOQUIA,1524,1441,67,4,0,0,3036,6,189,69,34,298
ARGELIA,2023,6,ANTIOQUIA,1525,1452,67,4,0,0,3048,6,188,69,34,297
ARGELIA,2023,7,ANTIOQUIA,1529,1455,67,5,0,0,3056,7,188,69,34,298
ARGELIA,2023,8,ANTIOQUIA,1541,1459,67,5,0,0,3072,7,189,69,34,299
ARGELIA,2023,9,ANTIOQUIA,1548,1462,66,5,0,0,3081,7,188,70,34,299
ARMENIA,2018,1,ANTIOQUIA,193,1244,282,27,2,1,1749,13,117,27,3,160
ARMENIA,2018,10,ANTIOQUIA,191,1255,281,28,2,1,1758,14,116,27,3,160
ARMENIA,2018,11,ANTIOQUIA,191,1253,282,28,2,1,1757,14,115,27,3,159
ARMENIA,2018,12,ANTIOQUIA,191,1253,282,28,2,1,1757,14,115,27,3,159
ARMENIA,2018,2,ANTIOQUIA,193,1249,282,28,2,1,1755,13,117,27,3,160
ARMENIA,2018,3,ANTIOQUIA,192,1251,282,28,2,1,1756,13,117,27,3,160
ARMENIA,2018,4,ANTIOQUIA,191,1252,282,28,2,1,1756,13,117,27,3,160
ARMENIA,2018,5,ANTIOQUIA,191,1250,282,28,2,1,1754,13,116,27,3,159
ARMENIA,2018,6,ANTIOQUIA,192,1251,282,28,2,1,1756,13,116,27,3,159
ARMENIA,2018,7,ANTIOQUIA,191,1252,282,28,2,1,1756,13,116,27,3,159
ARMENIA,2018,8,ANTIOQUIA,191,1252,282,28,2,1,1756,14,115,27,3,159
ARMENIA,2018,9,ANTIOQUIA,191,1253,282,28,2,1,1757,14,116,27,3,160
ARMENIA,2019,1,ANTIOQUIA,192,1253,282,28,2,1,1758,14,115,27,3,159
ARMENIA,2019,10,ANTIOQUIA,199,1269,282,29,2,1,1782,13,114,27,3,157
ARMENIA,2019,11,ANTIOQUIA,199,1269,282,31,2,1,1784,13,118,27,3,161
ARMENIA,2019,12,ANTIOQUIA,200,1271,282,31,2,1,1787,13,118,27,3,161
ARMENIA,2019,2,ANTIOQUIA,193,1253,282,28,2,1,1759,14,115,27,3,159
ARMENIA,2019,3,ANTIOQUIA,193,1253,282,28,2,1,1759,14,115,27,3,159
ARMENIA,2019,4,ANTIOQUIA,193,1253,282,28,2,1,1759,14,115,27,3,159
ARMENIA,2019,5,ANTIOQUIA,194,1254,282,28,2,1,1761,14,115,27,3,159
ARMENIA,2019,6,ANTIOQUIA,196,1255,282,28,2,1,1764,14,115,27,3,159
ARMENIA,2019,7,ANTIOQUIA,197,1257,282,28,2,1,1767,14,115,27,3,159
ARMENIA,2019,8,ANTIOQUIA,197,1258,283,28,2,1,1769,13,115,27,3,158
ARMENIA,2019,9,ANTIOQUIA,197,1263,282,29,2,1,1774,13,114,27,3,157
ARMENIA,2020,1,ANTIOQUIA,199,1272,282,30,2,1,1786,13,118,27,3,161
ARMENIA,2020,10,ANTIOQUIA,203,1280,282,32,2,1,1800,14,114,27,58,213
ARMENIA,2020,11,ANTIOQUIA,204,1281,282,32,2,1,1802,14,114,27,58,213
ARMENIA,2020,12,ANTIOQUIA,215,1253,297,38,2,1,1806,14,113,27,58,212
ARMENIA,2020,2,ANTIOQUIA,200,1271,282,30,2,1,1786,14,118,28,58,218
ARMENIA,2020,3,ANTIOQUIA,201,1271,282,31,2,1,1788,14,118,28,58,218
ARMENIA,2020,4,ANTIOQUIA,201,1271,282,31,2,1,1788,14,114,27,58,213
ARMENIA,2020,5,ANTIOQUIA,201,1271,282,31,2,1,1788,14,114,27,58,213
ARMENIA,2020,6,ANTIOQUIA,201,1271,282,32,2,1,1789,14,114,27,58,213
ARMENIA,2020,7,ANTIOQUIA,201,1271,281,31,2,1,1787,14,114,27,58,213
ARMENIA,2020,8,ANTIOQUIA,202,1272,281,32,2,1,1790,14,114,27,58,213
ARMENIA,2020,9,ANTIOQUIA,202,1274,281,32,2,1,1792,14,114,27,58,213
ARMENIA,2021,1,ANTIOQUIA,214,1254,295,37,2,1,1803,14,112,27,58,211
ARMENIA,2021,10,ANTIOQUIA,215,1267,291,36,2,1,1812,14,117,27,58,216
ARMENIA,2021,11,ANTIOQUIA,216,1270,291,37,2,1,1817,14,118,27,58,217
ARMENIA,2021,12,ANTIOQUIA,217,1271,292,37,2,1,1820,14,118,27,58,217
ARMENIA,2021,2,ANTIOQUIA,215,1257,292,38,2,1,1805,14,117,27,58,216
ARMENIA,2021,3,ANTIOQUIA,214,1261,290,38,2,1,1806,14,116,27,58,215
ARMENIA,2021,4,ANTIOQUIA,214,1263,291,37,2,1,1808,14,118,27,58,217
ARMENIA,2021,5,ANTIOQUIA,215,1262,291,37,2,1,1808,14,119,27,58,218
ARMENIA,2021,6,ANTIOQUIA,213,1264,291,36,2,1,1807,14,119,27,58,218
ARMENIA,2021,7,ANTIOQUIA,213,1264,291,36,2,1,1807,14,119,27,58,218
ARMENIA,2021,8,ANTIOQUIA,215,1266,292,36,2,1,1812,14,119,27,58,218
ARMENIA,2021,9,ANTIOQUIA,214,1267,292,36,2,1,1812,14,118,27,58,217
ARMENIA,2022,1,ANTIOQUIA,218,1271,292,37,2,1,1821,14,118,27,58,217
ARMENIA,2022,10,ANTIOQUIA,226,1283,299,35,2,1,1846,15,118,27,58,218
ARMENIA,2022,11,ANTIOQUIA,225,1289,302,35,2,1,1854,15,118,27,58,218
ARMENIA,2022,12,ANTIOQUIA,225,1291,302,35,2,1,1856,15,118,27,58,218
ARMENIA,2022,2,ANTIOQUIA,221,1276,293,37,2,1,1830,14,118,27,58,217
ARMENIA,2022,3,ANTIOQUIA,222,1278,293,37,2,1,1833,14,118,27,58,217
ARMENIA,2022,4,ANTIOQUIA,217,1282,293,37,2,1,1832,15,118,27,58,218
ARMENIA,2022,5,ANTIOQUIA,218,1283,295,37,2,1,1836,15,118,27,58,218
ARMENIA,2022,6,ANTIOQUIA,219,1284,297,36,2,1,1839,15,118,27,58,218
ARMENIA,2022,7,ANTIOQUIA,221,1283,296,36,2,1,1839,15,118,27,58,218
ARMENIA,2022,8,ANTIOQUIA,221,1278,296,36,2,1,1834,15,118,27,58,218
ARMENIA,2022,9,ANTIOQUIA,221,1281,295,36,2,1,1836,15,118,27,58,218
ARMENIA,2023,1,ANTIOQUIA,226,1292,302,35,2,1,1858,15,121,27,58,221
ARMENIA,2023,2,ANTIOQUIA,227,1297,315,35,2,1,1877,15,124,27,58,224
ARMENIA,2023,3,ANTIOQUIA,227,1298,316,35,2,1,1879,15,123,27,58,223
ARMENIA,2023,4,ANTIOQUIA,227,1301,318,35,2,1,1884,15,123,27,58,223
ARMENIA,2023,5,ANTIOQUIA,228,1303,318,34,2,1,1886,15,123,27,58,223
ARMENIA,2023,6,ANTIOQUIA,228,1303,319,34,2,1,1887,15,123,27,58,223
ARMENIA,2023,7,ANTIOQUIA,228,1304,319,34,2,1,1888,15,123,27,58,223
ARMENIA,2023,8,ANTIOQUIA,226,1304,317,32,2,1,1882,15,123,27,58,223
ARMENIA,2023,9,ANTIOQUIA,226,1305,317,32,2,1,1883,15,123,27,58,223
BARBOSA,2018,1,ANTIOQUIA,2718,11878,1964,320,142,94,17116,88,969,103,22,1182
BARBOSA,2018,10,ANTIOQUIA,2769,12234,2024,323,142,95,17587,91,985,105,22,1203
BARBOSA,2018,11,ANTIOQUIA,2767,12222,2025,321,142,95,17572,91,983,105,23,1202
BARBOSA,2018,12,ANTIOQUIA,2774,12295,2027,322,143,95,17656,91,982,105,23,1201
BARBOSA,2018,2,ANTIOQUIA,2721,11925,1965,319,142,94,17166,86,967,103,22,1178
BARBOSA,2018,3,ANTIOQUIA,2715,11947,1967,318,142,94,17183,86,970,103,22,1181
BARBOSA,2018,4,ANTIOQUIA,2732,11999,1974,320,142,95,17262,86,979,103,23,1191
BARBOSA,2018,5,ANTIOQUIA,2726,12058,1973,321,142,95,17315,89,975,103,23,1190
BARBOSA,2018,6,ANTIOQUIA,2744,12095,1980,323,142,95,17379,89,975,103,22,1189
BARBOSA,2018,7,ANTIOQUIA,2748,12125,1985,323,142,95,17418,88,974,104,22,1188
BARBOSA,2018,8,ANTIOQUIA,2757,12153,2002,322,142,95,17471,89,986,104,22,1201
BARBOSA,2018,9,ANTIOQUIA,2757,12166,2008,323,142,95,17491,90,986,105,22,1203
BARBOSA,2019,1,ANTIOQUIA,2772,12315,2031,324,143,94,17679,90,980,103,23,1196
BARBOSA,2019,10,ANTIOQUIA,2812,12639,2115,325,144,94,18129,95,989,103,23,1210
BARBOSA,2019,11,ANTIOQUIA,2826,12659,2118,326,144,94,18167,96,989,103,23,1211
BARBOSA,2019,12,ANTIOQUIA,2836,12699,2123,327,146,96,18227,97,993,103,23,1216
BARBOSA,2019,2,ANTIOQUIA,2775,12362,2036,324,144,94,17735,89,980,102,23,1194
BARBOSA,2019,3,ANTIOQUIA,2777,12393,2037,324,143,94,17768,89,979,102,23,1193
BARBOSA,2019,4,ANTIOQUIA,2778,12426,2052,325,143,94,17818,88,979,103,23,1193
BARBOSA,2019,5,ANTIOQUIA,2947,9242,4541,866,308,91,17995,90,977,104,23,1194
BARBOSA,2019,6,ANTIOQUIA,2886,12543,2374,345,151,96,18395,91,979,104,23,1197
BARBOSA,2019,7,ANTIOQUIA,2787,12476,2082,323,143,94,17905,92,978,104,23,1197
BARBOSA,2019,8,ANTIOQUIA,2793,12541,2084,325,143,94,17980,93,981,103,23,1200
BARBOSA,2019,9,ANTIOQUIA,2800,12603,2114,325,143,94,18079,93,987,104,22,1206
BARBOSA,2020,1,ANTIOQUIA,2848,12685,2125,333,144,94,18229,97,990,103,23,1213
BARBOSA,2020,10,ANTIOQUIA,2889,12954,2184,344,145,93,18609,104,1033,103,871,2111
BARBOSA,2020,11,ANTIOQUIA,2900,12988,2187,346,145,93,18659,101,1032,102,873,2108
BARBOSA,2020,12,ANTIOQUIA,2901,13023,2188,358,145,93,18708,107,1033,103,874,2117
BARBOSA,2020,2,ANTIOQUIA,2854,12720,2130,334,144,94,18276,104,1005,125,877,2111
BARBOSA,2020,3,ANTIOQUIA,2856,12742,2135,338,144,94,18309,105,1006,125,876,2112
BARBOSA,2020,4,ANTIOQUIA,2866,12767,2138,335,144,94,18344,103,1027,104,876,2110
BARBOSA,2020,5,ANTIOQUIA,2867,12808,2155,344,147,96,18417,102,1029,104,876,2111
BARBOSA,2020,6,ANTIOQUIA,2870,12820,2145,343,147,97,18422,104,1027,105,876,2112
BARBOSA,2020,7,ANTIOQUIA,2871,12828,2144,343,146,95,18427,103,1028,106,876,2113
BARBOSA,2020,8,ANTIOQUIA,2877,12892,2172,344,144,93,18522,102,1031,103,873,2109
BARBOSA,2020,9,ANTIOQUIA,2882,12923,2177,344,144,93,18563,103,1030,103,873,2109
BARBOSA,2021,1,ANTIOQUIA,2906,13082,2193,348,145,93,18767,106,1036,103,875,2120
BARBOSA,2021,10,ANTIOQUIA,3028,13428,2262,354,143,91,19306,111,1048,103,873,2135
BARBOSA,2021,11,ANTIOQUIA,3035,13476,2271,354,143,91,19370,110,1051,103,874,2138
BARBOSA,2021,12,ANTIOQUIA,3039,13508,2274,355,143,91,19410,110,1048,104,874,2136
BARBOSA,2021,2,ANTIOQUIA,2960,13113,2203,349,144,93,18862,107,1040,103,875,2125
BARBOSA,2021,3,ANTIOQUIA,2967,13152,2209,350,143,92,18913,108,1041,103,875,2127
BARBOSA,2021,4,ANTIOQUIA,2992,13191,2228,353,144,92,19000,109,1042,103,874,2128
BARBOSA,2021,5,ANTIOQUIA,2999,13230,2234,351,144,92,19050,109,1044,103,873,2129
BARBOSA,2021,6,ANTIOQUIA,3003,13240,2239,347,144,92,19065,107,1042,103,875,2127
BARBOSA,2021,7,ANTIOQUIA,3006,13265,2242,348,144,91,19096,109,1045,102,875,2131
BARBOSA,2021,8,ANTIOQUIA,3015,13302,2248,350,143,91,19149,110,1047,103,876,2136
BARBOSA,2021,9,ANTIOQUIA,3025,13365,2252,352,143,91,19228,112,1050,104,876,2142
BARBOSA,2022,1,ANTIOQUIA,3042,13583,2278,357,143,91,19494,111,1050,104,874,2139
BARBOSA,2022,10,ANTIOQUIA,3077,14113,2338,391,145,91,20155,119,1064,104,879,2166
BARBOSA,2022,11,ANTIOQUIA,3083,14145,2349,390,145,91,20203,120,1064,105,880,2169
BARBOSA,2022,12,ANTIOQUIA,3090,14182,2364,391,144,91,20262,120,1070,105,880,2175
BARBOSA,2022,2,ANTIOQUIA,3054,13701,2286,361,143,91,19636,111,1060,105,873,2149
BARBOSA,2022,3,ANTIOQUIA,3064,13767,2292,365,144,91,19723,112,1058,105,873,2148
BARBOSA,2022,4,ANTIOQUIA,3063,13810,2293,368,144,91,19769,114,1057,105,874,2150
BARBOSA,2022,5,ANTIOQUIA,3050,13883,2314,371,144,91,19853,116,1058,105,874,2153
BARBOSA,2022,6,ANTIOQUIA,3071,13944,2320,376,144,91,19946,116,1063,105,875,2159
BARBOSA,2022,7,ANTIOQUIA,3064,13982,2323,376,145,91,19981,113,1061,105,874,2153
BARBOSA,2022,8,ANTIOQUIA,3074,14022,2328,383,145,91,20043,116,1063,104,875,2158
BARBOSA,2022,9,ANTIOQUIA,3078,14060,2335,387,145,91,20096,119,1064,104,875,2162
BARBOSA,2023,1,ANTIOQUIA,3093,14200,2366,396,144,91,20290,122,1070,105,880,2177
BARBOSA,2023,2,ANTIOQUIA,3100,14246,2378,396,144,91,20355,121,1070,105,880,2176
BARBOSA,2023,3,ANTIOQUIA,3116,14304,2381,396,144,91,20432,122,1071,105,880,2178
BARBOSA,2023,4,ANTIOQUIA,3121,14338,2389,395,144,91,20478,123,1070,105,880,2178
BARBOSA,2023,5,ANTIOQUIA,3118,14372,2398,395,144,91,20518,123,1070,105,881,2179
BARBOSA,2023,6,ANTIOQUIA,3119,14405,2402,396,143,92,20557,123,1061,105,881,2170
BARBOSA,2023,7,ANTIOQUIA,3135,14428,2407,399,143,92,20604,123,1062,106,875,2166
BARBOSA,2023,8,ANTIOQUIA,3145,14459,2412,399,143,92,20650,126,1063,106,875,2170
BARBOSA,2023,9,ANTIOQUIA,3157,14469,2422,401,143,92,20684,128,1061,106,875,2170
BELLO,2018,1,ANTIOQUIA,38488,50522,54856,10871,57,22,154816,620,7126,197,121,8064
BELLO,2018,10,ANTIOQUIA,39333,51979,56439,12257,57,21,160086,658,7199,199,124,8180
BELLO,2018,11,ANTIOQUIA,39520,52214,56470,12292,57,21,160574,659,7209,198,125,8191
BELLO,2018,12,ANTIOQUIA,39693,52319,56922,12268,58,21,161281,661,7003,198,127,7989
BELLO,2018,2,ANTIOQUIA,38603,50828,55065,10920,57,22,155495,617,7126,198,121,8062
BELLO,2018,3,ANTIOQUIA,38687,50985,55173,10914,57,21,155837,620,7135,198,121,8074
BELLO,2018,4,ANTIOQUIA,38840,51113,55267,10946,57,22,156245,628,7156,198,122,8104
BELLO,2018,5,ANTIOQUIA,38901,51194,55424,10971,57,21,156568,630,7149,197,123,8099
BELLO,2018,6,ANTIOQUIA,38986,51360,55489,11307,57,21,157220,634,7175,198,124,8131
BELLO,2018,7,ANTIOQUIA,39103,51699,55748,11742,57,21,158370,642,7205,198,124,8169
BELLO,2018,8,ANTIOQUIA,39186,51816,55821,11940,57,21,158841,647,7217,198,124,8186
BELLO,2018,9,ANTIOQUIA,39236,51880,56067,12070,57,21,159331,658,7193,198,124,8173
BELLO,2019,1,ANTIOQUIA,39753,52383,57188,12052,58,21,161455,665,7233,197,128,8223
BELLO,2019,10,ANTIOQUIA,40435,53319,60093,13106,59,22,167034,692,7385,198,129,8404
BELLO,2019,11,ANTIOQUIA,40524,53416,60164,13124,59,22,167309,697,7416,198,130,8441
BELLO,2019,12,ANTIOQUIA,40756,53596,60239,13153,58,22,167824,698,7434,199,130,8461
BELLO,2019,2,ANTIOQUIA,39822,52467,57534,12056,58,21,161958,666,7248,197,127,8238
BELLO,2019,3,ANTIOQUIA,39889,52555,57668,12393,58,22,162585,670,7251,197,127,8245
BELLO,2019,4,ANTIOQUIA,39962,52627,57802,12309,58,22,162780,672,7275,197,127,8271
BELLO,2019,5,ANTIOQUIA,40035,52876,58285,12519,58,22,163795,680,7314,197,130,8321
BELLO,2019,6,ANTIOQUIA,40106,52949,58721,12681,59,22,164538,687,7337,197,129,8350
BELLO,2019,7,ANTIOQUIA,40175,53047,59288,12698,59,22,165289,691,7351,197,130,8369
BELLO,2019,8,ANTIOQUIA,40251,53130,59600,12997,59,22,166059,693,7373,197,130,8393
BELLO,2019,9,ANTIOQUIA,40353,53239,59672,13103,59,22,166448,688,7383,199,128,8398
BELLO,2020,1,ANTIOQUIA,40855,53655,60273,13400,58,22,168263,702,7453,199,131,8485
BELLO,2020,10,ANTIOQUIA,42661,55782,62160,14294,60,22,174979,729,7792,205,2462,11188
BELLO,2020,11,ANTIOQUIA,43292,56196,62265,14461,60,23,176297,728,7807,201,2465,11201
BELLO,2020,12,ANTIOQUIA,44129,56249,62760,14587,60,24,177809,739,7829,205,2465,11238
BELLO,2020,2,ANTIOQUIA,41025,53711,60507,13640,58,22,168963,694,7503,307,2462,10966
BELLO,2020,3,ANTIOQUIA,41136,53875,60855,13830,59,22,169777,696,7530,307,2461,10994
BELLO,2020,4,ANTIOQUIA,41341,53976,61151,13710,60,22,170260,704,7662,199,2462,11027
BELLO,2020,5,ANTIOQUIA,41508,54329,61343,14216,66,24,171486,802,7677,209,2461,11149
BELLO,2020,6,ANTIOQUIA,41537,54667,61462,14357,59,22,172104,706,7695,200,2462,11063
BELLO,2020,7,ANTIOQUIA,41609,54907,61694,14426,59,22,172717,716,7723,201,2462,11102
BELLO,2020,8,ANTIOQUIA,41956,55291,61762,14182,59,22,173272,725,7751,204,2464,11144
BELLO,2020,9,ANTIOQUIA,42121,55617,61845,14296,59,22,173960,727,7780,205,2463,11175
BELLO,2021,1,ANTIOQUIA,44781,56350,63060,14595,60,25,178871,740,7832,207,2465,11244
BELLO,2021,10,ANTIOQUIA,47733,57613,64982,16209,60,27,186624,750,8112,207,2466,11535
BELLO,2021,11,ANTIOQUIA,48033,57732,65220,16202,60,28,187275,752,8124,204,2466,11546
BELLO,2021,12,ANTIOQUIA,48377,58166,65482,16269,61,28,188383,761,8254,206,2464,11685
BELLO,2021,2,ANTIOQUIA,45511,56429,63216,14511,60,26,179753,741,7848,208,2464,11261
BELLO,2021,3,ANTIOQUIA,46077,56556,63547,14493,60,26,180759,743,7869,208,2462,11282
BELLO,2021,4,ANTIOQUIA,46536,56676,63637,14790,60,26,181725,748,7884,209,2462,11303
BELLO,2021,5,ANTIOQUIA,46839,56798,63728,14960,61,26,182412,753,7910,209,2462,11334
BELLO,2021,6,ANTIOQUIA,46908,56816,63915,14961,59,25,182684,753,7907,209,2462,11331
BELLO,2021,7,ANTIOQUIA,47128,56936,64039,15014,60,25,183202,749,7910,208,2463,11330
BELLO,2021,8,ANTIOQUIA,47281,57301,64391,15601,60,26,184660,748,7929,210,2464,11351
BELLO,2021,9,ANTIOQUIA,47400,57501,64625,16206,59,27,185818,745,7966,210,2464,11385
BELLO,2022,1,ANTIOQUIA,48548,58351,65722,16273,61,28,188983,765,8252,206,2464,11687
BELLO,2022,10,ANTIOQUIA,50241,60687,67888,16969,65,31,195881,811,8358,216,2461,11846
BELLO,2022,11,ANTIOQUIA,50450,60864,68197,17359,65,31,196966,820,8339,216,2462,11837
BELLO,2022,12,ANTIOQUIA,51065,61023,68259,17380,65,31,197823,822,8556,216,2464,12058
BELLO,2022,2,ANTIOQUIA,48721,58580,65987,16483,62,29,189862,776,8261,205,2465,11707
BELLO,2022,3,ANTIOQUIA,48999,58910,66097,16684,63,29,190782,783,8291,209,2462,11745
BELLO,2022,4,ANTIOQUIA,49171,59072,66308,16846,63,29,191489,781,8302,209,2462,11754
BELLO,2022,5,ANTIOQUIA,49162,59554,66529,16877,64,28,192214,783,8305,209,2462,11759
BELLO,2022,6,ANTIOQUIA,49529,59665,66773,16888,63,28,192946,789,8310,209,2462,11770
BELLO,2022,7,ANTIOQUIA,49710,59948,67284,16906,63,28,193939,790,8303,209,2461,11763
BELLO,2022,8,ANTIOQUIA,49852,60286,67335,16925,65,28,194491,805,8324,210,2460,11799
BELLO,2022,9,ANTIOQUIA,50051,60473,67452,16963,65,30,195034,813,8329,213,2460,11815
BELLO,2023,1,ANTIOQUIA,51190,61195,68322,17510,66,31,198314,823,8552,217,2463,12055
BELLO,2023,2,ANTIOQUIA,51362,61454,68396,17527,67,35,198841,825,8584,218,2464,12091
BELLO,2023,3,ANTIOQUIA,51538,61636,68683,17551,70,36,199514,824,8584,219,2462,12089
BELLO,2023,4,ANTIOQUIA,51715,61870,68751,17749,79,38,200202,830,8603,219,2463,12115
BELLO,2023,5,ANTIOQUIA,51924,62032,68984,17775,79,38,200832,828,8614,218,2464,12124
BELLO,2023,6,ANTIOQUIA,51971,62056,69077,17803,81,38,201026,823,8566,218,2468,12075
BELLO,2023,7,ANTIOQUIA,52176,62289,69117,18210,83,38,201913,843,8557,220,2472,12092
BELLO,2023,8,ANTIOQUIA,52322,62518,69353,18425,83,38,202739,843,8606,220,2472,12141
BELLO,2023,9,ANTIOQUIA,52703,62683,69409,18459,83,39,203376,846,8595,220,2472,12133
BELMIRA,2018,1,ANTIOQUIA,197,1395,377,52,2,1,2024,125,245,36,5,411
BELMIRA,2018,10,ANTIOQUIA,321,1354,344,55,2,1,2077,135,247,37,6,425
BELMIRA,2018,11,ANTIOQUIA,318,1339,342,55,2,1,2057,135,245,37,5,422
BELMIRA,2018,12,ANTIOQUIA,321,1341,343,56,2,1,2064,135,245,37,5,422
BELMIRA,2018,2,ANTIOQUIA,313,1298,355,50,2,1,2019,125,245,36,5,411
BELMIRA,2018,3,ANTIOQUIA,314,1298,355,50,2,1,2020,127,244,36,5,412
BELMIRA,2018,4,ANTIOQUIA,314,1304,352,54,2,1,2027,127,244,36,5,412
BELMIRA,2018,5,ANTIOQUIA,314,1310,348,55,2,1,2030,128,243,36,5,412
BELMIRA,2018,6,ANTIOQUIA,316,1315,347,56,2,1,2037,132,243,36,5,416
BELMIRA,2018,7,ANTIOQUIA,317,1321,347,57,2,1,2045,132,244,36,5,417
BELMIRA,2018,8,ANTIOQUIA,317,1330,344,54,2,1,2048,133,244,36,5,418
BELMIRA,2018,9,ANTIOQUIA,318,1332,341,57,2,1,2051,135,243,37,5,420
BELMIRA,2019,1,ANTIOQUIA,321,1345,343,56,2,1,2068,135,245,37,5,422
BELMIRA,2019,10,ANTIOQUIA,324,1362,352,59,2,1,2100,149,240,37,5,431
BELMIRA,2019,11,ANTIOQUIA,323,1364,352,59,2,1,2101,149,240,37,5,431
BELMIRA,2019,12,ANTIOQUIA,323,1364,352,59,2,1,2101,149,240,37,6,432
BELMIRA,2019,2,ANTIOQUIA,322,1347,343,56,2,1,2071,136,243,37,5,421
BELMIRA,2019,3,ANTIOQUIA,322,1351,342,57,2,1,2075,137,244,37,5,423
BELMIRA,2019,4,ANTIOQUIA,322,1352,343,58,2,1,2078,139,244,37,5,425
BELMIRA,2019,5,ANTIOQUIA,322,1355,347,59,2,1,2086,140,244,37,5,426
BELMIRA,2019,6,ANTIOQUIA,322,1356,350,59,2,1,2090,141,243,37,5,426
BELMIRA,2019,7,ANTIOQUIA,323,1358,349,58,2,1,2091,143,242,37,5,427
BELMIRA,2019,8,ANTIOQUIA,323,1359,349,58,2,1,2092,145,242,37,5,429
BELMIRA,2019,9,ANTIOQUIA,320,1361,350,58,2,1,2092,148,242,37,5,432
BELMIRA,2020,1,ANTIOQUIA,323,1364,352,62,2,1,2104,152,240,37,5,434
BELMIRA,2020,10,ANTIOQUIA,536,1021,462,72,30,27,2148,156,247,37,44,484
BELMIRA,2020,11,ANTIOQUIA,547,1003,471,74,30,27,2152,155,247,38,44,484
BELMIRA,2020,12,ANTIOQUIA,548,1010,471,75,30,28,2162,157,246,38,44,485
BELMIRA,2020,2,ANTIOQUIA,325,1367,354,62,2,1,2111,154,241,40,44,479
BELMIRA,2020,3,ANTIOQUIA,325,1370,356,63,2,1,2117,154,241,40,44,479
BELMIRA,2020,4,ANTIOQUIA,327,1373,354,60,2,1,2117,153,244,37,44,478
BELMIRA,2020,5,ANTIOQUIA,330,1378,357,60,2,1,2128,153,244,37,44,478
BELMIRA,2020,6,ANTIOQUIA,333,1381,357,59,2,1,2133,153,245,37,44,479
BELMIRA,2020,7,ANTIOQUIA,333,1383,357,60,2,1,2136,153,244,37,44,478
BELMIRA,2020,8,ANTIOQUIA,506,1030,498,72,19,15,2140,154,246,37,44,481
BELMIRA,2020,9,ANTIOQUIA,536,1002,475,73,30,27,2143,156,247,37,44,484
BELMIRA,2021,1,ANTIOQUIA,549,1015,473,75,30,28,2170,158,246,38,44,486
BELMIRA,2021,10,ANTIOQUIA,594,1065,461,67,28,28,2243,182,247,38,44,511
BELMIRA,2021,11,ANTIOQUIA,595,1070,463,67,28,27,2250,183,247,38,44,512
BELMIRA,2021,12,ANTIOQUIA,596,1073,463,66,29,27,2254,188,248,38,44,518
BELMIRA,2021,2,ANTIOQUIA,559,1021,462,74,29,28,2173,160,248,38,44,490
BELMIRA,2021,3,ANTIOQUIA,568,1028,463,71,29,28,2187,161,248,38,44,491
BELMIRA,2021,4,ANTIOQUIA,573,1035,464,71,28,28,2199,165,248,38,44,495
BELMIRA,2021,5,ANTIOQUIA,577,1034,468,69,28,28,2204,165,248,38,44,495
BELMIRA,2021,6,ANTIOQUIA,585,1040,467,68,28,28,2216,165,249,38,44,496
BELMIRA,2021,7,ANTIOQUIA,587,1046,463,68,28,28,2220,176,248,38,44,506
BELMIRA,2021,8,ANTIOQUIA,587,1050,463,68,28,28,2224,178,247,38,44,507
BELMIRA,2021,9,ANTIOQUIA,590,1055,463,67,28,28,2231,180,248,38,44,510
BELMIRA,2022,1,ANTIOQUIA,598,1078,463,66,29,28,2262,189,247,38,44,518
BELMIRA,2022,10,ANTIOQUIA,621,1122,464,68,29,26,2330,207,241,38,43,529
BELMIRA,2022,11,ANTIOQUIA,622,1121,465,68,29,26,2331,207,241,38,43,529
BELMIRA,2022,12,ANTIOQUIA,623,1123,465,68,29,26,2334,208,241,38,43,530
BELMIRA,2022,2,ANTIOQUIA,600,1080,463,65,29,28,2265,190,247,38,44,519
BELMIRA,2022,3,ANTIOQUIA,603,1081,463,65,29,28,2269,197,244,38,43,522
BELMIRA,2022,4,ANTIOQUIA,602,1086,466,65,29,28,2276,199,243,38,43,523
BELMIRA,2022,5,ANTIOQUIA,606,1089,463,65,29,28,2280,200,242,38,43,523
BELMIRA,2022,6,ANTIOQUIA,610,1097,461,65,30,28,2291,201,242,38,43,524
BELMIRA,2022,7,ANTIOQUIA,616,1103,461,66,30,27,2303,201,243,38,43,525
BELMIRA,2022,8,ANTIOQUIA,617,1109,462,66,29,27,2310,202,242,38,43,525
BELMIRA,2022,9,ANTIOQUIA,618,1117,463,68,29,27,2322,205,242,38,43,528
BELMIRA,2023,1,ANTIOQUIA,628,1126,466,67,29,26,2342,210,239,38,43,530
BELMIRA,2023,2,ANTIOQUIA,633,1127,467,68,29,26,2350,210,239,38,43,530
BELMIRA,2023,3,ANTIOQUIA,634,1135,467,67,29,25,2357,211,237,38,43,529
BELMIRA,2023,4,ANTIOQUIA,637,1136,466,69,28,25,2361,211,239,37,43,530
BELMIRA,2023,5,ANTIOQUIA,638,1135,467,69,28,25,2362,212,239,37,43,531
BELMIRA,2023,6,ANTIOQUIA,635,1140,468,68,28,25,2364,212,240,37,43,532
BELMIRA,2023,7,ANTIOQUIA,638,1135,462,68,28,25,2356,212,238,37,43,530
BELMIRA,2023,8,ANTIOQUIA,636,1135,461,67,27,25,2351,216,240,37,43,536
BELMIRA,2023,9,ANTIOQUIA,637,1147,461,67,27,25,2364,213,240,37,43,533
BETANIA,2018,1,ANTIOQUIA,374,2047,435,15,0,1,2872,88,208,48,4,348
BETANIA,2018,10,ANTIOQUIA,379,2058,428,13,0,1,2879,92,211,48,4,355
BETANIA,2018,11,ANTIOQUIA,380,2061,431,13,0,1,2886,93,211,48,4,356
BETANIA,2018,12,ANTIOQUIA,380,2062,431,12,0,1,2886,93,211,48,4,356
BETANIA,2018,2,ANTIOQUIA,374,2046,434,14,0,1,2869,88,208,48,4,348
BETANIA,2018,3,ANTIOQUIA,375,2049,433,14,0,1,2872,88,208,48,4,348
BETANIA,2018,4,ANTIOQUIA,374,2049,433,14,0,1,2871,89,208,48,4,349
BETANIA,2018,5,ANTIOQUIA,373,2049,432,14,0,1,2869,89,207,48,4,348
BETANIA,2018,6,ANTIOQUIA,373,2046,431,14,0,1,2865,90,212,48,4,354
BETANIA,2018,7,ANTIOQUIA,375,2048,430,15,0,1,2869,91,211,48,4,354
BETANIA,2018,8,ANTIOQUIA,379,2051,430,15,0,1,2876,92,211,48,4,355
BETANIA,2018,9,ANTIOQUIA,379,2054,429,13,0,1,2876,92,211,48,4,355
BETANIA,2019,1,ANTIOQUIA,381,2066,432,12,0,1,2892,93,211,48,4,356
BETANIA,2019,10,ANTIOQUIA,391,2103,432,12,0,1,2939,95,215,47,4,361
BETANIA,2019,11,ANTIOQUIA,392,2104,432,12,0,1,2941,95,214,47,4,360
BETANIA,2019,12,ANTIOQUIA,397,2108,433,13,0,1,2952,95,215,47,4,361
BETANIA,2019,2,ANTIOQUIA,383,2068,436,12,0,1,2900,93,212,47,4,356
BETANIA,2019,3,ANTIOQUIA,383,2070,433,13,0,0,2899,94,212,47,4,357
BETANIA,2019,4,ANTIOQUIA,383,2073,433,13,0,0,2902,94,213,47,4,358
BETANIA,2019,5,ANTIOQUIA,384,2082,432,12,0,1,2911,95,213,47,4,359
BETANIA,2019,6,ANTIOQUIA,387,2076,432,12,0,0,2907,95,213,47,4,359
BETANIA,2019,7,ANTIOQUIA,387,2082,435,12,0,0,2916,95,213,47,4,359
BETANIA,2019,8,ANTIOQUIA,388,2085,435,12,0,1,2921,95,214,47,4,360
BETANIA,2019,9,ANTIOQUIA,388,2093,435,12,0,1,2929,95,215,47,4,361
BETANIA,2020,1,ANTIOQUIA,396,2108,433,13,0,1,2951,95,214,47,4,360
BETANIA,2020,10,ANTIOQUIA,435,2412,449,15,0,1,3312,125,220,52,62,459
BETANIA,2020,11,ANTIOQUIA,435,2413,449,15,0,1,3313,125,220,52,62,459
BETANIA,2020,12,ANTIOQUIA,437,2420,448,15,0,1,3321,125,221,52,62,460
BETANIA,2020,2,ANTIOQUIA,397,2110,432,13,0,1,2953,97,214,47,63,421
BETANIA,2020,3,ANTIOQUIA,401,2116,434,14,0,1,2966,97,214,47,63,421
BETANIA,2020,4,ANTIOQUIA,401,2116,434,14,0,1,2966,97,214,47,63,421
BETANIA,2020,5,ANTIOQUIA,402,2117,434,14,0,1,2968,98,214,47,63,422
BETANIA,2020,6,ANTIOQUIA,401,2116,433,14,0,1,2965,96,215,47,63,421
BETANIA,2020,7,ANTIOQUIA,401,2118,434,15,0,1,2969,97,215,47,63,422
BETANIA,2020,8,ANTIOQUIA,402,2123,432,15,0,1,2973,97,215,47,63,422
BETANIA,2020,9,ANTIOQUIA,435,2394,449,15,0,1,3294,124,221,52,62,459
BETANIA,2021,1,ANTIOQUIA,438,2422,448,16,0,1,3325,125,222,52,62,461
BETANIA,2021,10,ANTIOQUIA,452,2458,439,17,0,1,3367,126,232,52,62,472
BETANIA,2021,11,ANTIOQUIA,452,2465,438,18,0,1,3374,126,233,53,62,474
BETANIA,2021,12,ANTIOQUIA,451,2468,439,17,0,1,3376,127,233,53,62,475
BETANIA,2021,2,ANTIOQUIA,440,2423,445,16,0,1,3325,125,225,52,62,464
BETANIA,2021,3,ANTIOQUIA,441,2425,445,19,0,1,3331,125,226,52,62,465
BETANIA,2021,4,ANTIOQUIA,445,2428,446,19,0,1,3339,125,226,52,62,465
BETANIA,2021,5,ANTIOQUIA,447,2438,444,21,0,1,3351,126,230,52,62,470
BETANIA,2021,6,ANTIOQUIA,448,2438,443,21,0,1,3351,126,231,52,62,471
BETANIA,2021,7,ANTIOQUIA,449,2440,442,22,0,1,3354,126,231,52,62,471
BETANIA,2021,8,ANTIOQUIA,448,2445,442,20,0,1,3356,126,229,52,62,469
BETANIA,2021,9,ANTIOQUIA,449,2452,442,16,0,1,3360,126,232,52,62,472
BETANIA,2022,1,ANTIOQUIA,454,2472,436,17,0,1,3380,127,233,53,62,475
BETANIA,2022,10,ANTIOQUIA,462,2488,415,17,0,1,3383,123,235,55,62,475
BETANIA,2022,11,ANTIOQUIA,462,2489,416,16,0,1,3384,123,235,55,62,475
BETANIA,2022,12,ANTIOQUIA,462,2495,415,15,0,1,3388,124,235,55,62,476
BETANIA,2022,2,ANTIOQUIA,454,2477,436,18,0,1,3386,128,232,53,62,475
BETANIA,2022,3,ANTIOQUIA,457,2482,435,17,0,1,3392,124,233,55,61,473
BETANIA,2022,4,ANTIOQUIA,459,2491,433,18,0,1,3402,123,233,55,61,472
BETANIA,2022,5,ANTIOQUIA,458,2494,433,17,0,1,3403,123,234,55,61,473
BETANIA,2022,6,ANTIOQUIA,459,2498,433,17,0,1,3408,123,235,55,61,474
BETANIA,2022,7,ANTIOQUIA,461,2511,433,17,0,1,3423,122,236,55,61,474
BETANIA,2022,8,ANTIOQUIA,458,2474,417,16,0,1,3366,122,236,55,61,474
BETANIA,2022,9,ANTIOQUIA,461,2478,416,17,0,1,3373,123,236,55,61,475
BETANIA,2023,1,ANTIOQUIA,462,2499,416,15,0,1,3393,124,234,55,62,475
BETANIA,2023,2,ANTIOQUIA,464,2513,416,15,0,1,3409,126,235,55,62,478
BETANIA,2023,3,ANTIOQUIA,464,2522,415,15,0,1,3417,126,235,55,62,478
BETANIA,2023,4,ANTIOQUIA,465,2522,415,15,0,1,3418,126,235,55,62,478
BETANIA,2023,5,ANTIOQUIA,465,2528,415,15,0,1,3424,125,235,55,62,477
BETANIA,2023,6,ANTIOQUIA,467,2537,414,15,0,1,3434,125,235,55,62,477
BETANIA,2023,7,ANTIOQUIA,466,2531,414,15,0,1,3427,126,236,55,62,479
BETANIA,2023,8,ANTIOQUIA,467,2533,412,16,0,1,3429,126,235,55,62,478
BETANIA,2023,9,ANTIOQUIA,470,2543,413,16,0,1,3443,125,237,55,62,479
BETULIA,2018,1,ANTIOQUIA,3309,1783,673,198,1,5,5969,84,359,74,9,526
BETULIA,2018,10,ANTIOQUIA,3344,1855,681,199,1,5,6085,86,369,74,9,538
BETULIA,2018,11,ANTIOQUIA,3346,1839,678,200,1,5,6069,86,367,74,9,536
BETULIA,2018,12,ANTIOQUIA,3363,1840,686,202,1,5,6097,86,368,74,9,537
BETULIA,2018,2,ANTIOQUIA,3319,1798,673,198,1,5,5994,84,358,74,9,525
BETULIA,2018,3,ANTIOQUIA,3317,1805,672,199,1,5,5999,84,358,74,9,525
BETULIA,2018,4,ANTIOQUIA,3326,1806,675,199,1,5,6012,84,359,74,9,526
BETULIA,2018,5,ANTIOQUIA,3322,1809,675,197,1,5,6009,84,361,74,9,528
BETULIA,2018,6,ANTIOQUIA,3326,1816,680,197,1,5,6025,85,363,74,9,531
BETULIA,2018,7,ANTIOQUIA,3331,1821,681,197,1,5,6036,85,363,74,9,531
BETULIA,2018,8,ANTIOQUIA,3339,1824,683,197,1,5,6049,85,364,74,9,532
BETULIA,2018,9,ANTIOQUIA,3342,1834,677,199,1,5,6058,85,368,74,9,536
BETULIA,2019,1,ANTIOQUIA,3364,1849,686,202,1,5,6107,87,368,74,9,538
BETULIA,2019,10,ANTIOQUIA,3447,1884,693,202,1,5,6232,88,370,75,9,542
BETULIA,2019,11,ANTIOQUIA,3451,1887,693,202,1,5,6239,88,370,75,9,542
BETULIA,2019,12,ANTIOQUIA,3462,1894,695,204,1,5,6261,89,370,75,9,543
BETULIA,2019,2,ANTIOQUIA,3372,1849,688,200,1,5,6115,87,368,74,9,538
BETULIA,2019,3,ANTIOQUIA,3371,1852,688,200,1,5,6117,87,368,74,9,538
BETULIA,2019,4,ANTIOQUIA,3379,1853,688,201,1,5,6127,88,368,74,9,539
BETULIA,2019,5,ANTIOQUIA,3391,1857,691,202,1,5,6147,88,369,74,9,540
BETULIA,2019,6,ANTIOQUIA,3418,1863,689,201,1,5,6177,88,368,74,9,539
BETULIA,2019,7,ANTIOQUIA,3423,1867,689,201,1,5,6186,88,368,75,9,540
BETULIA,2019,8,ANTIOQUIA,3433,1872,690,202,1,5,6203,88,369,75,9,541
BETULIA,2019,9,ANTIOQUIA,3435,1877,692,202,1,5,6212,88,370,75,9,542
BETULIA,2020,1,ANTIOQUIA,3458,1891,694,202,1,5,6251,89,371,75,9,544
BETULIA,2020,10,ANTIOQUIA,3519,1919,700,204,1,5,6348,91,382,76,65,614
BETULIA,2020,11,ANTIOQUIA,3519,1918,697,204,1,5,6344,92,390,75,65,622
BETULIA,2020,12,ANTIOQUIA,3521,1921,696,205,1,5,6349,92,390,76,65,623
BETULIA,2020,2,ANTIOQUIA,3462,1893,694,209,1,5,6264,91,370,81,65,607
BETULIA,2020,3,ANTIOQUIA,3464,1895,697,209,1,5,6271,91,370,81,65,607
BETULIA,2020,4,ANTIOQUIA,3467,1901,696,203,1,5,6273,91,381,75,65,612
BETULIA,2020,5,ANTIOQUIA,3490,1910,699,203,1,5,6308,92,380,76,65,613
BETULIA,2020,6,ANTIOQUIA,3490,1915,701,204,1,5,6316,91,382,76,65,614
BETULIA,2020,7,ANTIOQUIA,3502,1914,701,204,1,5,6327,91,382,76,65,614
BETULIA,2020,8,ANTIOQUIA,3510,1915,702,204,1,5,6337,91,381,76,65,613
BETULIA,2020,9,ANTIOQUIA,3513,1920,700,204,1,5,6343,91,382,76,65,614
BETULIA,2021,1,ANTIOQUIA,3543,1923,699,204,1,5,6375,92,391,76,65,624
BETULIA,2021,10,ANTIOQUIA,3563,1951,704,205,1,5,6429,92,395,78,65,630
BETULIA,2021,11,ANTIOQUIA,3562,1952,705,205,1,5,6430,92,395,78,65,630
BETULIA,2021,12,ANTIOQUIA,3567,1955,705,206,1,5,6439,92,398,78,65,633
BETULIA,2021,2,ANTIOQUIA,3544,1924,699,204,1,5,6377,92,394,77,65,628
BETULIA,2021,3,ANTIOQUIA,3548,1927,699,203,1,5,6383,92,394,77,65,628
BETULIA,2021,4,ANTIOQUIA,3551,1926,701,204,1,5,6388,92,395,77,65,629
BETULIA,2021,5,ANTIOQUIA,3551,1931,700,205,1,5,6393,92,394,78,65,629
BETULIA,2021,6,ANTIOQUIA,3555,1939,702,204,1,5,6406,92,395,78,65,630
BETULIA,2021,7,ANTIOQUIA,3556,1948,704,204,1,5,6418,92,395,78,65,630
BETULIA,2021,8,ANTIOQUIA,3557,1948,704,204,1,5,6419,92,395,78,65,630
BETULIA,2021,9,ANTIOQUIA,3558,1949,704,204,1,5,6421,92,395,78,65,630
BETULIA,2022,1,ANTIOQUIA,3571,1955,706,206,1,5,6444,92,398,78,65,633
BETULIA,2022,10,ANTIOQUIA,3603,2006,714,196,1,5,6525,89,403,81,67,640
BETULIA,2022,11,ANTIOQUIA,3615,2013,714,197,1,5,6545,89,403,81,67,640
BETULIA,2022,12,ANTIOQUIA,3620,2026,714,197,1,5,6563,89,407,81,67,644
BETULIA,2022,2,ANTIOQUIA,3578,1960,714,206,1,5,6464,92,398,78,65,633
BETULIA,2022,3,ANTIOQUIA,3594,1977,712,207,1,5,6496,90,398,80,65,633
BETULIA,2022,4,ANTIOQUIA,3582,1999,711,207,1,5,6505,90,398,80,65,633
BETULIA,2022,5,ANTIOQUIA,3584,2004,712,207,1,5,6513,90,399,79,65,633
BETULIA,2022,6,ANTIOQUIA,3586,2008,712,207,1,5,6519,90,401,79,65,635
BETULIA,2022,7,ANTIOQUIA,3590,2015,712,208,1,5,6531,90,401,79,65,635
BETULIA,2022,8,ANTIOQUIA,3569,2005,704,193,1,5,6477,89,401,79,65,634
BETULIA,2022,9,ANTIOQUIA,3599,2001,710,196,1,5,6512,89,402,81,67,639
BETULIA,2023,1,ANTIOQUIA,3621,2029,713,197,1,5,6566,90,407,81,67,645
BETULIA,2023,2,ANTIOQUIA,3621,2032,713,198,1,5,6570,90,407,81,67,645
BETULIA,2023,3,ANTIOQUIA,3635,2049,714,198,1,5,6602,90,406,81,67,644
BETULIA,2023,4,ANTIOQUIA,3653,2061,713,196,1,5,6629,90,406,81,67,644
BETULIA,2023,5,ANTIOQUIA,3667,2065,711,196,1,5,6645,90,406,82,67,645
BETULIA,2023,6,ANTIOQUIA,3673,2082,712,195,1,5,6668,90,407,82,67,646
BETULIA,2023,7,ANTIOQUIA,3690,2091,712,196,1,5,6695,90,407,82,67,646
BETULIA,2023,8,ANTIOQUIA,3689,2089,710,196,1,5,6690,90,407,82,67,646
BETULIA,2023,9,ANTIOQUIA,3698,2094,709,194,1,5,6701,90,408,83,67,648
BRICENO,2018,1,ANTIOQUIA,935,1215,339,12,2,0,2503,39,128,57,7,231
BRICENO,2018,10,ANTIOQUIA,925,1247,349,13,2,0,2536,40,135,57,7,239
BRICENO,2018,11,ANTIOQUIA,919,1240,348,13,2,0,2522,40,134,57,7,238
BRICENO,2018,12,ANTIOQUIA,929,1267,349,13,2,0,2560,40,135,57,7,239
BRICENO,2018,2,ANTIOQUIA,933,1214,344,12,2,0,2505,40,128,57,7,232
BRICENO,2018,3,ANTIOQUIA,928,1214,344,12,2,0,2500,40,128,57,7,232
BRICENO,2018,4,ANTIOQUIA,935,1218,345,12,2,0,2512,40,128,57,7,232
BRICENO,2018,5,ANTIOQUIA,922,1217,349,13,2,0,2503,40,128,57,7,232
BRICENO,2018,6,ANTIOQUIA,921,1223,350,13,2,0,2509,40,132,57,7,236
BRICENO,2018,7,ANTIOQUIA,923,1229,350,13,2,0,2517,40,132,57,7,236
BRICENO,2018,8,ANTIOQUIA,922,1237,351,12,2,0,2524,40,132,57,7,236
BRICENO,2018,9,ANTIOQUIA,919,1239,349,12,2,0,2521,40,132,57,7,236
BRICENO,2019,1,ANTIOQUIA,927,1272,349,13,2,0,2563,40,134,57,7,238
BRICENO,2019,10,ANTIOQUIA,1002,1322,345,12,1,0,2682,41,133,57,7,238
BRICENO,2019,11,ANTIOQUIA,1007,1331,345,12,1,0,2696,41,133,57,7,238
BRICENO,2019,12,ANTIOQUIA,1014,1344,346,12,1,0,2717,42,136,57,7,242
BRICENO,2019,2,ANTIOQUIA,931,1280,349,13,2,0,2575,40,134,57,7,238
BRICENO,2019,3,ANTIOQUIA,943,1297,348,13,2,0,2603,41,134,57,7,239
BRICENO,2019,4,ANTIOQUIA,955,1303,347,13,2,0,2620,41,134,57,7,239
BRICENO,2019,5,ANTIOQUIA,974,1316,352,13,2,0,2657,42,134,57,7,240
BRICENO,2019,6,ANTIOQUIA,963,1307,350,13,2,0,2635,41,134,57,7,239
BRICENO,2019,7,ANTIOQUIA,975,1309,348,13,2,0,2647,41,134,57,7,239
BRICENO,2019,8,ANTIOQUIA,977,1314,347,12,1,0,2651,41,134,57,7,239
BRICENO,2019,9,ANTIOQUIA,993,1317,346,13,1,0,2670,41,134,57,7,239
BRICENO,2020,1,ANTIOQUIA,1013,1341,344,16,1,0,2715,41,136,57,7,241
BRICENO,2020,10,ANTIOQUIA,1039,1367,344,17,1,0,2768,43,141,57,49,290
BRICENO,2020,11,ANTIOQUIA,1040,1370,345,18,1,0,2774,43,141,57,49,290
BRICENO,2020,12,ANTIOQUIA,1054,1370,345,17,1,0,2787,43,142,57,49,291
BRICENO,2020,2,ANTIOQUIA,1011,1339,343,19,1,0,2713,42,135,64,49,290
BRICENO,2020,3,ANTIOQUIA,1011,1345,343,20,1,0,2720,42,135,64,49,290
BRICENO,2020,4,ANTIOQUIA,1017,1350,342,13,1,0,2723,42,141,57,49,289
BRICENO,2020,5,ANTIOQUIA,1018,1355,343,14,1,0,2731,42,141,57,49,289
BRICENO,2020,6,ANTIOQUIA,1017,1363,342,14,1,0,2737,42,141,57,49,289
BRICENO,2020,7,ANTIOQUIA,1030,1367,342,17,1,0,2757,43,141,57,49,290
BRICENO,2020,8,ANTIOQUIA,1030,1370,343,17,1,0,2761,43,140,57,49,289
BRICENO,2020,9,ANTIOQUIA,1041,1369,344,17,1,0,2772,43,141,57,49,290
BRICENO,2021,1,ANTIOQUIA,1061,1375,344,16,1,0,2797,43,141,57,49,290
BRICENO,2021,10,ANTIOQUIA,1080,1425,347,13,1,0,2866,44,144,57,49,294
BRICENO,2021,11,ANTIOQUIA,1080,1426,347,13,1,0,2867,44,144,57,49,294
BRICENO,2021,12,ANTIOQUIA,1085,1436,348,13,1,0,2883,44,144,57,49,294
BRICENO,2021,2,ANTIOQUIA,1063,1377,345,16,1,0,2802,44,141,57,49,291
BRICENO,2021,3,ANTIOQUIA,1068,1386,346,16,1,0,2817,44,141,57,49,291
BRICENO,2021,4,ANTIOQUIA,1070,1414,347,15,1,0,2847,44,141,57,49,291
BRICENO,2021,5,ANTIOQUIA,1073,1417,347,15,1,0,2853,44,141,57,49,291
BRICENO,2021,6,ANTIOQUIA,1076,1416,346,15,1,0,2854,44,141,57,49,291
BRICENO,2021,7,ANTIOQUIA,1077,1422,346,15,1,0,2861,44,142,57,49,292
BRICENO,2021,8,ANTIOQUIA,1077,1422,345,15,1,0,2860,44,143,57,49,293
BRICENO,2021,9,ANTIOQUIA,1079,1423,346,14,1,0,2863,44,142,57,49,292
BRICENO,2022,1,ANTIOQUIA,1088,1436,348,13,1,0,2886,44,145,57,49,295
BRICENO,2022,10,ANTIOQUIA,1086,1459,352,12,1,0,2910,45,148,59,49,301
BRICENO,2022,11,ANTIOQUIA,1086,1472,352,12,1,0,2923,45,148,59,49,301
BRICENO,2022,12,ANTIOQUIA,1086,1473,352,12,1,0,2924,45,148,59,49,301
BRICENO,2022,2,ANTIOQUIA,1089,1436,348,13,1,0,2887,44,145,58,49,296
BRICENO,2022,3,ANTIOQUIA,1090,1446,351,13,1,0,2901,43,145,59,49,296
BRICENO,2022,4,ANTIOQUIA,1085,1457,351,13,1,0,2907,43,145,59,49,296
BRICENO,2022,5,ANTIOQUIA,1079,1453,353,13,1,0,2899,43,146,59,49,297
BRICENO,2022,6,ANTIOQUIA,1081,1451,353,13,1,0,2899,43,147,59,49,298
BRICENO,2022,7,ANTIOQUIA,1084,1454,352,12,1,0,2903,45,149,59,49,302
BRICENO,2022,8,ANTIOQUIA,1086,1457,352,12,1,0,2908,45,148,59,49,301
BRICENO,2022,9,ANTIOQUIA,1085,1458,352,12,1,0,2908,45,148,59,49,301
BRICENO,2023,1,ANTIOQUIA,1086,1474,352,12,1,0,2925,45,148,59,49,301
BRICENO,2023,2,ANTIOQUIA,1085,1475,352,12,1,0,2925,45,148,59,49,301
BRICENO,2023,3,ANTIOQUIA,1085,1480,352,12,1,0,2930,45,149,59,50,303
BRICENO,2023,4,ANTIOQUIA,1084,1482,353,12,1,0,2932,45,149,59,50,303
BRICENO,2023,5,ANTIOQUIA,1085,1485,352,12,1,0,2935,45,149,59,50,303
BRICENO,2023,6,ANTIOQUIA,1075,1483,353,12,1,0,2924,45,149,59,50,303
BRICENO,2023,7,ANTIOQUIA,1076,1483,354,12,1,0,2926,45,149,59,50,303
BRICENO,2023,8,ANTIOQUIA,1068,1472,354,12,1,0,2907,46,150,59,50,305
BRICENO,2023,9,ANTIOQUIA,1076,1477,355,12,1,0,2921,46,150,59,50,305
BURITICA,2018,1,ANTIOQUIA,1263,1266,137,5,1,0,2672,37,115,55,1,208
BURITICA,2018,10,ANTIOQUIA,1264,1321,135,4,2,0,2726,34,112,54,1,201
BURITICA,2018,11,ANTIOQUIA,1262,1322,136,4,2,0,2726,32,112,54,1,199
BURITICA,2018,12,ANTIOQUIA,1266,1325,136,5,2,0,2734,33,112,54,1,200
BURITICA,2018,2,ANTIOQUIA,1264,1268,136,5,1,0,2674,35,115,55,1,206
BURITICA,2018,3,ANTIOQUIA,1265,1272,136,5,1,0,2679,37,114,55,1,207
BURITICA,2018,4,ANTIOQUIA,1266,1289,136,5,1,0,2697,36,116,55,1,208
BURITICA,2018,5,ANTIOQUIA,1259,1290,137,5,1,0,2692,33,115,55,1,204
BURITICA,2018,6,ANTIOQUIA,1269,1299,134,5,1,0,2708,34,114,55,1,204
BURITICA,2018,7,ANTIOQUIA,1269,1306,135,5,2,0,2717,34,113,55,1,203
BURITICA,2018,8,ANTIOQUIA,1269,1309,135,4,2,0,2719,34,112,55,1,202
BURITICA,2018,9,ANTIOQUIA,1265,1311,136,4,2,0,2718,33,112,55,1,201
BURITICA,2019,1,ANTIOQUIA,1264,1333,135,5,2,0,2739,32,113,54,1,200
BURITICA,2019,10,ANTIOQUIA,1287,1352,135,10,2,0,2786,29,117,55,1,202
BURITICA,2019,11,ANTIOQUIA,1284,1357,136,8,2,0,2787,32,117,55,1,205
BURITICA,2019,12,ANTIOQUIA,1289,1357,138,8,2,0,2794,30,117,55,1,203
BURITICA,2019,2,ANTIOQUIA,1264,1334,136,5,2,0,2741,32,113,54,1,200
BURITICA,2019,3,ANTIOQUIA,1272,1334,136,6,2,0,2750,32,114,54,1,201
BURITICA,2019,4,ANTIOQUIA,1274,1338,135,7,2,0,2756,31,115,54,1,201
BURITICA,2019,5,ANTIOQUIA,1277,1342,136,9,2,0,2766,31,115,54,1,201
BURITICA,2019,6,ANTIOQUIA,1279,1342,136,9,2,0,2768,31,117,54,1,203
BURITICA,2019,7,ANTIOQUIA,1282,1343,135,9,2,0,2771,30,116,54,1,201
BURITICA,2019,8,ANTIOQUIA,1282,1346,136,9,2,0,2775,30,118,54,1,203
BURITICA,2019,9,ANTIOQUIA,1284,1351,136,9,2,0,2782,30,117,55,1,203
BURITICA,2020,1,ANTIOQUIA,1289,1359,137,8,1,0,2794,30,118,55,1,204
BURITICA,2020,10,ANTIOQUIA,1326,1388,138,9,1,0,2862,31,120,55,65,271
BURITICA,2020,11,ANTIOQUIA,1329,1390,139,10,1,0,2869,31,120,55,65,271
BURITICA,2020,12,ANTIOQUIA,1332,1383,137,10,1,0,2863,31,130,55,65,281
BURITICA,2020,2,ANTIOQUIA,1287,1363,138,9,1,0,2798,29,118,55,65,267
BURITICA,2020,3,ANTIOQUIA,1289,1367,138,9,1,0,2804,28,118,55,65,266
BURITICA,2020,4,ANTIOQUIA,1291,1366,137,8,1,0,2803,29,118,55,65,267
BURITICA,2020,5,ANTIOQUIA,1312,1371,138,8,1,0,2830,31,119,55,65,270
BURITICA,2020,6,ANTIOQUIA,1313,1372,138,8,1,0,2832,30,119,55,65,269
BURITICA,2020,7,ANTIOQUIA,1317,1378,138,8,1,0,2842,31,119,55,65,270
BURITICA,2020,8,ANTIOQUIA,1318,1380,139,8,1,0,2846,31,119,55,65,270
BURITICA,2020,9,ANTIOQUIA,1321,1385,139,8,1,0,2854,31,120,55,65,271
BURITICA,2021,1,ANTIOQUIA,1337,1388,136,10,1,0,2872,31,130,55,65,281
BURITICA,2021,10,ANTIOQUIA,1344,1420,138,9,1,0,2912,31,131,56,65,283
BURITICA,2021,11,ANTIOQUIA,1339,1423,140,9,1,0,2912,32,132,56,65,285
BURITICA,2021,12,ANTIOQUIA,1342,1423,140,9,1,0,2915,32,132,56,65,285
BURITICA,2021,2,ANTIOQUIA,1338,1392,137,10,1,0,2878,31,129,55,65,280
BURITICA,2021,3,ANTIOQUIA,1341,1396,137,12,1,0,2887,31,129,55,65,280
BURITICA,2021,4,ANTIOQUIA,1341,1400,136,12,1,0,2890,31,129,55,65,280
BURITICA,2021,5,ANTIOQUIA,1339,1399,137,11,1,0,2887,31,129,55,65,280
BURITICA,2021,6,ANTIOQUIA,1342,1411,138,9,1,0,2901,31,129,55,65,280
BURITICA,2021,7,ANTIOQUIA,1338,1406,137,10,1,0,2892,31,131,56,65,283
BURITICA,2021,8,ANTIOQUIA,1340,1421,139,9,1,0,2910,31,131,56,65,283
BURITICA,2021,9,ANTIOQUIA,1341,1419,139,9,1,0,2909,31,131,56,65,283
BURITICA,2022,1,ANTIOQUIA,1343,1427,140,9,1,0,2920,33,132,56,65,286
BURITICA,2022,10,ANTIOQUIA,1362,1476,146,8,1,0,2993,32,136,56,65,289
BURITICA,2022,11,ANTIOQUIA,1365,1485,149,10,1,0,3010,31,136,56,66,289
BURITICA,2022,12,ANTIOQUIA,1367,1488,149,8,1,0,3013,31,136,56,66,289
BURITICA,2022,2,ANTIOQUIA,1343,1431,141,8,1,0,2924,33,132,56,65,286
BURITICA,2022,3,ANTIOQUIA,1349,1440,141,9,1,0,2940,33,133,56,65,287
BURITICA,2022,4,ANTIOQUIA,1353,1444,140,8,1,0,2946,33,133,56,65,287
BURITICA,2022,5,ANTIOQUIA,1355,1455,147,11,1,0,2969,33,133,56,65,287
BURITICA,2022,6,ANTIOQUIA,1361,1455,147,9,1,0,2973,34,134,56,65,289
BURITICA,2022,7,ANTIOQUIA,1355,1458,146,8,1,0,2968,33,134,56,65,288
BURITICA,2022,8,ANTIOQUIA,1356,1465,146,8,1,0,2976,32,134,56,65,287
BURITICA,2022,9,ANTIOQUIA,1357,1472,146,8,1,0,2984,32,135,56,65,288
BURITICA,2023,1,ANTIOQUIA,1371,1496,149,8,1,0,3025,31,136,56,66,289
BURITICA,2023,2,ANTIOQUIA,1371,1510,148,8,1,0,3038,36,138,56,66,296
BURITICA,2023,3,ANTIOQUIA,1376,1528,147,8,1,0,3060,31,139,56,66,292
BURITICA,2023,4,ANTIOQUIA,1382,1535,147,8,1,0,3073,32,140,56,66,294
BURITICA,2023,5,ANTIOQUIA,1394,1540,147,7,1,0,3089,32,139,57,65,293
BURITICA,2023,6,ANTIOQUIA,1401,1548,147,8,1,0,3105,29,136,57,65,287
BURITICA,2023,7,ANTIOQUIA,1409,1557,147,8,1,0,3122,30,135,57,65,287
BURITICA,2023,8,ANTIOQUIA,1412,1556,148,9,1,0,3126,30,136,57,65,288
BURITICA,2023,9,ANTIOQUIA,1420,1566,146,10,1,0,3143,29,136,57,65,287
CACERES,2018,1,ANTIOQUIA,6295,941,92,30,5,1,7364,17,378,84,10,489
CACERES,2018,10,ANTIOQUIA,6441,942,96,33,5,1,7518,16,380,85,10,491
CACERES,2018,11,ANTIOQUIA,6420,942,95,31,5,1,7494,16,381,86,10,493
CACERES,2018,12,ANTIOQUIA,6528,943,95,30,5,1,7602,17,383,87,10,497
CACERES,2018,2,ANTIOQUIA,6309,942,92,31,5,1,7380,16,373,84,10,483
CACERES,2018,3,ANTIOQUIA,6323,938,92,31,5,1,7390,18,375,84,10,487
CACERES,2018,4,ANTIOQUIA,6353,943,93,33,5,1,7428,17,374,84,10,485
CACERES,2018,5,ANTIOQUIA,6318,936,94,32,5,1,7386,17,374,85,11,487
CACERES,2018,6,ANTIOQUIA,6352,936,94,32,5,1,7420,17,376,85,12,490
CACERES,2018,7,ANTIOQUIA,6378,945,96,34,5,1,7459,17,382,85,11,495
CACERES,2018,8,ANTIOQUIA,6414,941,95,33,5,1,7489,17,382,85,10,494
CACERES,2018,9,ANTIOQUIA,6392,941,96,33,5,1,7468,16,380,85,10,491
CACERES,2019,1,ANTIOQUIA,6583,942,95,28,5,1,7654,16,388,87,10,501
CACERES,2019,10,ANTIOQUIA,7047,950,94,31,5,1,8128,17,402,89,10,518
CACERES,2019,11,ANTIOQUIA,7087,953,96,32,5,1,8174,17,402,89,10,518
CACERES,2019,12,ANTIOQUIA,7269,961,98,34,5,1,8368,17,401,90,10,518
CACERES,2019,2,ANTIOQUIA,6711,941,95,28,5,1,7781,18,396,87,10,511
CACERES,2019,3,ANTIOQUIA,6753,943,95,28,5,1,7825,17,396,88,10,511
CACERES,2019,4,ANTIOQUIA,6815,945,95,28,5,1,7889,17,398,88,10,513
CACERES,2019,5,ANTIOQUIA,6930,944,98,28,5,1,8006,17,398,89,10,514
CACERES,2019,6,ANTIOQUIA,6906,942,95,28,5,1,7977,17,398,89,10,514
CACERES,2019,7,ANTIOQUIA,6940,942,93,28,5,1,8009,17,394,89,10,510
CACERES,2019,8,ANTIOQUIA,6951,945,94,29,5,1,8025,17,399,89,10,515
CACERES,2019,9,ANTIOQUIA,6981,950,94,31,5,1,8062,17,402,89,10,518
CACERES,2020,1,ANTIOQUIA,7154,954,96,35,5,1,8245,17,401,90,10,518
CACERES,2020,10,ANTIOQUIA,7535,974,96,37,5,1,8648,20,414,92,224,750
CACERES,2020,11,ANTIOQUIA,7535,975,96,40,5,1,8652,20,414,92,224,750
CACERES,2020,12,ANTIOQUIA,7595,977,96,91,5,1,8765,20,418,93,224,755
CACERES,2020,2,ANTIOQUIA,7159,955,96,33,5,1,8249,17,399,99,224,739
CACERES,2020,3,ANTIOQUIA,7213,957,95,33,5,1,8304,17,399,100,224,740
CACERES,2020,4,ANTIOQUIA,7214,957,94,33,5,1,8304,17,408,91,224,740
CACERES,2020,5,ANTIOQUIA,7594,973,96,42,5,1,8711,21,418,97,224,760
CACERES,2020,6,ANTIOQUIA,7470,970,96,35,5,1,8577,20,416,92,223,751
CACERES,2020,7,ANTIOQUIA,7489,971,96,47,5,1,8609,20,416,92,224,752
CACERES,2020,8,ANTIOQUIA,7531,978,96,47,5,1,8658,21,415,92,224,752
CACERES,2020,9,ANTIOQUIA,7582,974,102,36,5,1,8700,20,415,92,224,751
CACERES,2021,1,ANTIOQUIA,7600,982,96,91,5,1,8775,20,418,93,224,755
CACERES,2021,10,ANTIOQUIA,7673,975,95,48,5,2,8798,19,426,90,224,759
CACERES,2021,11,ANTIOQUIA,7678,977,95,48,5,2,8805,19,428,90,224,761
CACERES,2021,12,ANTIOQUIA,7714,984,95,49,5,2,8849,19,429,90,224,762
CACERES,2021,2,ANTIOQUIA,7628,982,96,92,5,1,8804,20,417,93,224,754
CACERES,2021,3,ANTIOQUIA,7683,983,96,46,5,1,8814,20,418,92,224,754
CACERES,2021,4,ANTIOQUIA,7693,982,96,46,5,2,8824,20,417,89,224,750
CACERES,2021,5,ANTIOQUIA,7691,980,94,46,5,1,8817,20,419,88,223,750
CACERES,2021,6,ANTIOQUIA,7687,978,95,45,5,1,8811,20,419,88,224,751
CACERES,2021,7,ANTIOQUIA,7682,980,95,45,5,1,8808,19,419,89,224,751
CACERES,2021,8,ANTIOQUIA,7691,978,95,46,5,2,8817,19,420,89,224,752
CACERES,2021,9,ANTIOQUIA,7685,977,95,47,5,2,8811,19,427,89,224,759
CACERES,2022,1,ANTIOQUIA,7708,984,95,49,4,2,8842,21,428,90,224,763
CACERES,2022,10,ANTIOQUIA,7653,980,93,49,4,2,8781,21,438,89,225,773
CACERES,2022,11,ANTIOQUIA,7669,982,92,49,4,2,8798,21,438,89,225,773
CACERES,2022,12,ANTIOQUIA,7667,982,93,49,5,2,8798,21,439,90,225,775
CACERES,2022,2,ANTIOQUIA,7717,982,95,49,4,2,8849,21,430,90,224,765
CACERES,2022,3,ANTIOQUIA,7722,980,94,50,4,2,8852,21,437,90,224,772
CACERES,2022,4,ANTIOQUIA,7710,981,94,49,4,2,8840,21,438,90,224,773
CACERES,2022,5,ANTIOQUIA,7700,982,95,48,4,2,8831,21,438,90,224,773
CACERES,2022,6,ANTIOQUIA,7683,980,94,49,4,2,8812,21,439,90,224,774
CACERES,2022,7,ANTIOQUIA,7638,975,95,49,4,2,8763,21,439,90,224,774
CACERES,2022,8,ANTIOQUIA,7648,980,95,47,4,2,8776,21,437,89,224,771
CACERES,2022,9,ANTIOQUIA,7657,978,94,48,4,2,8783,21,438,89,225,773
CACERES,2023,1,ANTIOQUIA,7673,981,92,50,5,2,8803,21,438,89,225,773
CACERES,2023,2,ANTIOQUIA,7734,990,92,51,5,2,8874,22,451,91,225,789
CACERES,2023,3,ANTIOQUIA,7779,996,91,52,5,2,8925,22,451,91,225,789
CACERES,2023,4,ANTIOQUIA,7788,996,91,53,5,2,8935,22,453,91,225,791
CACERES,2023,5,ANTIOQUIA,7798,995,93,53,5,2,8946,22,453,92,225,792
CACERES,2023,6,ANTIOQUIA,7616,989,93,51,5,2,8756,19,448,92,225,784
CACERES,2023,7,ANTIOQUIA,7595,990,93,52,5,2,8737,21,446,92,226,785
CACERES,2023,8,ANTIOQUIA,7625,989,92,51,5,2,8764,21,447,94,226,788
CACERES,2023,9,ANTIOQUIA,7606,990,92,51,5,2,8746,21,448,94,226,789
CAICEDO,2018,1,ANTIOQUIA,1248,1480,172,0,0,0,2900,8,129,55,2,194
CAICEDO,2018,10,ANTIOQUIA,1270,1521,170,0,0,0,2961,9,131,55,2,197
CAICEDO,2018,11,ANTIOQUIA,1272,1524,171,0,0,0,2967,9,131,55,2,197
CAICEDO,2018,12,ANTIOQUIA,1273,1527,171,0,0,0,2971,9,131,55,2,197
CAICEDO,2018,2,ANTIOQUIA,1250,1479,172,0,0,0,2901,8,129,55,2,194
CAICEDO,2018,3,ANTIOQUIA,1250,1482,172,0,0,0,2904,8,129,55,2,194
CAICEDO,2018,4,ANTIOQUIA,1252,1484,173,0,0,0,2909,8,129,55,2,194
CAICEDO,2018,5,ANTIOQUIA,1251,1486,172,0,0,0,2909,9,130,55,2,196
CAICEDO,2018,6,ANTIOQUIA,1252,1493,172,0,0,0,2917,9,130,55,2,196
CAICEDO,2018,7,ANTIOQUIA,1255,1497,172,0,0,0,2924,9,130,55,2,196
CAICEDO,2018,8,ANTIOQUIA,1260,1506,171,0,0,0,2937,9,130,55,2,196
CAICEDO,2018,9,ANTIOQUIA,1262,1511,170,0,0,0,2943,9,130,55,2,196
CAICEDO,2019,1,ANTIOQUIA,1278,1527,170,0,0,0,2975,9,132,55,2,198
CAICEDO,2019,10,ANTIOQUIA,1325,1571,167,1,0,0,3064,8,133,56,2,199
CAICEDO,2019,11,ANTIOQUIA,1324,1578,167,1,0,0,3070,8,132,56,2,198
CAICEDO,2019,12,ANTIOQUIA,1329,1583,167,1,0,0,3080,8,132,56,2,198
CAICEDO,2019,2,ANTIOQUIA,1283,1529,169,0,0,0,2981,9,132,55,2,198
CAICEDO,2019,3,ANTIOQUIA,1288,1535,168,0,0,0,2991,8,132,56,2,198
CAICEDO,2019,4,ANTIOQUIA,1289,1542,168,1,0,0,3000,8,131,56,2,197
CAICEDO,2019,5,ANTIOQUIA,1300,1548,170,1,0,0,3019,8,131,56,2,197
CAICEDO,2019,6,ANTIOQUIA,1303,1556,168,1,0,0,3028,8,132,56,2,198
CAICEDO,2019,7,ANTIOQUIA,1310,1556,168,1,0,0,3035,8,132,56,2,198
CAICEDO,2019,8,ANTIOQUIA,1313,1558,168,1,0,0,3040,8,132,56,2,198
CAICEDO,2019,9,ANTIOQUIA,1321,1567,167,1,0,0,3056,8,132,56,2,198
CAICEDO,2020,1,ANTIOQUIA,1329,1581,167,1,0,0,3078,8,132,56,2,198
CAICEDO,2020,10,ANTIOQUIA,1347,1605,168,0,0,0,3120,8,133,56,35,232
CAICEDO,2020,11,ANTIOQUIA,1350,1608,166,0,0,0,3124,8,133,56,35,232
CAICEDO,2020,12,ANTIOQUIA,1352,1618,166,0,0,0,3136,8,133,56,35,232
CAICEDO,2020,2,ANTIOQUIA,1328,1580,167,2,0,0,3077,8,132,57,35,232
CAICEDO,2020,3,ANTIOQUIA,1329,1581,167,2,0,0,3079,8,132,57,35,232
CAICEDO,2020,4,ANTIOQUIA,1328,1583,167,1,0,0,3079,8,133,56,35,232
CAICEDO,2020,5,ANTIOQUIA,1332,1586,167,1,0,0,3086,8,133,56,35,232
CAICEDO,2020,6,ANTIOQUIA,1331,1588,167,0,0,0,3086,8,133,56,35,232
CAICEDO,2020,7,ANTIOQUIA,1339,1595,168,0,0,0,3102,8,133,56,35,232
CAICEDO,2020,8,ANTIOQUIA,1342,1600,168,0,0,0,3110,8,133,56,35,232
CAICEDO,2020,9,ANTIOQUIA,1344,1604,168,0,0,0,3116,8,133,56,35,232
CAICEDO,2021,1,ANTIOQUIA,1358,1621,167,0,0,0,3146,8,133,57,35,233
CAICEDO,2021,10,ANTIOQUIA,1390,1668,164,1,0,0,3223,8,144,57,35,244
CAICEDO,2021,11,ANTIOQUIA,1391,1671,164,1,0,0,3227,8,144,57,35,244
CAICEDO,2021,12,ANTIOQUIA,1392,1680,164,1,0,0,3237,8,145,57,35,245
CAICEDO,2021,2,ANTIOQUIA,1364,1627,167,0,0,0,3158,9,135,57,35,236
CAICEDO,2021,3,ANTIOQUIA,1365,1637,167,1,0,0,3170,8,137,57,35,237
CAICEDO,2021,4,ANTIOQUIA,1372,1644,165,1,0,0,3182,8,137,57,35,237
CAICEDO,2021,5,ANTIOQUIA,1373,1648,164,1,0,0,3186,8,137,57,34,236
CAICEDO,2021,6,ANTIOQUIA,1374,1648,163,2,0,0,3187,8,137,57,35,237
CAICEDO,2021,7,ANTIOQUIA,1375,1649,163,3,0,0,3190,8,137,57,35,237
CAICEDO,2021,8,ANTIOQUIA,1379,1659,162,3,0,0,3203,7,140,57,35,239
CAICEDO,2021,9,ANTIOQUIA,1386,1667,164,1,0,0,3218,8,142,57,35,242
CAICEDO,2022,1,ANTIOQUIA,1392,1683,163,1,0,0,3239,8,145,57,35,245
CAICEDO,2022,10,ANTIOQUIA,1411,1724,163,1,0,0,3299,7,148,57,35,247
CAICEDO,2022,11,ANTIOQUIA,1413,1729,163,1,0,0,3306,7,150,57,35,249
CAICEDO,2022,12,ANTIOQUIA,1422,1738,163,1,0,0,3324,7,150,57,35,249
CAICEDO,2022,2,ANTIOQUIA,1401,1685,162,1,0,0,3249,8,146,57,35,246
CAICEDO,2022,3,ANTIOQUIA,1402,1693,162,1,0,0,3258,7,146,57,35,245
CAICEDO,2022,4,ANTIOQUIA,1403,1697,162,1,0,0,3263,7,146,57,35,245
CAICEDO,2022,5,ANTIOQUIA,1406,1705,162,1,0,0,3274,7,146,57,35,245
CAICEDO,2022,6,ANTIOQUIA,1408,1716,162,1,0,0,3287,7,146,57,35,245
CAICEDO,2022,7,ANTIOQUIA,1408,1703,162,1,0,0,3274,7,146,57,35,245
CAICEDO,2022,8,ANTIOQUIA,1408,1704,162,1,0,0,3275,7,146,57,35,245
CAICEDO,2022,9,ANTIOQUIA,1410,1722,163,1,0,0,3296,7,146,57,35,245
CAICEDO,2023,1,ANTIOQUIA,1425,1743,163,1,0,0,3332,7,151,57,35,250
CAICEDO,2023,2,ANTIOQUIA,1425,1749,162,1,0,0,3337,7,152,57,35,251
CAICEDO,2023,3,ANTIOQUIA,1432,1763,162,1,0,0,3358,7,151,57,35,250
CAICEDO,2023,4,ANTIOQUIA,1437,1772,163,3,0,0,3375,7,153,57,36,253
CAICEDO,2023,5,ANTIOQUIA,1440,1777,163,3,0,0,3383,7,153,57,36,253
CAICEDO,2023,6,ANTIOQUIA,1450,1792,163,3,0,0,3408,7,154,57,36,254
CAICEDO,2023,7,ANTIOQUIA,1455,1803,162,3,0,0,3423,8,154,57,36,255
CAICEDO,2023,8,ANTIOQUIA,1463,1807,161,3,0,0,3434,7,154,57,36,254
CAICEDO,2023,9,ANTIOQUIA,1465,1817,162,3,0,0,3447,7,154,57,37,255
CALDAS,2018,1,ANTIOQUIA,2884,15824,6515,192,36,7,25458,194,2015,95,14,2318
CALDAS,2018,10,ANTIOQUIA,2913,16161,6740,195,36,7,26052,201,2029,90,15,2335
CALDAS,2018,11,ANTIOQUIA,2914,16177,6745,195,36,7,26074,200,2022,90,15,2327
CALDAS,2018,12,ANTIOQUIA,2920,16212,6760,196,36,7,26131,202,2026,90,15,2333
CALDAS,2018,2,ANTIOQUIA,2882,15857,6567,190,36,7,25539,193,2016,95,14,2318
CALDAS,2018,3,ANTIOQUIA,2883,15881,6568,191,36,7,25566,192,2017,95,14,2318
CALDAS,2018,4,ANTIOQUIA,2891,15940,6687,190,36,7,25751,196,2027,95,15,2333
CALDAS,2018,5,ANTIOQUIA,2893,15949,6695,189,36,7,25769,194,2015,95,15,2319
CALDAS,2018,6,ANTIOQUIA,2899,15994,6710,192,36,7,25838,197,2017,95,15,2324
CALDAS,2018,7,ANTIOQUIA,2903,16029,6724,195,36,7,25894,198,2020,95,15,2328
CALDAS,2018,8,ANTIOQUIA,2904,16069,6729,196,36,7,25941,199,2034,95,15,2343
CALDAS,2018,9,ANTIOQUIA,2906,16120,6733,194,36,7,25996,199,2018,90,15,2322
CALDAS,2019,1,ANTIOQUIA,2925,16244,6786,193,36,7,26191,203,2028,89,15,2335
CALDAS,2019,10,ANTIOQUIA,2949,16684,7194,200,35,7,27069,215,2066,87,15,2383
CALDAS,2019,11,ANTIOQUIA,2959,16707,7200,198,35,7,27106,215,2063,87,15,2380
CALDAS,2019,12,ANTIOQUIA,2971,16748,7211,196,35,7,27168,218,2073,87,15,2393
CALDAS,2019,2,ANTIOQUIA,2919,16275,6835,193,36,7,26265,204,2035,89,15,2343
CALDAS,2019,3,ANTIOQUIA,2920,16302,6857,193,36,7,26315,203,2037,89,15,2344
CALDAS,2019,4,ANTIOQUIA,2934,16324,6921,193,36,7,26415,205,2046,89,15,2355
CALDAS,2019,5,ANTIOQUIA,2926,16395,6922,192,36,7,26478,206,2050,89,15,2360
CALDAS,2019,6,ANTIOQUIA,2931,16433,6946,192,36,7,26545,207,2052,89,15,2363
CALDAS,2019,7,ANTIOQUIA,2950,16476,6991,195,36,7,26655,209,2063,89,15,2376
CALDAS,2019,8,ANTIOQUIA,2942,16540,6996,194,35,7,26714,213,2062,88,15,2378
CALDAS,2019,9,ANTIOQUIA,2943,16635,7093,199,35,7,26912,214,2065,88,14,2381
CALDAS,2020,1,ANTIOQUIA,2961,16744,7210,210,35,7,27167,219,2070,88,15,2392
CALDAS,2020,10,ANTIOQUIA,2999,17149,7419,214,35,7,27823,242,2100,87,564,2993
CALDAS,2020,11,ANTIOQUIA,3009,17187,7446,216,35,7,27900,241,2105,87,564,2997
CALDAS,2020,12,ANTIOQUIA,3013,17246,7427,222,35,7,27950,248,2106,89,563,3006
CALDAS,2020,2,ANTIOQUIA,2966,16770,7249,236,35,7,27263,226,2079,94,564,2963
CALDAS,2020,3,ANTIOQUIA,2970,16795,7277,244,35,7,27328,226,2080,94,563,2963
CALDAS,2020,4,ANTIOQUIA,2974,16819,7280,228,35,7,27343,227,2086,87,564,2964
CALDAS,2020,5,ANTIOQUIA,2983,16893,7311,235,36,7,27465,237,2174,87,562,3060
CALDAS,2020,6,ANTIOQUIA,2978,16916,7310,231,35,7,27477,237,2092,88,564,2981
CALDAS,2020,7,ANTIOQUIA,2989,17027,7374,234,35,7,27666,241,2093,88,564,2986
CALDAS,2020,8,ANTIOQUIA,2993,17057,7381,234,35,7,27707,241,2094,87,564,2986
CALDAS,2020,9,ANTIOQUIA,2997,17115,7418,211,35,7,27783,241,2100,87,564,2992
CALDAS,2021,1,ANTIOQUIA,3013,17284,7463,236,35,7,28038,248,2107,89,563,3007
CALDAS,2021,10,ANTIOQUIA,3047,17843,7660,242,37,8,28837,259,2138,89,566,3052
CALDAS,2021,11,ANTIOQUIA,3053,17893,7663,239,38,8,28894,263,2149,91,564,3067
CALDAS,2021,12,ANTIOQUIA,3062,17962,7699,240,38,8,29009,264,2154,91,564,3073
CALDAS,2021,2,ANTIOQUIA,3018,17323,7489,233,35,7,28105,250,2112,89,563,3014
CALDAS,2021,3,ANTIOQUIA,3021,17365,7491,215,36,8,28136,249,2115,88,564,3016
CALDAS,2021,4,ANTIOQUIA,3026,17394,7509,216,36,8,28189,254,2117,88,565,3024
CALDAS,2021,5,ANTIOQUIA,3026,17514,7513,218,36,8,28315,253,2124,90,563,3030
CALDAS,2021,6,ANTIOQUIA,3023,17531,7612,228,35,8,28437,254,2134,88,565,3041
CALDAS,2021,7,ANTIOQUIA,3025,17585,7642,234,35,8,28529,253,2137,88,565,3043
CALDAS,2021,8,ANTIOQUIA,3034,17640,7648,237,35,8,28602,255,2133,88,566,3042
CALDAS,2021,9,ANTIOQUIA,3041,17715,7658,239,36,8,28697,254,2134,90,564,3042
CALDAS,2022,1,ANTIOQUIA,3065,18005,7763,244,40,8,29125,264,2156,91,564,3075
CALDAS,2022,10,ANTIOQUIA,3068,18463,7939,267,40,7,29784,264,2208,90,564,3126
CALDAS,2022,11,ANTIOQUIA,3072,18502,7944,263,40,7,29828,266,2210,90,565,3131
CALDAS,2022,12,ANTIOQUIA,3073,18507,7963,262,40,7,29852,267,2229,90,565,3151
CALDAS,2022,2,ANTIOQUIA,3072,18046,7768,245,40,8,29179,264,2163,90,565,3082
CALDAS,2022,3,ANTIOQUIA,3073,18094,7771,247,40,8,29233,263,2162,91,564,3080
CALDAS,2022,4,ANTIOQUIA,3078,18155,7822,253,40,8,29356,263,2179,91,564,3097
CALDAS,2022,5,ANTIOQUIA,3040,18216,7832,258,39,8,29393,265,2184,91,564,3104
CALDAS,2022,6,ANTIOQUIA,3039,18280,7897,271,40,8,29535,264,2194,91,564,3113
CALDAS,2022,7,ANTIOQUIA,3063,18305,7911,274,41,7,29601,263,2201,91,564,3119
CALDAS,2022,8,ANTIOQUIA,3064,18354,7925,269,40,7,29659,264,2203,90,564,3121
CALDAS,2022,9,ANTIOQUIA,3065,18392,7932,267,40,7,29703,264,2208,90,564,3126
CALDAS,2023,1,ANTIOQUIA,3079,18534,7970,305,40,7,29935,268,2236,90,565,3159
CALDAS,2023,2,ANTIOQUIA,3090,18566,8002,308,40,7,30013,269,2244,90,565,3168
CALDAS,2023,3,ANTIOQUIA,3090,18611,8093,311,40,7,30152,270,2249,91,565,3175
CALDAS,2023,4,ANTIOQUIA,3090,18642,8098,317,40,7,30194,267,2249,91,565,3172
CALDAS,2023,5,ANTIOQUIA,3093,18858,8101,320,39,7,30418,268,2255,92,565,3180
CALDAS,2023,6,ANTIOQUIA,3085,19113,8104,321,39,7,30669,270,2247,91,565,3173
CALDAS,2023,7,ANTIOQUIA,3077,19178,8120,321,39,6,30741,269,2262,91,565,3187
CALDAS,2023,8,ANTIOQUIA,3081,19188,8124,318,39,6,30756,270,2266,91,565,3192
CALDAS,2023,9,ANTIOQUIA,3086,19240,8143,318,39,6,30832,276,2282,90,565,3213
CAMPAMENTO,2018,1,ANTIOQUIA,547,1841,129,17,0,0,2534,79,171,61,4,315
CAMPAMENTO,2018,10,ANTIOQUIA,580,1851,131,18,0,0,2580,79,181,61,4,325
CAMPAMENTO,2018,11,ANTIOQUIA,583,1852,131,19,0,0,2585,79,181,61,4,325
CAMPAMENTO,2018,12,ANTIOQUIA,588,1856,131,19,0,0,2594,79,181,61,4,325
CAMPAMENTO,2018,2,ANTIOQUIA,548,1843,129,17,0,0,2537,78,172,61,4,315
CAMPAMENTO,2018,3,ANTIOQUIA,547,1847,130,18,0,0,2542,79,172,61,4,316
CAMPAMENTO,2018,4,ANTIOQUIA,550,1850,131,18,0,0,2549,80,172,61,4,317
CAMPAMENTO,2018,5,ANTIOQUIA,541,1837,131,18,0,0,2527,79,172,61,4,316
CAMPAMENTO,2018,6,ANTIOQUIA,544,1839,131,18,0,0,2532,79,172,61,4,316
CAMPAMENTO,2018,7,ANTIOQUIA,546,1842,130,18,0,0,2536,79,173,61,4,317
CAMPAMENTO,2018,8,ANTIOQUIA,570,1845,131,18,0,0,2564,80,178,61,4,323
CAMPAMENTO,2018,9,ANTIOQUIA,574,1849,132,18,0,0,2573,79,179,61,4,323
CAMPAMENTO,2019,1,ANTIOQUIA,590,1868,131,19,0,0,2608,79,181,61,4,325
CAMPAMENTO,2019,10,ANTIOQUIA,627,1904,131,21,0,0,2683,80,189,61,4,334
CAMPAMENTO,2019,11,ANTIOQUIA,630,1902,132,21,0,0,2685,79,188,61,4,332
CAMPAMENTO,2019,12,ANTIOQUIA,633,1908,131,21,0,0,2693,83,188,61,4,336
CAMPAMENTO,2019,2,ANTIOQUIA,592,1867,131,19,0,0,2609,79,181,61,4,325
CAMPAMENTO,2019,3,ANTIOQUIA,594,1873,131,19,0,0,2617,79,182,61,4,326
CAMPAMENTO,2019,4,ANTIOQUIA,597,1882,131,18,0,0,2628,79,181,61,4,325
CAMPAMENTO,2019,5,ANTIOQUIA,616,1900,131,18,0,0,2665,78,184,61,4,327
CAMPAMENTO,2019,6,ANTIOQUIA,616,1886,131,19,0,0,2652,79,183,61,4,327
CAMPAMENTO,2019,7,ANTIOQUIA,612,1894,131,21,0,0,2658,79,184,61,4,328
CAMPAMENTO,2019,8,ANTIOQUIA,614,1895,131,20,0,0,2660,79,186,61,4,330
CAMPAMENTO,2019,9,ANTIOQUIA,627,1897,131,21,0,0,2676,80,187,61,4,332
CAMPAMENTO,2020,1,ANTIOQUIA,630,1906,131,22,0,0,2689,84,188,61,4,337
CAMPAMENTO,2020,10,ANTIOQUIA,646,1940,131,25,0,0,2742,87,194,61,23,365
CAMPAMENTO,2020,11,ANTIOQUIA,648,1940,132,25,0,0,2745,86,191,61,23,361
CAMPAMENTO,2020,12,ANTIOQUIA,649,1945,132,28,0,0,2754,88,193,61,23,365
CAMPAMENTO,2020,2,ANTIOQUIA,631,1910,131,22,0,0,2694,84,189,64,24,361
CAMPAMENTO,2020,3,ANTIOQUIA,632,1915,131,22,0,0,2700,83,189,64,24,360
CAMPAMENTO,2020,4,ANTIOQUIA,630,1922,131,23,0,0,2706,85,191,61,23,360
CAMPAMENTO,2020,5,ANTIOQUIA,642,1933,131,23,0,0,2729,85,192,61,23,361
CAMPAMENTO,2020,6,ANTIOQUIA,643,1931,131,23,0,0,2728,85,192,61,23,361
CAMPAMENTO,2020,7,ANTIOQUIA,642,1932,131,23,0,0,2728,85,192,61,23,361
CAMPAMENTO,2020,8,ANTIOQUIA,645,1931,131,23,0,0,2730,87,192,61,23,363
CAMPAMENTO,2020,9,ANTIOQUIA,645,1933,131,24,0,0,2733,87,192,61,23,363
CAMPAMENTO,2021,1,ANTIOQUIA,649,1956,132,29,0,0,2766,87,193,61,23,364
CAMPAMENTO,2021,10,ANTIOQUIA,674,2128,21,22,0,0,2845,96,194,61,23,374
CAMPAMENTO,2021,11,ANTIOQUIA,678,2135,19,21,0,0,2853,96,195,61,23,375
CAMPAMENTO,2021,12,ANTIOQUIA,681,2137,19,21,0,0,2858,97,196,61,23,377
CAMPAMENTO,2021,2,ANTIOQUIA,654,1956,132,29,0,0,2771,88,193,61,23,365
CAMPAMENTO,2021,3,ANTIOQUIA,657,1961,132,29,0,0,2779,91,195,61,23,370
CAMPAMENTO,2021,4,ANTIOQUIA,653,1972,132,32,0,0,2789,91,196,61,23,371
CAMPAMENTO,2021,5,ANTIOQUIA,654,1981,129,33,0,0,2797,92,196,61,23,372
CAMPAMENTO,2021,6,ANTIOQUIA,652,2110,20,20,0,0,2802,91,196,61,23,371
CAMPAMENTO,2021,7,ANTIOQUIA,648,2114,20,20,0,0,2802,91,196,61,23,371
CAMPAMENTO,2021,8,ANTIOQUIA,659,2119,21,21,0,0,2820,92,193,61,23,369
CAMPAMENTO,2021,9,ANTIOQUIA,668,2120,21,21,0,0,2830,96,193,61,23,373
CAMPAMENTO,2022,1,ANTIOQUIA,680,2147,19,21,0,0,2867,97,196,61,23,377
CAMPAMENTO,2022,10,ANTIOQUIA,683,2029,26,26,0,0,2764,82,195,58,24,359
CAMPAMENTO,2022,11,ANTIOQUIA,684,2039,27,28,0,0,2778,83,196,58,24,361
CAMPAMENTO,2022,12,ANTIOQUIA,686,2042,27,28,0,0,2783,83,196,58,24,361
CAMPAMENTO,2022,2,ANTIOQUIA,686,2150,20,23,0,0,2879,95,196,61,23,375
CAMPAMENTO,2022,3,ANTIOQUIA,692,2158,20,27,0,0,2897,97,196,61,23,377
CAMPAMENTO,2022,4,ANTIOQUIA,695,2163,20,27,0,0,2905,97,195,61,23,376
CAMPAMENTO,2022,5,ANTIOQUIA,684,2067,21,25,0,0,2797,87,190,58,23,358
CAMPAMENTO,2022,6,ANTIOQUIA,669,2012,23,24,0,0,2728,84,190,58,23,355
CAMPAMENTO,2022,7,ANTIOQUIA,675,2006,24,24,0,0,2729,82,191,58,23,354
CAMPAMENTO,2022,8,ANTIOQUIA,679,2014,25,22,0,0,2740,82,193,58,24,357
CAMPAMENTO,2022,9,ANTIOQUIA,681,2022,26,23,0,0,2752,82,194,58,24,358
CAMPAMENTO,2023,1,ANTIOQUIA,687,2051,29,27,0,0,2794,83,196,58,24,361
CAMPAMENTO,2023,2,ANTIOQUIA,687,2053,29,30,0,0,2799,84,196,58,24,362
CAMPAMENTO,2023,3,ANTIOQUIA,687,2066,30,30,0,0,2813,84,196,58,24,362
CAMPAMENTO,2023,4,ANTIOQUIA,691,2070,34,27,0,0,2822,84,197,58,24,363
CAMPAMENTO,2023,5,ANTIOQUIA,694,2085,34,22,0,0,2835,85,197,58,24,364
CAMPAMENTO,2023,6,ANTIOQUIA,686,2087,34,19,0,0,2826,83,197,58,24,362
CAMPAMENTO,2023,7,ANTIOQUIA,691,2091,35,17,0,0,2834,83,197,58,24,362
CAMPAMENTO,2023,8,ANTIOQUIA,688,2097,35,18,0,0,2838,83,199,58,24,364
CAMPAMENTO,2023,9,ANTIOQUIA,689,2099,35,18,0,0,2841,84,199,58,24,365
CANASGORDAS,2018,1,ANTIOQUIA,1873,3503,167,2,0,0,5545,22,320,105,9,456
CANASGORDAS,2018,10,ANTIOQUIA,1892,3602,179,4,0,0,5677,22,324,105,9,460
CANASGORDAS,2018,11,ANTIOQUIA,1891,3597,179,4,0,0,5671,22,324,105,9,460
CANASGORDAS,2018,12,ANTIOQUIA,1892,3601,179,4,0,0,5676,22,324,105,9,460
CANASGORDAS,2018,2,ANTIOQUIA,1875,3508,167,2,0,0,5552,21,320,105,9,455
CANASGORDAS,2018,3,ANTIOQUIA,1880,3520,179,4,0,0,5583,21,321,105,9,456
CANASGORDAS,2018,4,ANTIOQUIA,1882,3538,180,4,0,0,5604,21,320,105,9,455
CANASGORDAS,2018,5,ANTIOQUIA,1875,3546,180,4,0,0,5605,21,321,105,9,456
CANASGORDAS,2018,6,ANTIOQUIA,1883,3552,180,4,0,0,5619,21,322,105,9,457
CANASGORDAS,2018,7,ANTIOQUIA,1881,3567,179,4,0,0,5631,21,322,105,9,457
CANASGORDAS,2018,8,ANTIOQUIA,1881,3571,179,4,0,0,5635,22,323,105,9,459
CANASGORDAS,2018,9,ANTIOQUIA,1888,3579,179,4,0,0,5650,22,323,105,9,459
CANASGORDAS,2019,1,ANTIOQUIA,1896,3611,177,4,0,0,5688,23,324,104,9,460
CANASGORDAS,2019,10,ANTIOQUIA,1960,3686,176,5,0,0,5827,25,329,104,9,467
CANASGORDAS,2019,11,ANTIOQUIA,1962,3691,175,5,0,0,5833,25,329,104,9,467
CANASGORDAS,2019,12,ANTIOQUIA,1968,3697,177,5,0,0,5847,25,329,105,9,468
CANASGORDAS,2019,2,ANTIOQUIA,1941,3621,177,5,0,0,5744,23,325,104,9,461
CANASGORDAS,2019,3,ANTIOQUIA,1944,3627,179,5,0,0,5755,24,323,105,9,461
CANASGORDAS,2019,4,ANTIOQUIA,1949,3635,178,6,0,0,5768,24,323,104,9,460
CANASGORDAS,2019,5,ANTIOQUIA,1951,3642,179,6,0,0,5778,24,323,104,9,460
CANASGORDAS,2019,6,ANTIOQUIA,1947,3649,179,6,0,0,5781,24,325,106,9,464
CANASGORDAS,2019,7,ANTIOQUIA,1955,3660,177,6,0,0,5798,24,330,104,9,467
CANASGORDAS,2019,8,ANTIOQUIA,1954,3662,176,6,0,0,5798,24,329,104,9,466
CANASGORDAS,2019,9,ANTIOQUIA,1962,3671,177,5,0,0,5815,24,330,104,9,467
CANASGORDAS,2020,1,ANTIOQUIA,1964,3697,175,10,0,0,5846,25,328,104,9,466
CANASGORDAS,2020,10,ANTIOQUIA,2002,3801,171,9,0,0,5983,26,333,105,118,582
CANASGORDAS,2020,11,ANTIOQUIA,2009,3823,160,9,0,0,6001,26,339,105,118,588
CANASGORDAS,2020,12,ANTIOQUIA,2016,3836,160,9,0,0,6021,26,339,105,118,588
CANASGORDAS,2020,2,ANTIOQUIA,1970,3711,176,16,0,0,5873,25,328,113,118,584
CANASGORDAS,2020,3,ANTIOQUIA,1973,3721,175,16,0,0,5885,24,328,114,118,584
CANASGORDAS,2020,4,ANTIOQUIA,1972,3728,173,6,0,0,5879,24,336,105,118,583
CANASGORDAS,2020,5,ANTIOQUIA,1975,3735,173,6,0,0,5889,24,336,105,118,583
CANASGORDAS,2020,6,ANTIOQUIA,1983,3738,173,7,0,0,5901,24,336,105,118,583
CANASGORDAS,2020,7,ANTIOQUIA,1984,3745,172,7,0,0,5908,25,335,105,118,583
CANASGORDAS,2020,8,ANTIOQUIA,1980,3755,172,10,0,0,5917,25,332,105,118,580
CANASGORDAS,2020,9,ANTIOQUIA,1991,3765,172,9,0,0,5937,26,333,105,118,582
CANASGORDAS,2021,1,ANTIOQUIA,2023,3848,160,12,0,0,6043,25,339,105,118,587
CANASGORDAS,2021,10,ANTIOQUIA,2039,3941,162,15,0,0,6157,26,340,105,118,589
CANASGORDAS,2021,11,ANTIOQUIA,2041,3947,162,15,0,0,6165,26,341,105,118,590
CANASGORDAS,2021,12,ANTIOQUIA,2044,3955,165,15,0,0,6179,26,341,105,118,590
CANASGORDAS,2021,2,ANTIOQUIA,2019,3859,160,11,0,0,6049,25,339,105,118,587
CANASGORDAS,2021,3,ANTIOQUIA,2029,3867,159,11,0,0,6066,25,338,105,118,586
CANASGORDAS,2021,4,ANTIOQUIA,2036,3883,158,11,0,0,6088,25,337,105,118,585
CANASGORDAS,2021,5,ANTIOQUIA,2039,3897,159,15,0,0,6110,26,339,105,118,588
CANASGORDAS,2021,6,ANTIOQUIA,2039,3903,159,18,0,0,6119,27,341,105,118,591
CANASGORDAS,2021,7,ANTIOQUIA,2040,3913,163,16,0,0,6132,26,341,105,118,590
CANASGORDAS,2021,8,ANTIOQUIA,2042,3920,162,16,0,0,6140,26,340,105,118,589
CANASGORDAS,2021,9,ANTIOQUIA,2038,3925,162,15,0,0,6140,26,340,105,118,589
CANASGORDAS,2022,1,ANTIOQUIA,2048,3964,165,16,0,0,6193,26,341,105,118,590
CANASGORDAS,2022,10,ANTIOQUIA,2071,4109,161,18,0,0,6359,23,350,103,118,594
CANASGORDAS,2022,11,ANTIOQUIA,2072,4122,161,20,0,0,6375,23,351,103,118,595
CANASGORDAS,2022,12,ANTIOQUIA,2075,4137,160,19,0,0,6391,23,352,103,118,596
CANASGORDAS,2022,2,ANTIOQUIA,2048,3977,164,18,0,0,6207,25,341,105,118,589
CANASGORDAS,2022,3,ANTIOQUIA,2054,4006,164,19,0,0,6243,25,341,105,118,589
CANASGORDAS,2022,4,ANTIOQUIA,2045,4033,164,18,0,0,6260,25,341,105,118,589
CANASGORDAS,2022,5,ANTIOQUIA,2055,4054,164,17,0,0,6290,25,342,105,118,590
CANASGORDAS,2022,6,ANTIOQUIA,2059,4064,165,17,0,0,6305,24,343,105,118,590
CANASGORDAS,2022,7,ANTIOQUIA,2061,4051,162,18,0,0,6292,24,346,103,118,591
CANASGORDAS,2022,8,ANTIOQUIA,2063,4065,161,18,0,0,6307,23,346,103,118,590
CANASGORDAS,2022,9,ANTIOQUIA,2069,4083,161,17,0,0,6330,23,350,103,118,594
CANASGORDAS,2023,1,ANTIOQUIA,2086,4153,159,16,0,0,6414,24,352,103,118,597
CANASGORDAS,2023,2,ANTIOQUIA,2086,4171,154,15,0,0,6426,24,352,103,118,597
CANASGORDAS,2023,3,ANTIOQUIA,2099,4191,154,17,0,0,6461,24,352,103,118,597
CANASGORDAS,2023,4,ANTIOQUIA,2111,4202,154,17,0,0,6484,24,353,103,118,598
CANASGORDAS,2023,5,ANTIOQUIA,2113,4212,154,17,0,0,6496,24,352,103,118,597
CANASGORDAS,2023,6,ANTIOQUIA,2129,4239,154,17,0,0,6539,24,352,104,118,598
CANASGORDAS,2023,7,ANTIOQUIA,2131,4249,152,18,0,0,6550,24,352,104,118,598
CANASGORDAS,2023,8,ANTIOQUIA,2132,4260,152,18,0,0,6562,24,351,105,118,598
CANASGORDAS,2023,9,ANTIOQUIA,2140,4274,153,20,0,0,6587,23,350,105,118,596
CARACOLI,2018,1,ANTIOQUIA,745,1041,59,4,1,0,1850,20,139,40,3,202
CARACOLI,2018,10,ANTIOQUIA,753,1059,58,3,1,0,1874,17,140,40,3,200
CARACOLI,2018,11,ANTIOQUIA,753,1058,57,3,1,0,1872,16,140,40,3,199
CARACOLI,2018,12,ANTIOQUIA,755,1058,57,3,1,0,1874,15,140,40,3,198
CARACOLI,2018,2,ANTIOQUIA,747,1040,59,4,1,0,1851,19,139,40,3,201
CARACOLI,2018,3,ANTIOQUIA,749,1042,59,4,1,0,1855,19,139,40,3,201
CARACOLI,2018,4,ANTIOQUIA,750,1045,59,4,1,0,1859,19,139,40,3,201
CARACOLI,2018,5,ANTIOQUIA,747,1046,58,4,1,0,1856,18,139,40,3,200
CARACOLI,2018,6,ANTIOQUIA,748,1051,58,4,1,0,1862,17,139,40,3,199
CARACOLI,2018,7,ANTIOQUIA,752,1052,58,4,1,0,1867,18,139,40,3,200
CARACOLI,2018,8,ANTIOQUIA,753,1060,58,3,1,0,1875,18,139,40,3,200
CARACOLI,2018,9,ANTIOQUIA,752,1060,58,3,1,0,1874,16,139,40,3,198
CARACOLI,2019,1,ANTIOQUIA,755,1058,56,3,1,0,1873,14,141,40,3,198
CARACOLI,2019,10,ANTIOQUIA,763,1059,56,3,1,0,1882,14,142,40,3,199
CARACOLI,2019,11,ANTIOQUIA,764,1059,56,3,1,0,1883,14,142,40,3,199
CARACOLI,2019,12,ANTIOQUIA,765,1060,57,3,1,0,1886,14,142,40,3,199
CARACOLI,2019,2,ANTIOQUIA,755,1060,56,3,1,0,1875,14,140,40,3,197
CARACOLI,2019,3,ANTIOQUIA,755,1060,56,3,1,0,1875,14,140,40,3,197
CARACOLI,2019,4,ANTIOQUIA,755,1061,56,3,1,0,1876,14,140,40,3,197
CARACOLI,2019,5,ANTIOQUIA,758,1062,57,3,1,0,1881,14,140,40,3,197
CARACOLI,2019,6,ANTIOQUIA,757,1060,56,3,1,0,1877,14,142,40,3,199
CARACOLI,2019,7,ANTIOQUIA,757,1060,56,3,1,0,1877,14,142,40,3,199
CARACOLI,2019,8,ANTIOQUIA,760,1060,56,3,1,0,1880,14,142,40,3,199
CARACOLI,2019,9,ANTIOQUIA,761,1060,56,3,1,0,1881,14,142,40,3,199
CARACOLI,2020,1,ANTIOQUIA,764,1059,57,4,1,0,1885,14,142,40,3,199
CARACOLI,2020,10,ANTIOQUIA,780,1064,58,3,1,0,1906,15,139,40,39,233
CARACOLI,2020,11,ANTIOQUIA,784,1064,58,3,1,0,1910,15,142,40,39,236
CARACOLI,2020,12,ANTIOQUIA,786,1066,58,3,1,0,1914,15,142,40,39,236
CARACOLI,2020,2,ANTIOQUIA,767,1059,56,4,1,0,1887,15,141,40,39,235
CARACOLI,2020,3,ANTIOQUIA,766,1059,56,4,1,0,1886,15,141,40,39,235
CARACOLI,2020,4,ANTIOQUIA,766,1061,56,3,1,0,1887,15,141,40,39,235
CARACOLI,2020,5,ANTIOQUIA,790,1070,59,3,1,0,1923,15,141,46,39,241
CARACOLI,2020,6,ANTIOQUIA,769,1062,58,3,1,0,1893,15,141,40,39,235
CARACOLI,2020,7,ANTIOQUIA,771,1062,57,3,1,0,1894,15,141,40,39,235
CARACOLI,2020,8,ANTIOQUIA,783,1068,58,3,1,0,1913,15,140,40,39,234
CARACOLI,2020,9,ANTIOQUIA,777,1060,58,3,1,0,1899,15,140,40,39,234
CARACOLI,2021,1,ANTIOQUIA,789,1065,58,3,1,0,1916,15,142,40,39,236
CARACOLI,2021,10,ANTIOQUIA,802,1069,58,5,1,0,1935,15,143,40,39,237
CARACOLI,2021,11,ANTIOQUIA,803,1069,58,5,1,0,1936,15,143,40,39,237
CARACOLI,2021,12,ANTIOQUIA,801,1070,58,5,1,0,1935,15,142,40,39,236
CARACOLI,2021,2,ANTIOQUIA,790,1064,58,3,1,0,1916,15,141,40,39,235
CARACOLI,2021,3,ANTIOQUIA,796,1065,58,3,1,0,1923,15,143,40,39,237
CARACOLI,2021,4,ANTIOQUIA,797,1067,58,4,1,0,1927,15,143,40,39,237
CARACOLI,2021,5,ANTIOQUIA,799,1067,58,4,1,0,1929,15,143,40,39,237
CARACOLI,2021,6,ANTIOQUIA,799,1067,58,5,1,0,1930,15,143,40,39,237
CARACOLI,2021,7,ANTIOQUIA,800,1067,58,5,1,0,1931,15,143,40,39,237
CARACOLI,2021,8,ANTIOQUIA,799,1066,58,5,1,0,1929,15,143,40,39,237
CARACOLI,2021,9,ANTIOQUIA,800,1068,58,5,1,0,1932,15,143,40,39,237
CARACOLI,2022,1,ANTIOQUIA,801,1071,58,5,1,0,1936,15,142,40,39,236
CARACOLI,2022,10,ANTIOQUIA,805,1083,59,6,1,0,1954,11,143,41,38,233
CARACOLI,2022,11,ANTIOQUIA,804,1085,59,6,1,0,1955,11,143,41,38,233
CARACOLI,2022,12,ANTIOQUIA,804,1087,59,6,1,0,1957,11,143,41,38,233
CARACOLI,2022,2,ANTIOQUIA,802,1071,58,6,1,0,1938,15,142,40,39,236
CARACOLI,2022,3,ANTIOQUIA,804,1073,58,7,1,0,1943,14,142,41,38,235
CARACOLI,2022,4,ANTIOQUIA,806,1075,58,7,1,0,1947,14,143,41,38,236
CARACOLI,2022,5,ANTIOQUIA,795,1086,58,7,1,0,1947,14,144,41,38,237
CARACOLI,2022,6,ANTIOQUIA,797,1087,58,5,1,0,1948,14,144,41,38,237
CARACOLI,2022,7,ANTIOQUIA,803,1079,59,6,1,0,1948,11,143,41,38,233
CARACOLI,2022,8,ANTIOQUIA,804,1079,59,6,1,0,1949,11,143,41,38,233
CARACOLI,2022,9,ANTIOQUIA,804,1081,59,6,1,0,1951,11,143,41,38,233
CARACOLI,2023,1,ANTIOQUIA,807,1087,59,6,1,0,1960,11,143,41,38,233
CARACOLI,2023,2,ANTIOQUIA,809,1086,59,6,1,0,1961,11,143,41,38,233
CARACOLI,2023,3,ANTIOQUIA,810,1089,60,6,1,0,1966,11,143,41,38,233
CARACOLI,2023,4,ANTIOQUIA,809,1087,60,6,1,0,1963,12,143,41,38,234
CARACOLI,2023,5,ANTIOQUIA,809,1088,60,6,1,0,1964,12,144,41,38,235
CARACOLI,2023,6,ANTIOQUIA,809,1087,61,7,1,0,1965,12,145,42,38,237
CARACOLI,2023,7,ANTIOQUIA,809,1088,62,7,1,0,1967,12,146,42,39,239
CARACOLI,2023,8,ANTIOQUIA,810,1089,61,6,1,0,1967,12,146,42,39,239
CARACOLI,2023,9,ANTIOQUIA,809,1092,60,6,1,0,1968,12,146,42,39,239
CARAMANTA,2018,1,ANTIOQUIA,371,1039,570,6,1,2,1989,7,132,46,7,192
CARAMANTA,2018,10,ANTIOQUIA,376,1055,572,8,1,2,2014,7,133,46,7,193
CARAMANTA,2018,11,ANTIOQUIA,376,1055,572,8,1,2,2014,7,133,46,7,193
CARAMANTA,2018,12,ANTIOQUIA,376,1058,571,8,1,2,2016,7,133,46,7,193
CARAMANTA,2018,2,ANTIOQUIA,372,1040,570,6,1,2,1991,7,132,46,7,192
CARAMANTA,2018,3,ANTIOQUIA,371,1040,569,6,1,2,1989,7,132,46,7,192
CARAMANTA,2018,4,ANTIOQUIA,373,1041,569,6,1,2,1992,7,132,46,7,192
CARAMANTA,2018,5,ANTIOQUIA,371,1042,568,6,1,2,1990,7,132,46,7,192
CARAMANTA,2018,6,ANTIOQUIA,370,1045,568,6,1,2,1992,7,132,46,7,192
CARAMANTA,2018,7,ANTIOQUIA,371,1046,569,7,1,2,1996,7,132,46,7,192
CARAMANTA,2018,8,ANTIOQUIA,372,1048,568,7,1,2,1998,7,132,46,7,192
CARAMANTA,2018,9,ANTIOQUIA,372,1049,571,8,1,2,2003,7,132,46,7,192
CARAMANTA,2019,1,ANTIOQUIA,375,1059,571,7,1,2,2015,7,133,46,7,193
CARAMANTA,2019,10,ANTIOQUIA,382,1065,573,8,1,2,2031,6,133,46,7,192
CARAMANTA,2019,11,ANTIOQUIA,383,1066,573,7,1,2,2032,6,134,46,7,193
CARAMANTA,2019,12,ANTIOQUIA,383,1072,573,7,1,2,2038,6,134,46,7,193
CARAMANTA,2019,2,ANTIOQUIA,376,1061,571,7,1,2,2018,7,133,46,7,193
CARAMANTA,2019,3,ANTIOQUIA,377,1063,569,7,1,2,2019,7,133,46,7,193
CARAMANTA,2019,4,ANTIOQUIA,377,1062,569,7,1,2,2018,7,133,46,7,193
CARAMANTA,2019,5,ANTIOQUIA,380,1064,569,7,1,2,2023,7,133,46,7,193
CARAMANTA,2019,6,ANTIOQUIA,380,1064,569,7,1,2,2023,7,133,46,7,193
CARAMANTA,2019,7,ANTIOQUIA,381,1063,569,7,1,2,2023,7,133,46,7,193
CARAMANTA,2019,8,ANTIOQUIA,382,1063,569,7,1,2,2024,7,133,46,7,193
CARAMANTA,2019,9,ANTIOQUIA,382,1065,572,7,1,2,2029,7,133,46,7,193
CARAMANTA,2020,1,ANTIOQUIA,384,1070,573,9,1,2,2039,6,133,46,7,192
CARAMANTA,2020,10,ANTIOQUIA,389,1080,573,8,1,2,2053,6,141,46,69,262
CARAMANTA,2020,11,ANTIOQUIA,389,1081,572,8,1,2,2053,6,142,46,69,263
CARAMANTA,2020,12,ANTIOQUIA,390,1077,574,8,1,2,2052,6,142,46,69,263
CARAMANTA,2020,2,ANTIOQUIA,393,1137,573,8,1,2,2114,6,134,52,70,262
CARAMANTA,2020,3,ANTIOQUIA,393,1137,574,8,1,2,2115,6,134,52,70,262
CARAMANTA,2020,4,ANTIOQUIA,392,1138,574,8,1,2,2115,6,140,46,70,262
CARAMANTA,2020,5,ANTIOQUIA,384,1077,573,8,1,2,2045,6,139,46,69,260
CARAMANTA,2020,6,ANTIOQUIA,383,1076,573,8,1,2,2043,6,139,46,69,260
CARAMANTA,2020,7,ANTIOQUIA,383,1077,573,8,1,2,2044,6,140,47,69,262
CARAMANTA,2020,8,ANTIOQUIA,390,1074,573,8,1,2,2048,6,139,46,69,260
CARAMANTA,2020,9,ANTIOQUIA,390,1077,572,8,1,2,2050,6,141,46,69,262
CARAMANTA,2021,1,ANTIOQUIA,390,1078,573,8,1,2,2052,6,143,46,69,264
CARAMANTA,2021,10,ANTIOQUIA,393,1089,576,5,1,2,2066,6,146,46,69,267
CARAMANTA,2021,11,ANTIOQUIA,394,1096,577,5,1,2,2075,6,146,46,69,267
CARAMANTA,2021,12,ANTIOQUIA,396,1090,579,5,1,2,2073,6,146,46,69,267
CARAMANTA,2021,2,ANTIOQUIA,390,1078,575,8,1,2,2054,6,143,46,69,264
CARAMANTA,2021,3,ANTIOQUIA,390,1079,575,8,1,2,2055,6,143,46,69,264
CARAMANTA,2021,4,ANTIOQUIA,390,1084,577,7,1,2,2061,6,143,46,69,264
CARAMANTA,2021,5,ANTIOQUIA,392,1089,578,7,1,2,2069,6,143,46,69,264
CARAMANTA,2021,6,ANTIOQUIA,392,1092,578,5,1,2,2070,6,142,46,69,263
CARAMANTA,2021,7,ANTIOQUIA,392,1092,576,5,1,2,2068,6,145,46,69,266
CARAMANTA,2021,8,ANTIOQUIA,393,1093,576,5,1,2,2070,6,145,46,69,266
CARAMANTA,2021,9,ANTIOQUIA,393,1096,575,5,1,2,2072,6,146,46,69,267
CARAMANTA,2022,1,ANTIOQUIA,397,1091,579,5,1,2,2075,6,146,46,69,267
CARAMANTA,2022,10,ANTIOQUIA,396,1076,580,4,1,2,2059,6,146,47,69,268
CARAMANTA,2022,11,ANTIOQUIA,397,1076,586,4,1,2,2066,6,146,47,69,268
CARAMANTA,2022,12,ANTIOQUIA,397,1076,585,4,1,2,2065,6,146,47,69,268
CARAMANTA,2022,2,ANTIOQUIA,398,1096,579,5,1,2,2081,6,146,46,69,267
CARAMANTA,2022,3,ANTIOQUIA,400,1098,578,5,1,2,2084,6,147,46,69,268
CARAMANTA,2022,4,ANTIOQUIA,401,1099,578,5,1,2,2086,6,147,46,69,268
CARAMANTA,2022,5,ANTIOQUIA,402,1100,579,5,1,2,2089,6,147,46,69,268
CARAMANTA,2022,6,ANTIOQUIA,402,1100,581,5,1,2,2091,7,146,47,69,269
CARAMANTA,2022,7,ANTIOQUIA,402,1100,582,5,1,2,2092,7,146,47,69,269
CARAMANTA,2022,8,ANTIOQUIA,395,1075,580,4,1,2,2057,6,146,47,69,268
CARAMANTA,2022,9,ANTIOQUIA,396,1075,580,4,1,2,2058,6,146,47,69,268
CARAMANTA,2023,1,ANTIOQUIA,398,1077,585,4,1,2,2067,5,146,47,69,267
CARAMANTA,2023,2,ANTIOQUIA,398,1080,585,4,1,2,2070,5,146,47,69,267
CARAMANTA,2023,3,ANTIOQUIA,399,1083,584,4,1,2,2073,5,146,48,70,269
CARAMANTA,2023,4,ANTIOQUIA,400,1091,584,4,1,2,2082,5,146,48,70,269
CARAMANTA,2023,5,ANTIOQUIA,400,1095,584,4,1,2,2086,5,146,48,70,269
CARAMANTA,2023,6,ANTIOQUIA,400,1093,585,4,1,2,2085,5,146,48,70,269
CARAMANTA,2023,7,ANTIOQUIA,401,1094,586,4,1,2,2088,5,146,48,70,269
CARAMANTA,2023,8,ANTIOQUIA,405,1095,582,4,1,2,2089,5,145,48,70,268
CARAMANTA,2023,9,ANTIOQUIA,409,1098,581,4,1,2,2095,5,145,48,70,268
CAREPA,2018,1,ANTIOQUIA,6501,6528,1179,126,0,1,14335,146,904,96,36,1182
CAREPA,2018,10,ANTIOQUIA,6800,6784,1292,37,0,1,14914,147,923,94,37,1201
CAREPA,2018,11,ANTIOQUIA,6783,6782,1270,37,0,1,14873,149,938,94,37,1218
CAREPA,2018,12,ANTIOQUIA,6818,6813,1265,38,0,1,14935,147,948,94,36,1225
CAREPA,2018,2,ANTIOQUIA,6540,6563,1284,30,0,1,14418,146,902,96,36,1180
CAREPA,2018,3,ANTIOQUIA,6560,6579,1288,31,0,1,14459,145,904,96,36,1181
CAREPA,2018,4,ANTIOQUIA,6602,6619,1289,31,0,1,14542,147,910,96,36,1189
CAREPA,2018,5,ANTIOQUIA,6613,6621,1286,33,0,1,14554,145,905,97,36,1183
CAREPA,2018,6,ANTIOQUIA,6654,6657,1292,32,0,1,14636,145,906,95,36,1182
CAREPA,2018,7,ANTIOQUIA,6695,6706,1294,31,0,1,14727,145,911,95,36,1187
CAREPA,2018,8,ANTIOQUIA,6737,6744,1292,32,0,1,14806,146,919,95,36,1196
CAREPA,2018,9,ANTIOQUIA,6761,6765,1288,30,0,1,14845,146,916,94,36,1192
CAREPA,2019,1,ANTIOQUIA,6854,6823,1265,40,0,1,14983,147,950,94,35,1226
CAREPA,2019,10,ANTIOQUIA,7499,7639,1553,66,26,65,16848,156,990,96,35,1277
CAREPA,2019,11,ANTIOQUIA,5280,7453,2583,245,55,113,15729,156,990,96,35,1277
CAREPA,2019,12,ANTIOQUIA,5366,7568,2585,246,55,113,15933,158,1003,96,35,1292
CAREPA,2019,2,ANTIOQUIA,6883,6837,1267,40,0,1,15028,148,954,94,35,1231
CAREPA,2019,3,ANTIOQUIA,6907,6863,1256,40,0,1,15067,148,954,94,35,1231
CAREPA,2019,4,ANTIOQUIA,6954,6885,1252,40,0,1,15132,147,956,94,35,1232
CAREPA,2019,5,ANTIOQUIA,7010,6912,1252,40,0,1,15215,147,960,95,35,1237
CAREPA,2019,6,ANTIOQUIA,7032,6943,1246,39,0,1,15261,147,970,95,35,1247
CAREPA,2019,7,ANTIOQUIA,7113,6986,1243,41,0,1,15384,147,973,95,35,1250
CAREPA,2019,8,ANTIOQUIA,7173,7011,1240,41,0,1,15466,149,982,96,35,1262
CAREPA,2019,9,ANTIOQUIA,7219,7040,1240,41,0,1,15541,154,986,97,35,1272
CAREPA,2020,1,ANTIOQUIA,5355,7713,2354,260,53,113,15848,156,1004,95,35,1290
CAREPA,2020,10,ANTIOQUIA,5681,8134,2051,196,41,106,16209,167,1057,95,359,1678
CAREPA,2020,11,ANTIOQUIA,5790,8244,2016,192,38,89,16369,168,1057,95,359,1679
CAREPA,2020,12,ANTIOQUIA,5828,8264,2017,189,38,89,16425,168,1066,95,359,1688
CAREPA,2020,2,ANTIOQUIA,5372,7755,2308,277,52,110,15874,163,1015,124,359,1661
CAREPA,2020,3,ANTIOQUIA,5396,7783,2304,284,52,110,15929,163,1014,124,359,1660
CAREPA,2020,4,ANTIOQUIA,5497,7981,2101,216,52,108,15955,166,1042,95,359,1662
CAREPA,2020,5,ANTIOQUIA,5538,8004,2102,219,54,110,16027,165,1044,95,359,1663
CAREPA,2020,6,ANTIOQUIA,5537,8010,2099,218,53,110,16027,166,1042,95,358,1661
CAREPA,2020,7,ANTIOQUIA,5559,8026,2094,217,54,112,16062,167,1045,95,359,1666
CAREPA,2020,8,ANTIOQUIA,5601,8048,2086,214,52,112,16113,166,1045,95,359,1665
CAREPA,2020,9,ANTIOQUIA,5633,8092,2067,199,50,110,16151,167,1050,95,359,1671
CAREPA,2021,1,ANTIOQUIA,5887,8360,2018,187,36,84,16572,169,1068,95,359,1691
CAREPA,2021,10,ANTIOQUIA,6324,8757,1821,150,27,40,17119,169,1105,97,359,1730
CAREPA,2021,11,ANTIOQUIA,6370,8802,1808,150,27,38,17195,170,1109,97,359,1735
CAREPA,2021,12,ANTIOQUIA,6427,8889,1801,147,27,39,17330,169,1113,98,359,1739
CAREPA,2021,2,ANTIOQUIA,5914,8378,2013,177,35,82,16599,169,1070,95,359,1693
CAREPA,2021,3,ANTIOQUIA,5983,8420,2009,175,35,74,16696,171,1072,95,359,1697
CAREPA,2021,4,ANTIOQUIA,6034,8439,1993,171,32,68,16737,172,1081,95,359,1707
CAREPA,2021,5,ANTIOQUIA,6079,8508,1963,162,31,56,16799,172,1084,95,358,1709
CAREPA,2021,6,ANTIOQUIA,6116,8573,1936,159,32,52,16868,173,1085,95,359,1712
CAREPA,2021,7,ANTIOQUIA,6201,8642,1899,151,30,48,16971,170,1090,96,359,1715
CAREPA,2021,8,ANTIOQUIA,6237,8681,1862,152,28,45,17005,171,1091,97,358,1717
CAREPA,2021,9,ANTIOQUIA,6271,8709,1835,154,28,39,17036,169,1094,98,359,1720
CAREPA,2022,1,ANTIOQUIA,6475,8966,1787,146,27,38,17439,169,1118,98,359,1744
CAREPA,2022,10,ANTIOQUIA,7012,9266,1713,140,26,31,18188,159,1162,101,360,1782
CAREPA,2022,11,ANTIOQUIA,7112,9294,1703,142,26,31,18308,159,1165,101,360,1785
CAREPA,2022,12,ANTIOQUIA,7193,9382,1691,142,26,31,18465,159,1165,101,358,1783
CAREPA,2022,2,ANTIOQUIA,6526,9029,1773,145,26,38,17537,167,1121,99,359,1746
CAREPA,2022,3,ANTIOQUIA,6561,9079,1756,146,26,36,17604,160,1124,104,358,1746
CAREPA,2022,4,ANTIOQUIA,6587,9114,1750,146,26,35,17658,161,1129,102,358,1750
CAREPA,2022,5,ANTIOQUIA,6613,9142,1743,145,26,35,17704,159,1135,101,360,1755
CAREPA,2022,6,ANTIOQUIA,6645,9155,1745,140,26,35,17746,159,1141,101,360,1761
CAREPA,2022,7,ANTIOQUIA,6746,9192,1730,142,26,35,17871,159,1146,100,360,1765
CAREPA,2022,8,ANTIOQUIA,6852,9205,1723,142,26,33,17981,160,1153,101,360,1774
CAREPA,2022,9,ANTIOQUIA,6940,9244,1707,142,26,33,18092,161,1160,101,360,1782
CAREPA,2023,1,ANTIOQUIA,7257,9504,1691,139,25,31,18647,160,1167,101,358,1786
CAREPA,2023,2,ANTIOQUIA,7332,9528,1692,140,25,31,18748,162,1178,103,358,1801
CAREPA,2023,3,ANTIOQUIA,7559,9407,1692,138,25,31,18852,161,1188,103,358,1810
CAREPA,2023,4,ANTIOQUIA,7603,9445,1687,142,25,31,18933,160,1191,103,358,1812
CAREPA,2023,5,ANTIOQUIA,7644,9483,1680,144,25,31,19007,159,1190,105,358,1812
CAREPA,2023,6,ANTIOQUIA,7672,9517,1674,146,25,31,19065,159,1180,105,358,1802
CAREPA,2023,7,ANTIOQUIA,7714,9526,1673,149,24,31,19117,161,1186,107,359,1813
CAREPA,2023,8,ANTIOQUIA,7749,9523,1665,151,24,31,19143,162,1187,107,359,1815
CAREPA,2023,9,ANTIOQUIA,7766,9532,1665,147,23,30,19163,160,1193,107,359,1819
CAROLINA,2018,1,ANTIOQUIA,340,1147,90,33,12,11,1633,13,132,48,2,195
CAROLINA,2018,10,ANTIOQUIA,341,1159,89,33,12,11,1645,13,132,48,3,196
CAROLINA,2018,11,ANTIOQUIA,341,1160,90,33,12,11,1647,13,132,48,2,195
CAROLINA,2018,12,ANTIOQUIA,341,1161,90,33,12,11,1648,13,131,50,2,196
CAROLINA,2018,2,ANTIOQUIA,339,1147,90,33,12,11,1632,13,132,48,2,195
CAROLINA,2018,3,ANTIOQUIA,340,1148,90,33,12,11,1634,13,132,48,2,195
CAROLINA,2018,4,ANTIOQUIA,340,1150,90,34,12,11,1637,13,132,48,2,195
CAROLINA,2018,5,ANTIOQUIA,340,1150,90,33,12,11,1636,13,132,48,2,195
CAROLINA,2018,6,ANTIOQUIA,340,1155,89,33,12,11,1640,13,132,48,2,195
CAROLINA,2018,7,ANTIOQUIA,340,1155,89,33,12,11,1640,13,132,48,2,195
CAROLINA,2018,8,ANTIOQUIA,341,1157,89,33,12,11,1643,13,132,48,2,195
CAROLINA,2018,9,ANTIOQUIA,341,1159,89,33,12,11,1645,13,132,48,2,195
CAROLINA,2019,1,ANTIOQUIA,341,1161,90,33,12,11,1648,13,131,50,2,196
CAROLINA,2019,10,ANTIOQUIA,346,1179,92,31,12,11,1671,13,131,50,2,196
CAROLINA,2019,11,ANTIOQUIA,346,1180,92,31,12,11,1672,13,132,51,2,198
CAROLINA,2019,12,ANTIOQUIA,346,1180,91,31,12,11,1671,13,131,51,2,197
CAROLINA,2019,2,ANTIOQUIA,341,1163,90,33,12,11,1650,13,131,50,2,196
CAROLINA,2019,3,ANTIOQUIA,343,1168,90,32,12,11,1656,13,131,50,2,196
CAROLINA,2019,4,ANTIOQUIA,343,1171,90,31,12,11,1658,13,131,50,2,196
CAROLINA,2019,5,ANTIOQUIA,344,1173,90,31,12,11,1661,13,131,50,2,196
CAROLINA,2019,6,ANTIOQUIA,344,1172,90,31,12,11,1660,13,131,50,2,196
CAROLINA,2019,7,ANTIOQUIA,344,1175,90,31,12,11,1663,13,131,50,2,196
CAROLINA,2019,8,ANTIOQUIA,344,1179,91,31,12,11,1668,13,131,50,2,196
CAROLINA,2019,9,ANTIOQUIA,345,1179,91,31,12,11,1669,13,131,50,2,196
CAROLINA,2020,1,ANTIOQUIA,346,1182,91,31,12,11,1673,13,131,51,2,197
CAROLINA,2020,10,ANTIOQUIA,350,1192,91,36,13,11,1693,13,131,51,55,250
CAROLINA,2020,11,ANTIOQUIA,350,1192,91,36,13,11,1693,13,131,51,55,250
CAROLINA,2020,12,ANTIOQUIA,351,1193,92,36,12,11,1695,13,131,51,55,250
CAROLINA,2020,2,ANTIOQUIA,346,1182,91,31,12,11,1673,13,131,52,55,251
CAROLINA,2020,3,ANTIOQUIA,345,1184,91,31,12,11,1674,13,131,52,55,251
CAROLINA,2020,4,ANTIOQUIA,345,1185,91,31,12,11,1675,13,131,51,55,250
CAROLINA,2020,5,ANTIOQUIA,348,1186,91,32,12,11,1680,13,131,51,55,250
CAROLINA,2020,6,ANTIOQUIA,349,1189,91,32,12,11,1684,13,131,51,55,250
CAROLINA,2020,7,ANTIOQUIA,349,1189,91,32,12,11,1684,13,131,52,55,251
CAROLINA,2020,8,ANTIOQUIA,349,1189,91,32,12,11,1684,13,131,51,55,250
CAROLINA,2020,9,ANTIOQUIA,349,1189,91,35,12,11,1687,13,131,51,55,250
CAROLINA,2021,1,ANTIOQUIA,351,1194,93,37,12,11,1698,13,130,51,55,249
CAROLINA,2021,10,ANTIOQUIA,354,1207,93,36,12,11,1713,17,133,51,54,255
CAROLINA,2021,11,ANTIOQUIA,356,1209,94,36,12,11,1718,17,133,51,54,255
CAROLINA,2021,12,ANTIOQUIA,356,1214,93,37,12,12,1724,17,136,51,54,258
CAROLINA,2021,2,ANTIOQUIA,351,1195,93,38,12,11,1700,13,132,51,55,251
CAROLINA,2021,3,ANTIOQUIA,351,1198,93,38,12,11,1703,14,131,51,54,250
CAROLINA,2021,4,ANTIOQUIA,351,1199,94,38,12,11,1705,14,131,51,55,251
CAROLINA,2021,5,ANTIOQUIA,352,1199,94,38,12,11,1706,14,131,51,55,251
CAROLINA,2021,6,ANTIOQUIA,353,1202,93,37,12,11,1708,15,131,51,54,251
CAROLINA,2021,7,ANTIOQUIA,353,1204,93,37,12,11,1710,15,131,51,54,251
CAROLINA,2021,8,ANTIOQUIA,353,1204,93,36,12,11,1709,15,132,51,54,252
CAROLINA,2021,9,ANTIOQUIA,354,1207,93,36,12,11,1713,17,133,51,54,255
CAROLINA,2022,1,ANTIOQUIA,356,1215,93,38,12,12,1726,17,135,50,54,256
CAROLINA,2022,10,ANTIOQUIA,362,1230,93,36,11,11,1743,18,141,50,56,265
CAROLINA,2022,11,ANTIOQUIA,362,1230,93,37,11,11,1744,18,143,50,56,267
CAROLINA,2022,12,ANTIOQUIA,363,1229,93,40,11,11,1747,18,143,50,56,267
CAROLINA,2022,2,ANTIOQUIA,357,1216,93,38,12,12,1728,17,136,50,54,257
CAROLINA,2022,3,ANTIOQUIA,358,1222,92,38,12,12,1734,17,138,50,54,259
CAROLINA,2022,4,ANTIOQUIA,359,1225,93,38,12,12,1739,17,138,50,54,259
CAROLINA,2022,5,ANTIOQUIA,359,1223,93,39,12,11,1737,17,137,50,54,258
CAROLINA,2022,6,ANTIOQUIA,360,1229,93,39,12,11,1744,18,139,50,54,261
CAROLINA,2022,7,ANTIOQUIA,362,1226,91,37,11,11,1738,18,139,49,54,260
CAROLINA,2022,8,ANTIOQUIA,362,1229,93,36,11,11,1742,18,140,49,55,262
CAROLINA,2022,9,ANTIOQUIA,362,1229,93,36,11,11,1742,18,141,49,55,263
CAROLINA,2023,1,ANTIOQUIA,363,1231,94,44,11,10,1753,18,145,51,56,270
CAROLINA,2023,2,ANTIOQUIA,363,1241,94,40,10,10,1758,18,145,51,56,270
CAROLINA,2023,3,ANTIOQUIA,367,1245,94,36,10,10,1762,17,144,52,56,269
CAROLINA,2023,4,ANTIOQUIA,367,1245,94,38,10,10,1764,17,144,52,56,269
CAROLINA,2023,5,ANTIOQUIA,367,1248,94,38,10,10,1767,17,144,52,56,269
CAROLINA,2023,6,ANTIOQUIA,368,1254,94,35,10,10,1771,17,144,52,56,269
CAROLINA,2023,7,ANTIOQUIA,368,1254,94,35,10,10,1771,17,144,52,56,269
CAROLINA,2023,8,ANTIOQUIA,368,1257,94,36,10,10,1775,17,143,52,57,269
CAROLINA,2023,9,ANTIOQUIA,367,1256,94,35,10,10,1772,17,143,53,58,271
CAUCASIA,2018,1,ANTIOQUIA,12276,9871,4135,1085,77,0,27444,89,2554,167,27,2837
CAUCASIA,2018,10,ANTIOQUIA,13337,10404,4129,1028,68,0,28966,91,2682,181,27,2981
CAUCASIA,2018,11,ANTIOQUIA,13145,10382,4110,1008,67,0,28712,89,2682,180,27,2978
CAUCASIA,2018,12,ANTIOQUIA,13195,10446,4102,997,67,0,28807,88,2673,185,29,2975
CAUCASIA,2018,2,ANTIOQUIA,12282,9934,4141,1076,76,0,27509,89,2555,169,27,2840
CAUCASIA,2018,3,ANTIOQUIA,12381,9982,4161,1085,72,0,27681,90,2561,171,28,2850
CAUCASIA,2018,4,ANTIOQUIA,12475,10058,4138,1076,70,0,27817,89,2569,173,28,2859
CAUCASIA,2018,5,ANTIOQUIA,12450,10061,4123,1063,70,0,27767,89,2580,174,27,2870
CAUCASIA,2018,6,ANTIOQUIA,12703,10104,4147,1062,70,0,28086,88,2588,174,27,2877
CAUCASIA,2018,7,ANTIOQUIA,12773,10155,4162,1055,70,0,28215,89,2599,178,27,2893
CAUCASIA,2018,8,ANTIOQUIA,12860,10220,4153,1041,69,0,28343,89,2605,179,27,2900
CAUCASIA,2018,9,ANTIOQUIA,12939,10276,4134,1027,68,0,28444,89,2607,179,27,2902
CAUCASIA,2019,1,ANTIOQUIA,13222,10502,4078,994,67,0,28863,88,2687,184,29,2988
CAUCASIA,2019,10,ANTIOQUIA,13828,10934,4015,951,68,0,29796,86,2790,187,28,3091
CAUCASIA,2019,11,ANTIOQUIA,13904,10987,4015,937,68,0,29911,89,2795,186,28,3098
CAUCASIA,2019,12,ANTIOQUIA,14043,11059,4005,932,68,0,30107,89,2835,186,28,3138
CAUCASIA,2019,2,ANTIOQUIA,13291,10538,4078,991,67,0,28965,91,2701,185,29,3006
CAUCASIA,2019,3,ANTIOQUIA,13360,10585,4077,1014,67,0,29103,89,2704,184,28,3005
CAUCASIA,2019,4,ANTIOQUIA,13453,10629,4061,1002,68,0,29213,88,2708,185,28,3009
CAUCASIA,2019,5,ANTIOQUIA,13529,10669,4055,997,68,0,29318,87,2725,185,28,3025
CAUCASIA,2019,6,ANTIOQUIA,13550,10709,4052,989,68,0,29368,89,2722,187,28,3026
CAUCASIA,2019,7,ANTIOQUIA,13614,10770,4036,986,68,0,29474,87,2720,188,27,3022
CAUCASIA,2019,8,ANTIOQUIA,13673,10823,4026,968,68,0,29558,86,2768,187,29,3070
CAUCASIA,2019,9,ANTIOQUIA,13772,10871,4031,956,68,0,29698,86,2783,187,29,3085
CAUCASIA,2020,1,ANTIOQUIA,14031,11071,4001,936,68,0,30107,90,2806,192,28,3116
CAUCASIA,2020,10,ANTIOQUIA,14517,11341,4029,931,67,0,30885,93,2871,196,515,3675
CAUCASIA,2020,11,ANTIOQUIA,14625,11396,4026,934,66,0,31047,92,2875,196,515,3678
CAUCASIA,2020,12,ANTIOQUIA,14797,11431,4036,931,66,0,31261,94,2873,197,515,3679
CAUCASIA,2020,2,ANTIOQUIA,14080,11120,3989,932,75,0,30196,93,2821,215,517,3646
CAUCASIA,2020,3,ANTIOQUIA,14137,11141,3994,946,75,0,30293,94,2822,215,517,3648
CAUCASIA,2020,4,ANTIOQUIA,14154,11151,4005,909,68,0,30287,94,2846,195,517,3652
CAUCASIA,2020,5,ANTIOQUIA,14217,11176,4012,920,79,0,30404,90,2854,196,516,3656
CAUCASIA,2020,6,ANTIOQUIA,14245,11180,4019,918,68,0,30430,94,2847,196,516,3653
CAUCASIA,2020,7,ANTIOQUIA,14280,11212,4020,918,68,0,30498,93,2853,199,517,3662
CAUCASIA,2020,8,ANTIOQUIA,14362,11245,4024,920,68,0,30619,92,2851,197,516,3656
CAUCASIA,2020,9,ANTIOQUIA,14432,11289,4020,924,68,0,30733,93,2857,197,516,3663
CAUCASIA,2021,1,ANTIOQUIA,14838,11466,4057,930,66,0,31357,94,2879,199,515,3687
CAUCASIA,2021,10,ANTIOQUIA,15411,11781,4053,888,68,0,32201,94,2954,202,515,3765
CAUCASIA,2021,11,ANTIOQUIA,15471,11813,4066,878,68,0,32296,94,2971,201,515,3781
CAUCASIA,2021,12,ANTIOQUIA,15581,11848,4082,878,68,0,32457,95,2999,202,515,3811
CAUCASIA,2021,2,ANTIOQUIA,14886,11503,4062,931,66,0,31448,94,2885,199,515,3693
CAUCASIA,2021,3,ANTIOQUIA,14957,11540,4070,923,67,0,31557,91,2900,200,515,3706
CAUCASIA,2021,4,ANTIOQUIA,14997,11566,4066,919,67,0,31615,92,2908,201,513,3714
CAUCASIA,2021,5,ANTIOQUIA,15029,11594,4055,912,68,0,31658,93,2905,202,512,3712
CAUCASIA,2021,6,ANTIOQUIA,15056,11643,4053,913,68,0,31733,91,2905,201,515,3712
CAUCASIA,2021,7,ANTIOQUIA,15139,11666,4062,912,68,0,31847,92,2914,202,515,3723
CAUCASIA,2021,8,ANTIOQUIA,15271,11695,4060,896,68,0,31990,91,2930,203,514,3738
CAUCASIA,2021,9,ANTIOQUIA,15336,11734,4055,894,68,0,32087,91,2948,204,515,3758
CAUCASIA,2022,1,ANTIOQUIA,15600,11865,4093,879,68,0,32505,99,3012,203,515,3829
CAUCASIA,2022,10,ANTIOQUIA,16223,12185,4131,864,58,0,33461,96,3082,203,515,3896
CAUCASIA,2022,11,ANTIOQUIA,16278,12228,4137,856,58,0,33557,96,3099,204,516,3915
CAUCASIA,2022,12,ANTIOQUIA,16308,12256,4134,858,56,0,33612,95,3101,204,516,3916
CAUCASIA,2022,2,ANTIOQUIA,15696,11892,4106,882,68,0,32644,98,3010,201,515,3824
CAUCASIA,2022,3,ANTIOQUIA,15791,11917,4108,886,68,0,32770,96,3012,203,515,3826
CAUCASIA,2022,4,ANTIOQUIA,15834,11983,4106,883,68,0,32874,96,3029,203,515,3843
CAUCASIA,2022,5,ANTIOQUIA,15859,12034,4107,875,66,0,32941,96,3034,204,515,3849
CAUCASIA,2022,6,ANTIOQUIA,15904,12067,4125,871,58,0,33025,96,3043,205,512,3856
CAUCASIA,2022,7,ANTIOQUIA,16030,12090,4128,871,58,0,33177,95,3056,203,514,3868
CAUCASIA,2022,8,ANTIOQUIA,16109,12120,4137,864,58,0,33288,95,3059,204,514,3872
CAUCASIA,2022,9,ANTIOQUIA,16186,12152,4125,864,58,0,33385,96,3074,204,514,3888
CAUCASIA,2023,1,ANTIOQUIA,16346,12291,4138,854,56,0,33685,95,3102,204,516,3917
CAUCASIA,2023,2,ANTIOQUIA,16319,12314,4131,859,57,0,33680,94,3100,202,516,3912
CAUCASIA,2023,3,ANTIOQUIA,16357,12344,4122,857,57,0,33737,96,3104,203,516,3919
CAUCASIA,2023,4,ANTIOQUIA,16405,12374,4130,853,58,0,33820,96,3108,204,516,3924
CAUCASIA,2023,5,ANTIOQUIA,16442,12402,4129,861,58,0,33892,97,3122,204,516,3939
CAUCASIA,2023,6,ANTIOQUIA,16454,12408,4115,842,58,0,33877,95,3110,204,516,3925
CAUCASIA,2023,7,ANTIOQUIA,16456,12417,4103,848,58,0,33882,96,3115,204,517,3932
CAUCASIA,2023,8,ANTIOQUIA,16437,12471,4114,830,58,0,33910,94,3160,204,518,3976
CAUCASIA,2023,9,ANTIOQUIA,16485,12516,4103,825,58,0,33987,94,3163,205,518,3980
CHIGORODO,2018,1,ANTIOQUIA,9495,7802,789,66,5,16,18173,91,1203,99,29,1422
CHIGORODO,2018,10,ANTIOQUIA,9903,7945,796,73,5,16,18738,95,1208,98,36,1437
CHIGORODO,2018,11,ANTIOQUIA,9934,7941,797,74,5,16,18767,95,1208,98,36,1437
CHIGORODO,2018,12,ANTIOQUIA,9968,7943,798,76,5,15,18805,95,1216,98,36,1445
CHIGORODO,2018,2,ANTIOQUIA,9538,7823,790,68,5,16,18240,90,1200,99,29,1418
CHIGORODO,2018,3,ANTIOQUIA,9573,7838,793,68,5,16,18293,93,1205,100,31,1429
CHIGORODO,2018,4,ANTIOQUIA,9633,7855,795,69,5,16,18373,93,1212,100,31,1436
CHIGORODO,2018,5,ANTIOQUIA,9636,7862,794,72,5,17,18386,92,1204,100,29,1425
CHIGORODO,2018,6,ANTIOQUIA,9696,7875,794,73,5,17,18460,94,1206,100,30,1430
CHIGORODO,2018,7,ANTIOQUIA,9748,7896,795,74,5,17,18535,94,1201,100,36,1431
CHIGORODO,2018,8,ANTIOQUIA,9813,7916,799,73,5,17,18623,94,1202,100,36,1432
CHIGORODO,2018,9,ANTIOQUIA,9845,7920,796,73,5,16,18655,95,1203,98,36,1432
CHIGORODO,2019,1,ANTIOQUIA,10048,7953,799,79,5,15,18899,94,1223,98,35,1450
CHIGORODO,2019,10,ANTIOQUIA,10928,8095,800,90,5,17,19935,96,1258,101,36,1491
CHIGORODO,2019,11,ANTIOQUIA,10997,8109,801,88,5,17,20017,98,1260,101,36,1495
CHIGORODO,2019,12,ANTIOQUIA,11068,8130,806,89,5,18,20116,97,1268,101,36,1502
CHIGORODO,2019,2,ANTIOQUIA,10088,7973,799,80,5,15,18960,96,1221,98,35,1450
CHIGORODO,2019,3,ANTIOQUIA,10115,7989,795,80,5,15,18999,96,1227,98,35,1456
CHIGORODO,2019,4,ANTIOQUIA,10163,8003,796,82,5,15,19064,94,1232,98,35,1459
CHIGORODO,2019,5,ANTIOQUIA,10267,8027,795,81,5,15,19190,95,1238,99,35,1467
CHIGORODO,2019,6,ANTIOQUIA,10346,8024,796,83,5,17,19271,94,1242,99,35,1470
CHIGORODO,2019,7,ANTIOQUIA,10515,8049,797,83,5,16,19465,95,1241,99,35,1470
CHIGORODO,2019,8,ANTIOQUIA,10720,8059,797,86,5,15,19682,95,1248,101,35,1479
CHIGORODO,2019,9,ANTIOQUIA,10861,8081,797,87,5,17,19848,95,1254,101,36,1486
CHIGORODO,2020,1,ANTIOQUIA,11073,8134,814,114,5,16,20156,98,1262,102,36,1498
CHIGORODO,2020,10,ANTIOQUIA,11471,8283,818,138,6,16,20732,97,1332,102,384,1915
CHIGORODO,2020,11,ANTIOQUIA,11508,8287,818,139,6,16,20774,97,1374,102,385,1958
CHIGORODO,2020,12,ANTIOQUIA,11559,8311,815,139,6,15,20845,97,1376,100,385,1958
CHIGORODO,2020,2,ANTIOQUIA,11014,8138,816,115,5,16,20104,96,1266,133,385,1880
CHIGORODO,2020,3,ANTIOQUIA,11039,8154,813,116,5,16,20143,96,1273,133,385,1887
CHIGORODO,2020,4,ANTIOQUIA,11164,8172,814,86,5,16,20257,96,1308,102,385,1891
CHIGORODO,2020,5,ANTIOQUIA,11218,8187,815,88,5,16,20329,95,1313,103,385,1896
CHIGORODO,2020,6,ANTIOQUIA,11223,8192,813,87,5,16,20336,97,1313,103,385,1898
CHIGORODO,2020,7,ANTIOQUIA,11289,8220,814,89,5,16,20433,98,1315,102,385,1900
CHIGORODO,2020,8,ANTIOQUIA,11359,8239,815,89,5,16,20523,97,1322,102,385,1906
CHIGORODO,2020,9,ANTIOQUIA,11429,8267,816,119,5,16,20652,98,1327,102,385,1912
CHIGORODO,2021,1,ANTIOQUIA,11608,8336,814,139,6,15,20918,98,1378,100,385,1961
CHIGORODO,2021,10,ANTIOQUIA,11904,8473,800,106,5,16,21304,103,1393,97,385,1978
CHIGORODO,2021,11,ANTIOQUIA,11947,8496,798,102,5,16,21364,103,1398,97,385,1983
CHIGORODO,2021,12,ANTIOQUIA,12038,8523,801,102,5,15,21484,104,1404,96,385,1989
CHIGORODO,2021,2,ANTIOQUIA,11654,8347,814,139,6,15,20975,98,1379,100,385,1962
CHIGORODO,2021,3,ANTIOQUIA,11718,8368,814,143,6,15,21064,99,1386,100,385,1970
CHIGORODO,2021,4,ANTIOQUIA,11751,8383,815,141,6,14,21110,99,1389,100,385,1973
CHIGORODO,2021,5,ANTIOQUIA,11712,8386,812,132,6,14,21062,99,1390,100,385,1974
CHIGORODO,2021,6,ANTIOQUIA,11663,8381,808,126,6,14,20998,99,1388,99,385,1971
CHIGORODO,2021,7,ANTIOQUIA,11704,8412,806,120,5,15,21062,101,1384,99,385,1969
CHIGORODO,2021,8,ANTIOQUIA,11776,8434,807,119,5,16,21157,102,1387,99,385,1973
CHIGORODO,2021,9,ANTIOQUIA,11834,8456,804,117,5,16,21232,103,1391,98,385,1977
CHIGORODO,2022,1,ANTIOQUIA,12089,8546,801,104,5,16,21561,104,1426,96,385,2011
CHIGORODO,2022,10,ANTIOQUIA,12583,8710,804,96,4,16,22213,99,1473,99,386,2057
CHIGORODO,2022,11,ANTIOQUIA,12659,8740,803,94,4,16,22316,102,1474,99,386,2061
CHIGORODO,2022,12,ANTIOQUIA,12698,8759,804,95,4,16,22376,102,1477,99,386,2064
CHIGORODO,2022,2,ANTIOQUIA,12143,8566,801,104,5,15,21634,104,1430,97,385,2016
CHIGORODO,2022,3,ANTIOQUIA,12217,8587,802,104,5,15,21730,101,1435,98,382,2016
CHIGORODO,2022,4,ANTIOQUIA,12267,8599,803,110,5,15,21799,103,1441,98,382,2024
CHIGORODO,2022,5,ANTIOQUIA,12307,8624,801,108,5,15,21860,99,1445,98,382,2024
CHIGORODO,2022,6,ANTIOQUIA,12378,8624,801,105,4,17,21929,100,1449,98,383,2030
CHIGORODO,2022,7,ANTIOQUIA,12420,8651,802,100,4,17,21994,99,1455,98,384,2036
CHIGORODO,2022,8,ANTIOQUIA,12486,8665,801,101,4,17,22074,99,1463,98,384,2044
CHIGORODO,2022,9,ANTIOQUIA,12544,8682,802,99,4,16,22147,100,1466,99,386,2051
CHIGORODO,2023,1,ANTIOQUIA,12729,8780,811,95,4,17,22436,105,1483,99,386,2073
CHIGORODO,2023,2,ANTIOQUIA,12798,8825,810,99,4,17,22553,111,1487,100,386,2084
CHIGORODO,2023,3,ANTIOQUIA,12839,8895,810,97,4,17,22662,103,1500,100,387,2090
CHIGORODO,2023,4,ANTIOQUIA,12927,8908,812,95,4,16,22762,103,1500,100,387,2090
CHIGORODO,2023,5,ANTIOQUIA,12955,8914,817,96,4,16,22802,103,1503,100,388,2094
CHIGORODO,2023,6,ANTIOQUIA,12993,8921,815,99,4,16,22848,103,1506,100,389,2098
CHIGORODO,2023,7,ANTIOQUIA,13029,8930,815,107,4,16,22901,103,1509,100,389,2101
CHIGORODO,2023,8,ANTIOQUIA,13110,8988,815,106,4,16,23039,102,1521,100,389,2112
CHIGORODO,2023,9,ANTIOQUIA,13203,9020,812,113,4,16,23168,102,1529,101,389,2121
CISNEROS,2018,1,ANTIOQUIA,686,2552,676,19,4,0,3937,65,380,49,4,498
CISNEROS,2018,10,ANTIOQUIA,700,2601,681,19,4,0,4005,64,381,49,4,498
CISNEROS,2018,11,ANTIOQUIA,700,2602,682,19,4,0,4007,64,380,49,4,497
CISNEROS,2018,12,ANTIOQUIA,701,2601,682,19,4,0,4007,64,381,49,4,498
CISNEROS,2018,2,ANTIOQUIA,686,2559,676,19,4,0,3944,64,380,49,4,497
CISNEROS,2018,3,ANTIOQUIA,688,2568,675,19,4,0,3954,64,380,49,4,497
CISNEROS,2018,4,ANTIOQUIA,690,2571,675,19,4,0,3959,64,383,49,4,500
CISNEROS,2018,5,ANTIOQUIA,691,2579,675,19,4,0,3968,64,380,49,4,497
CISNEROS,2018,6,ANTIOQUIA,694,2584,678,19,4,0,3979,64,380,49,4,497
CISNEROS,2018,7,ANTIOQUIA,695,2587,679,19,4,0,3984,64,380,49,4,497
CISNEROS,2018,8,ANTIOQUIA,697,2587,680,19,4,0,3987,64,381,49,4,498
CISNEROS,2018,9,ANTIOQUIA,698,2592,681,19,4,0,3994,64,381,49,4,498
CISNEROS,2019,1,ANTIOQUIA,703,2608,681,19,4,0,4015,65,380,49,4,498
CISNEROS,2019,10,ANTIOQUIA,710,2651,679,18,4,0,4062,64,388,52,4,508
CISNEROS,2019,11,ANTIOQUIA,712,2655,679,18,4,0,4068,64,388,52,4,508
CISNEROS,2019,12,ANTIOQUIA,713,2657,680,18,4,0,4072,63,391,52,4,510
CISNEROS,2019,2,ANTIOQUIA,703,2615,679,19,4,0,4020,64,383,50,4,501
CISNEROS,2019,3,ANTIOQUIA,704,2614,678,19,4,0,4019,64,386,50,4,504
CISNEROS,2019,4,ANTIOQUIA,706,2623,678,19,4,0,4030,63,387,50,4,504
CISNEROS,2019,5,ANTIOQUIA,706,2632,678,19,4,0,4039,64,388,50,4,506
CISNEROS,2019,6,ANTIOQUIA,707,2633,678,19,4,0,4041,62,387,50,4,503
CISNEROS,2019,7,ANTIOQUIA,708,2636,677,19,4,0,4044,62,387,50,4,503
CISNEROS,2019,8,ANTIOQUIA,710,2640,677,19,4,0,4050,62,387,50,4,503
CISNEROS,2019,9,ANTIOQUIA,710,2648,679,19,4,0,4060,64,387,51,4,506
CISNEROS,2020,1,ANTIOQUIA,713,2659,680,21,4,0,4077,63,392,52,4,511
CISNEROS,2020,10,ANTIOQUIA,726,2700,690,18,4,0,4138,60,400,51,103,614
CISNEROS,2020,11,ANTIOQUIA,725,2705,691,18,4,0,4143,60,399,51,103,613
CISNEROS,2020,12,ANTIOQUIA,726,2718,693,18,4,0,4159,60,399,51,103,613
CISNEROS,2020,2,ANTIOQUIA,720,2669,679,23,4,0,4095,61,397,55,103,616
CISNEROS,2020,3,ANTIOQUIA,722,2676,680,26,4,0,4108,60,397,55,103,615
CISNEROS,2020,4,ANTIOQUIA,720,2677,683,21,4,0,4105,62,397,51,103,613
CISNEROS,2020,5,ANTIOQUIA,720,2682,683,22,4,0,4111,62,399,51,103,615
CISNEROS,2020,6,ANTIOQUIA,721,2683,684,22,4,0,4114,61,397,51,103,612
CISNEROS,2020,7,ANTIOQUIA,721,2693,685,21,4,0,4124,61,397,51,103,612
CISNEROS,2020,8,ANTIOQUIA,723,2697,685,20,4,0,4129,61,398,51,103,613
CISNEROS,2020,9,ANTIOQUIA,722,2697,685,19,4,0,4127,60,397,51,103,611
CISNEROS,2021,1,ANTIOQUIA,726,2719,694,18,4,0,4161,60,397,51,103,611
CISNEROS,2021,10,ANTIOQUIA,735,2764,703,23,4,0,4229,60,404,48,103,615
CISNEROS,2021,11,ANTIOQUIA,739,2770,703,23,4,0,4239,61,403,48,103,615
CISNEROS,2021,12,ANTIOQUIA,742,2774,703,24,4,0,4247,62,412,48,103,625
CISNEROS,2021,2,ANTIOQUIA,727,2728,697,18,4,0,4174,61,396,51,103,611
CISNEROS,2021,3,ANTIOQUIA,727,2735,698,18,4,0,4182,61,397,51,103,612
CISNEROS,2021,4,ANTIOQUIA,729,2742,698,18,4,0,4191,61,398,51,103,613
CISNEROS,2021,5,ANTIOQUIA,731,2746,698,18,4,0,4197,61,398,51,103,613
CISNEROS,2021,6,ANTIOQUIA,732,2749,697,18,4,0,4200,61,397,51,103,612
CISNEROS,2021,7,ANTIOQUIA,733,2751,697,23,4,0,4208,61,395,51,103,610
CISNEROS,2021,8,ANTIOQUIA,734,2757,697,24,4,0,4216,60,395,50,102,607
CISNEROS,2021,9,ANTIOQUIA,735,2760,702,26,4,0,4227,60,404,48,103,615
CISNEROS,2022,1,ANTIOQUIA,742,2778,703,24,4,0,4251,62,412,48,103,625
CISNEROS,2022,10,ANTIOQUIA,744,2839,701,33,4,0,4321,60,424,48,103,635
CISNEROS,2022,11,ANTIOQUIA,747,2850,701,33,4,0,4335,60,425,48,103,636
CISNEROS,2022,12,ANTIOQUIA,747,2853,702,33,4,0,4339,60,425,47,104,636
CISNEROS,2022,2,ANTIOQUIA,741,2781,704,24,4,0,4254,61,413,48,103,625
CISNEROS,2022,3,ANTIOQUIA,744,2790,703,25,4,0,4266,61,415,48,103,627
CISNEROS,2022,4,ANTIOQUIA,746,2802,703,25,4,0,4280,62,416,48,103,629
CISNEROS,2022,5,ANTIOQUIA,736,2815,704,25,4,0,4284,63,415,48,103,629
CISNEROS,2022,6,ANTIOQUIA,745,2817,703,25,4,0,4294,61,416,48,103,628
CISNEROS,2022,7,ANTIOQUIA,743,2815,699,31,4,0,4292,59,416,48,103,626
CISNEROS,2022,8,ANTIOQUIA,744,2827,701,31,4,0,4307,59,418,48,103,628
CISNEROS,2022,9,ANTIOQUIA,744,2832,701,32,4,0,4313,60,420,48,103,631
CISNEROS,2023,1,ANTIOQUIA,749,2866,704,32,4,0,4355,59,424,47,104,634
CISNEROS,2023,2,ANTIOQUIA,749,2872,707,33,4,0,4365,60,424,47,104,635
CISNEROS,2023,3,ANTIOQUIA,752,2886,708,33,4,0,4383,59,424,47,104,634
CISNEROS,2023,4,ANTIOQUIA,753,2893,710,33,4,0,4393,59,425,47,104,635
CISNEROS,2023,5,ANTIOQUIA,757,2902,709,32,4,0,4404,59,425,47,104,635
CISNEROS,2023,6,ANTIOQUIA,760,2908,712,30,4,0,4414,59,427,47,104,637
CISNEROS,2023,7,ANTIOQUIA,762,2919,708,33,4,0,4426,58,425,47,104,634
CISNEROS,2023,8,ANTIOQUIA,764,2933,711,32,4,0,4444,59,425,47,104,635
CISNEROS,2023,9,ANTIOQUIA,767,2949,713,32,4,0,4465,59,426,47,104,636
CIUDAD BOLIVAR,2018,1,ANTIOQUIA,1638,3911,2833,112,12,2,8508,155,862,85,11,1113
CIUDAD BOLIVAR,2018,10,ANTIOQUIA,1671,3964,2873,123,12,2,8645,158,858,85,12,1113
CIUDAD BOLIVAR,2018,11,ANTIOQUIA,1676,3970,2872,123,12,2,8655,158,854,85,11,1108
CIUDAD BOLIVAR,2018,12,ANTIOQUIA,1690,3973,2880,115,12,2,8672,158,854,85,11,1108
CIUDAD BOLIVAR,2018,2,ANTIOQUIA,1640,3913,2832,111,12,2,8510,155,858,85,11,1109
CIUDAD BOLIVAR,2018,3,ANTIOQUIA,1642,3923,2839,110,12,2,8528,157,857,85,11,1110
CIUDAD BOLIVAR,2018,4,ANTIOQUIA,1642,3935,2855,111,12,2,8557,156,858,85,11,1110
CIUDAD BOLIVAR,2018,5,ANTIOQUIA,1644,3931,2862,111,12,2,8562,156,856,85,11,1108
CIUDAD BOLIVAR,2018,6,ANTIOQUIA,1646,3944,2867,113,12,2,8584,157,856,85,11,1109
CIUDAD BOLIVAR,2018,7,ANTIOQUIA,1647,3951,2868,113,12,2,8593,156,856,85,11,1108
CIUDAD BOLIVAR,2018,8,ANTIOQUIA,1664,3953,2869,121,12,2,8621,156,857,85,11,1109
CIUDAD BOLIVAR,2018,9,ANTIOQUIA,1669,3959,2869,121,12,2,8632,157,857,85,11,1110
CIUDAD BOLIVAR,2019,1,ANTIOQUIA,1691,3978,2885,115,12,2,8683,159,852,85,11,1107
CIUDAD BOLIVAR,2019,10,ANTIOQUIA,1734,4023,3051,118,12,2,8940,161,872,86,11,1130
CIUDAD BOLIVAR,2019,11,ANTIOQUIA,1734,4026,3050,117,12,2,8941,160,878,86,11,1135
CIUDAD BOLIVAR,2019,12,ANTIOQUIA,1742,4037,3070,117,12,2,8980,160,880,86,11,1137
CIUDAD BOLIVAR,2019,2,ANTIOQUIA,1693,3986,2893,178,12,2,8764,159,853,86,11,1109
CIUDAD BOLIVAR,2019,3,ANTIOQUIA,1700,3995,2888,178,12,2,8775,159,852,86,11,1108
CIUDAD BOLIVAR,2019,4,ANTIOQUIA,1702,3998,2889,178,12,2,8781,159,852,86,11,1108
CIUDAD BOLIVAR,2019,5,ANTIOQUIA,1705,4006,2892,178,12,2,8795,159,853,86,11,1109
CIUDAD BOLIVAR,2019,6,ANTIOQUIA,1712,4005,2884,178,12,2,8793,160,865,86,11,1122
CIUDAD BOLIVAR,2019,7,ANTIOQUIA,1714,4010,2924,160,12,2,8822,160,866,86,11,1123
CIUDAD BOLIVAR,2019,8,ANTIOQUIA,1718,4011,3026,118,12,2,8887,161,867,86,11,1125
CIUDAD BOLIVAR,2019,9,ANTIOQUIA,1731,4017,3042,118,12,2,8922,161,868,86,11,1126
CIUDAD BOLIVAR,2020,1,ANTIOQUIA,1738,4034,3067,120,12,2,8973,161,877,86,11,1135
CIUDAD BOLIVAR,2020,10,ANTIOQUIA,1754,4063,3168,130,12,2,9129,161,887,86,173,1307
CIUDAD BOLIVAR,2020,11,ANTIOQUIA,1756,4062,3231,129,12,2,9192,162,887,86,173,1308
CIUDAD BOLIVAR,2020,12,ANTIOQUIA,1759,4071,3242,126,12,2,9212,163,883,86,173,1305
CIUDAD BOLIVAR,2020,2,ANTIOQUIA,1741,4032,3066,124,12,2,8977,163,883,92,173,1311
CIUDAD BOLIVAR,2020,3,ANTIOQUIA,1740,4037,3067,187,12,2,9045,163,886,92,173,1314
CIUDAD BOLIVAR,2020,4,ANTIOQUIA,1744,4044,3067,179,12,2,9048,162,894,86,173,1315
CIUDAD BOLIVAR,2020,5,ANTIOQUIA,1745,4048,3076,222,12,2,9105,162,894,86,173,1315
CIUDAD BOLIVAR,2020,6,ANTIOQUIA,1746,4045,3076,221,12,2,9102,162,896,86,173,1317
CIUDAD BOLIVAR,2020,7,ANTIOQUIA,1745,4049,3093,208,12,2,9109,163,892,86,173,1314
CIUDAD BOLIVAR,2020,8,ANTIOQUIA,1749,4050,3112,185,12,2,9110,161,890,86,173,1310
CIUDAD BOLIVAR,2020,9,ANTIOQUIA,1753,4057,3165,132,12,2,9121,162,888,86,173,1309
CIUDAD BOLIVAR,2021,1,ANTIOQUIA,1758,4075,3251,117,12,2,9215,163,886,86,173,1308
CIUDAD BOLIVAR,2021,10,ANTIOQUIA,1784,4101,3283,120,11,2,9301,170,906,87,173,1336
CIUDAD BOLIVAR,2021,11,ANTIOQUIA,1848,4105,3285,120,11,2,9371,171,908,87,173,1339
CIUDAD BOLIVAR,2021,12,ANTIOQUIA,1851,4109,3309,120,11,2,9402,172,907,87,173,1339
CIUDAD BOLIVAR,2021,2,ANTIOQUIA,1758,4077,3252,117,12,2,9218,165,889,86,173,1313
CIUDAD BOLIVAR,2021,3,ANTIOQUIA,1762,4078,3254,118,12,2,9226,166,887,86,173,1312
CIUDAD BOLIVAR,2021,4,ANTIOQUIA,1763,4081,3258,121,11,2,9236,166,888,86,173,1313
CIUDAD BOLIVAR,2021,5,ANTIOQUIA,1770,4090,3265,121,11,2,9259,169,893,86,173,1321
CIUDAD BOLIVAR,2021,6,ANTIOQUIA,1777,4088,3275,120,11,2,9273,169,894,86,173,1322
CIUDAD BOLIVAR,2021,7,ANTIOQUIA,1777,4092,3277,120,11,2,9279,170,892,86,173,1321
CIUDAD BOLIVAR,2021,8,ANTIOQUIA,1779,4094,3278,120,11,2,9284,170,891,86,173,1320
CIUDAD BOLIVAR,2021,9,ANTIOQUIA,1780,4097,3279,120,11,2,9289,170,905,87,173,1335
CIUDAD BOLIVAR,2022,1,ANTIOQUIA,1853,4113,3309,118,11,2,9406,171,909,87,173,1340
CIUDAD BOLIVAR,2022,10,ANTIOQUIA,1895,4141,3315,106,10,2,9469,178,917,89,171,1355
CIUDAD BOLIVAR,2022,11,ANTIOQUIA,1897,4145,3316,106,10,2,9476,182,917,89,171,1359
CIUDAD BOLIVAR,2022,12,ANTIOQUIA,1900,4147,3315,106,10,2,9480,186,918,89,171,1364
CIUDAD BOLIVAR,2022,2,ANTIOQUIA,1856,4116,3314,113,11,2,9412,173,908,87,173,1341
CIUDAD BOLIVAR,2022,3,ANTIOQUIA,1864,4124,3314,113,11,2,9428,173,911,89,171,1344
CIUDAD BOLIVAR,2022,4,ANTIOQUIA,1867,4134,3312,114,11,2,9440,175,910,89,171,1345
CIUDAD BOLIVAR,2022,5,ANTIOQUIA,1855,4144,3316,114,11,2,9442,175,913,89,171,1348
CIUDAD BOLIVAR,2022,6,ANTIOQUIA,1865,4141,3313,115,11,2,9447,177,912,89,171,1349
CIUDAD BOLIVAR,2022,7,ANTIOQUIA,1867,4143,3316,115,11,2,9454,178,913,89,171,1351
CIUDAD BOLIVAR,2022,8,ANTIOQUIA,1888,4127,3302,106,10,2,9435,179,915,89,171,1354
CIUDAD BOLIVAR,2022,9,ANTIOQUIA,1893,4133,3315,106,10,2,9459,179,916,89,171,1355
CIUDAD BOLIVAR,2023,1,ANTIOQUIA,1901,4152,3322,106,10,2,9493,187,918,89,171,1365
CIUDAD BOLIVAR,2023,2,ANTIOQUIA,1924,4160,3326,107,10,2,9529,186,919,89,171,1365
CIUDAD BOLIVAR,2023,3,ANTIOQUIA,1929,4171,3327,107,10,2,9546,189,918,89,171,1367
CIUDAD BOLIVAR,2023,4,ANTIOQUIA,1930,4176,3327,107,10,2,9552,191,919,90,171,1371
CIUDAD BOLIVAR,2023,5,ANTIOQUIA,1932,4182,3325,108,10,2,9559,190,918,90,171,1369
CIUDAD BOLIVAR,2023,6,ANTIOQUIA,1924,4188,3330,108,10,2,9562,189,919,90,171,1369
CIUDAD BOLIVAR,2023,7,ANTIOQUIA,1920,4175,3329,105,10,2,9541,190,917,90,176,1373
CIUDAD BOLIVAR,2023,8,ANTIOQUIA,1926,4194,3332,107,10,2,9571,188,919,90,176,1373
CIUDAD BOLIVAR,2023,9,ANTIOQUIA,1920,4186,3335,126,10,2,9579,188,928,90,176,1382
COCORNA,2018,1,ANTIOQUIA,1412,4724,1284,18,0,0,7438,35,353,104,16,508
COCORNA,2018,10,ANTIOQUIA,1433,4816,1308,17,0,0,7574,37,359,104,16,516
COCORNA,2018,11,ANTIOQUIA,1439,4820,1315,17,0,0,7591,36,361,104,16,517
COCORNA,2018,12,ANTIOQUIA,1441,4828,1311,17,0,0,7597,37,366,104,16,523
COCORNA,2018,2,ANTIOQUIA,1418,4770,1291,18,0,0,7497,35,354,104,16,509
COCORNA,2018,3,ANTIOQUIA,1419,4779,1292,18,0,0,7508,35,354,104,16,509
COCORNA,2018,4,ANTIOQUIA,1424,4794,1297,18,0,0,7533,35,354,104,16,509
COCORNA,2018,5,ANTIOQUIA,1416,4782,1298,17,0,0,7513,35,352,104,16,507
COCORNA,2018,6,ANTIOQUIA,1415,4792,1299,17,0,0,7523,36,353,104,16,509
COCORNA,2018,7,ANTIOQUIA,1429,4797,1299,17,0,0,7542,36,355,104,16,511
COCORNA,2018,8,ANTIOQUIA,1433,4805,1305,17,0,0,7560,37,356,104,16,513
COCORNA,2018,9,ANTIOQUIA,1430,4809,1306,17,0,0,7562,35,354,104,16,509
COCORNA,2019,1,ANTIOQUIA,1443,4838,1317,17,0,0,7615,37,367,104,16,524
COCORNA,2019,10,ANTIOQUIA,1607,4949,1334,20,0,0,7910,36,378,105,16,535
COCORNA,2019,11,ANTIOQUIA,1573,4930,1337,21,0,0,7861,37,378,101,16,532
COCORNA,2019,12,ANTIOQUIA,1616,4987,1341,20,0,0,7964,37,378,104,16,535
COCORNA,2019,2,ANTIOQUIA,1474,4854,1321,17,0,0,7666,37,365,104,16,522
COCORNA,2019,3,ANTIOQUIA,1490,4860,1320,17,0,0,7687,36,369,104,16,525
COCORNA,2019,4,ANTIOQUIA,1492,4868,1321,18,0,0,7699,36,370,104,16,526
COCORNA,2019,5,ANTIOQUIA,1502,4885,1326,18,0,0,7731,37,371,104,16,528
COCORNA,2019,6,ANTIOQUIA,1524,4884,1326,16,0,0,7750,36,372,104,16,528
COCORNA,2019,7,ANTIOQUIA,1530,4895,1327,16,0,0,7768,36,375,104,16,531
COCORNA,2019,8,ANTIOQUIA,1553,4908,1332,17,0,0,7810,37,376,104,16,533
COCORNA,2019,9,ANTIOQUIA,1593,4942,1334,17,0,0,7886,37,378,105,16,536
COCORNA,2020,1,ANTIOQUIA,1608,4971,1339,28,0,0,7946,37,377,105,16,535
COCORNA,2020,10,ANTIOQUIA,1665,5089,1374,26,0,0,8154,42,397,104,61,604
COCORNA,2020,11,ANTIOQUIA,1666,5098,1376,26,0,0,8166,42,398,104,62,606
COCORNA,2020,12,ANTIOQUIA,1666,5116,1376,25,0,0,8183,42,398,104,62,606
COCORNA,2020,2,ANTIOQUIA,1569,4945,1340,31,0,0,7885,42,378,113,62,595
COCORNA,2020,3,ANTIOQUIA,1572,4950,1349,31,0,0,7902,42,383,113,62,600
COCORNA,2020,4,ANTIOQUIA,1577,4959,1351,24,0,0,7911,40,395,101,62,598
COCORNA,2020,5,ANTIOQUIA,1594,4986,1359,24,1,0,7964,41,398,102,62,603
COCORNA,2020,6,ANTIOQUIA,1590,4980,1364,24,0,0,7958,42,398,102,62,604
COCORNA,2020,7,ANTIOQUIA,1632,5027,1368,24,0,0,8051,42,399,103,62,606
COCORNA,2020,8,ANTIOQUIA,1645,5050,1368,25,0,0,8088,43,399,104,62,608
COCORNA,2020,9,ANTIOQUIA,1656,5070,1368,25,0,0,8119,43,399,104,62,608
COCORNA,2021,1,ANTIOQUIA,1677,5123,1377,25,0,0,8202,41,399,104,62,606
COCORNA,2021,10,ANTIOQUIA,2327,3535,2183,296,82,10,8433,40,406,103,62,611
COCORNA,2021,11,ANTIOQUIA,2335,3550,2185,295,81,10,8456,40,408,103,62,613
COCORNA,2021,12,ANTIOQUIA,2335,3575,2185,295,81,10,8481,40,408,103,62,613
COCORNA,2021,2,ANTIOQUIA,1679,5154,1378,25,0,0,8236,41,399,104,62,606
COCORNA,2021,3,ANTIOQUIA,1685,5186,1383,25,0,0,8279,40,399,104,62,605
COCORNA,2021,4,ANTIOQUIA,1690,5193,1384,25,0,0,8292,40,399,104,62,605
COCORNA,2021,5,ANTIOQUIA,1697,5207,1387,24,0,0,8315,40,400,104,62,606
COCORNA,2021,6,ANTIOQUIA,1697,5223,1389,24,0,0,8333,41,401,104,62,608
COCORNA,2021,7,ANTIOQUIA,1703,5233,1391,27,0,0,8354,41,400,104,62,607
COCORNA,2021,8,ANTIOQUIA,1713,5238,1390,26,0,0,8367,41,405,104,62,612
COCORNA,2021,9,ANTIOQUIA,1938,4727,1620,87,27,2,8401,41,405,104,62,612
COCORNA,2022,1,ANTIOQUIA,2343,3594,2181,294,80,10,8502,41,408,103,62,614
COCORNA,2022,10,ANTIOQUIA,2133,5222,1220,85,0,0,8660,42,413,107,65,627
COCORNA,2022,11,ANTIOQUIA,2175,5234,1223,84,0,0,8716,43,416,107,65,631
COCORNA,2022,12,ANTIOQUIA,2175,5248,1225,84,0,0,8732,43,417,107,67,634
COCORNA,2022,2,ANTIOQUIA,2207,4205,1846,215,41,7,8521,42,406,103,62,613
COCORNA,2022,3,ANTIOQUIA,2118,5133,1210,84,0,0,8545,40,409,106,62,617
COCORNA,2022,4,ANTIOQUIA,2119,5156,1210,84,0,0,8569,41,410,106,62,619
COCORNA,2022,5,ANTIOQUIA,2118,5176,1216,84,0,0,8594,41,411,107,63,622
COCORNA,2022,6,ANTIOQUIA,2123,5180,1216,84,0,0,8603,41,413,107,64,625
COCORNA,2022,7,ANTIOQUIA,2126,5178,1213,84,0,0,8601,41,415,107,64,627
COCORNA,2022,8,ANTIOQUIA,2132,5185,1213,86,0,0,8616,41,413,107,64,625
COCORNA,2022,9,ANTIOQUIA,2135,5205,1218,85,0,0,8643,41,415,107,65,628
COCORNA,2023,1,ANTIOQUIA,2180,5263,1228,85,0,0,8756,45,418,107,67,637
COCORNA,2023,2,ANTIOQUIA,2181,5277,1225,85,0,0,8768,45,418,107,67,637
COCORNA,2023,3,ANTIOQUIA,2207,5317,1225,85,0,0,8834,45,418,107,67,637
COCORNA,2023,4,ANTIOQUIA,2219,5339,1227,90,0,0,8875,45,420,107,68,640
COCORNA,2023,5,ANTIOQUIA,2235,5390,1230,90,0,0,8945,45,426,107,68,646
COCORNA,2023,6,ANTIOQUIA,2255,5425,1230,90,0,0,9000,45,428,108,68,649
COCORNA,2023,7,ANTIOQUIA,2268,5455,1233,89,0,0,9045,43,429,108,68,648
COCORNA,2023,8,ANTIOQUIA,2273,5482,1235,89,0,0,9079,45,429,108,68,650
COCORNA,2023,9,ANTIOQUIA,2276,5512,1236,90,0,0,9114,45,431,109,68,653
CONCEPCION,2018,1,ANTIOQUIA,389,1256,451,10,3,1,2110,9,140,40,4,193
CONCEPCION,2018,10,ANTIOQUIA,404,1274,451,10,3,1,2143,11,142,40,4,197
CONCEPCION,2018,11,ANTIOQUIA,406,1276,450,12,3,1,2148,10,142,40,4,196
CONCEPCION,2018,12,ANTIOQUIA,406,1277,451,12,3,1,2150,10,142,40,4,196
CONCEPCION,2018,2,ANTIOQUIA,389,1257,451,10,3,1,2111,9,140,40,4,193
CONCEPCION,2018,3,ANTIOQUIA,389,1259,450,10,3,1,2112,10,140,40,4,194
CONCEPCION,2018,4,ANTIOQUIA,389,1262,450,10,3,1,2115,10,140,40,4,194
CONCEPCION,2018,5,ANTIOQUIA,400,1265,450,10,3,1,2129,10,141,40,4,195
CONCEPCION,2018,6,ANTIOQUIA,399,1264,448,10,3,1,2125,10,141,40,4,195
CONCEPCION,2018,7,ANTIOQUIA,400,1266,448,10,3,1,2128,10,142,40,4,196
CONCEPCION,2018,8,ANTIOQUIA,404,1271,453,10,3,1,2142,11,142,40,4,197
CONCEPCION,2018,9,ANTIOQUIA,403,1271,451,10,3,1,2139,10,142,40,4,196
CONCEPCION,2019,1,ANTIOQUIA,408,1287,462,13,3,1,2174,10,142,40,4,196
CONCEPCION,2019,10,ANTIOQUIA,415,1306,459,14,3,1,2198,8,144,40,4,196
CONCEPCION,2019,11,ANTIOQUIA,415,1309,460,15,3,1,2203,8,144,40,4,196
CONCEPCION,2019,12,ANTIOQUIA,419,1316,462,15,3,1,2216,8,145,40,4,197
CONCEPCION,2019,2,ANTIOQUIA,407,1281,453,14,3,1,2159,10,143,40,4,197
CONCEPCION,2019,3,ANTIOQUIA,410,1289,460,14,3,1,2177,10,143,40,4,197
CONCEPCION,2019,4,ANTIOQUIA,409,1287,450,14,3,1,2164,10,143,40,4,197
CONCEPCION,2019,5,ANTIOQUIA,411,1296,460,14,3,1,2185,10,143,40,4,197
CONCEPCION,2019,6,ANTIOQUIA,410,1297,460,14,3,1,2185,9,143,40,4,196
CONCEPCION,2019,7,ANTIOQUIA,410,1302,459,14,3,1,2189,9,144,40,4,197
CONCEPCION,2019,8,ANTIOQUIA,412,1303,459,14,3,1,2192,9,144,40,4,197
CONCEPCION,2019,9,ANTIOQUIA,413,1305,459,15,3,1,2196,8,144,40,4,196
CONCEPCION,2020,1,ANTIOQUIA,415,1310,461,17,3,1,2207,8,144,40,4,196
CONCEPCION,2020,10,ANTIOQUIA,432,1350,468,19,3,1,2273,10,146,40,32,228
CONCEPCION,2020,11,ANTIOQUIA,430,1347,469,19,3,1,2269,10,145,40,32,227
CONCEPCION,2020,12,ANTIOQUIA,431,1348,469,19,3,1,2271,10,145,40,32,227
CONCEPCION,2020,2,ANTIOQUIA,416,1315,462,21,3,1,2218,10,144,41,32,227
CONCEPCION,2020,3,ANTIOQUIA,417,1316,463,22,3,1,2222,10,144,41,32,227
CONCEPCION,2020,4,ANTIOQUIA,419,1321,462,18,3,1,2224,10,144,40,32,226
CONCEPCION,2020,5,ANTIOQUIA,427,1339,465,19,3,1,2254,10,145,40,32,227
CONCEPCION,2020,6,ANTIOQUIA,426,1335,464,19,3,1,2248,10,145,40,32,227
CONCEPCION,2020,7,ANTIOQUIA,433,1342,466,19,3,1,2264,10,146,41,32,229
CONCEPCION,2020,8,ANTIOQUIA,428,1345,465,19,3,1,2261,10,146,40,32,228
CONCEPCION,2020,9,ANTIOQUIA,429,1345,465,19,3,1,2262,10,146,40,32,228
CONCEPCION,2021,1,ANTIOQUIA,433,1347,469,19,3,1,2272,10,145,40,32,227
CONCEPCION,2021,10,ANTIOQUIA,440,1377,478,19,3,1,2318,10,150,42,32,234
CONCEPCION,2021,11,ANTIOQUIA,437,1380,480,19,3,1,2320,10,150,42,32,234
CONCEPCION,2021,12,ANTIOQUIA,437,1383,479,19,3,1,2322,10,149,42,32,233
CONCEPCION,2021,2,ANTIOQUIA,434,1353,470,19,3,1,2280,10,145,40,32,227
CONCEPCION,2021,3,ANTIOQUIA,435,1361,471,19,3,1,2290,10,145,40,32,227
CONCEPCION,2021,4,ANTIOQUIA,436,1363,469,18,3,1,2290,10,146,40,32,228
CONCEPCION,2021,5,ANTIOQUIA,437,1363,470,18,3,1,2292,10,147,40,32,229
CONCEPCION,2021,6,ANTIOQUIA,437,1368,470,18,3,1,2297,10,147,41,32,230
CONCEPCION,2021,7,ANTIOQUIA,437,1369,472,19,3,1,2301,10,149,42,32,233
CONCEPCION,2021,8,ANTIOQUIA,439,1368,474,18,3,1,2303,10,149,42,32,233
CONCEPCION,2021,9,ANTIOQUIA,440,1370,474,19,3,1,2307,10,150,42,32,234
CONCEPCION,2022,1,ANTIOQUIA,438,1382,482,20,3,1,2326,10,150,42,32,234
CONCEPCION,2022,10,ANTIOQUIA,444,1397,485,16,3,0,2345,9,154,44,32,239
CONCEPCION,2022,11,ANTIOQUIA,443,1398,486,16,3,0,2346,9,154,44,32,239
CONCEPCION,2022,12,ANTIOQUIA,444,1407,490,16,3,0,2360,10,154,44,32,240
CONCEPCION,2022,2,ANTIOQUIA,438,1386,482,17,3,1,2327,11,150,42,32,235
CONCEPCION,2022,3,ANTIOQUIA,438,1396,485,17,3,1,2340,9,151,44,32,236
CONCEPCION,2022,4,ANTIOQUIA,438,1395,489,17,3,1,2343,9,151,44,32,236
CONCEPCION,2022,5,ANTIOQUIA,440,1396,490,17,3,1,2347,9,150,44,32,235
CONCEPCION,2022,6,ANTIOQUIA,439,1397,490,17,3,1,2347,9,149,44,32,234
CONCEPCION,2022,7,ANTIOQUIA,437,1386,483,17,3,0,2326,9,150,44,32,235
CONCEPCION,2022,8,ANTIOQUIA,438,1388,489,17,3,0,2335,9,150,44,32,235
CONCEPCION,2022,9,ANTIOQUIA,442,1392,486,17,3,0,2340,9,153,44,32,238
CONCEPCION,2023,1,ANTIOQUIA,447,1413,490,16,3,0,2369,10,154,44,32,240
CONCEPCION,2023,2,ANTIOQUIA,447,1415,490,16,3,0,2371,10,153,44,32,239
CONCEPCION,2023,3,ANTIOQUIA,448,1426,487,16,3,0,2380,10,153,44,32,239
CONCEPCION,2023,4,ANTIOQUIA,449,1430,486,16,3,0,2384,9,153,44,32,238
CONCEPCION,2023,5,ANTIOQUIA,454,1443,483,16,3,0,2399,9,153,44,32,238
CONCEPCION,2023,6,ANTIOQUIA,456,1449,483,16,3,0,2407,9,153,44,32,238
CONCEPCION,2023,7,ANTIOQUIA,460,1455,482,18,3,0,2418,9,153,44,32,238
CONCEPCION,2023,8,ANTIOQUIA,464,1470,482,18,3,0,2437,9,153,44,32,238
CONCEPCION,2023,9,ANTIOQUIA,467,1475,483,18,3,0,2446,9,154,44,32,239
CONCORDIA,2018,1,ANTIOQUIA,1128,3810,1252,93,13,5,6301,157,395,79,8,639
CONCORDIA,2018,10,ANTIOQUIA,1139,3843,1271,83,13,5,6354,161,395,79,8,643
CONCORDIA,2018,11,ANTIOQUIA,1140,3848,1269,83,13,5,6358,161,395,79,8,643
CONCORDIA,2018,12,ANTIOQUIA,1142,3853,1270,83,13,5,6366,162,395,79,8,644
CONCORDIA,2018,2,ANTIOQUIA,1132,3816,1253,90,13,5,6309,158,394,79,8,639
CONCORDIA,2018,3,ANTIOQUIA,1133,3816,1257,89,13,5,6313,157,394,79,8,638
CONCORDIA,2018,4,ANTIOQUIA,1134,3820,1261,90,13,5,6323,157,394,79,8,638
CONCORDIA,2018,5,ANTIOQUIA,1131,3817,1259,90,13,5,6315,159,394,79,8,640
CONCORDIA,2018,6,ANTIOQUIA,1134,3818,1264,88,13,5,6322,160,393,79,8,640
CONCORDIA,2018,7,ANTIOQUIA,1138,3827,1268,86,13,5,6337,160,394,79,8,641
CONCORDIA,2018,8,ANTIOQUIA,1138,3831,1273,84,13,5,6344,162,395,79,8,644
CONCORDIA,2018,9,ANTIOQUIA,1138,3836,1271,83,13,5,6346,161,395,79,8,643
CONCORDIA,2019,1,ANTIOQUIA,1142,3861,1268,82,13,5,6371,161,395,79,8,643
CONCORDIA,2019,10,ANTIOQUIA,1168,3901,1260,82,12,5,6428,162,412,82,8,664
CONCORDIA,2019,11,ANTIOQUIA,1169,3907,1269,82,12,5,6444,161,413,82,8,664
CONCORDIA,2019,12,ANTIOQUIA,1170,3925,1271,82,12,5,6465,162,417,82,8,669
CONCORDIA,2019,2,ANTIOQUIA,1144,3863,1269,82,13,5,6376,161,396,79,8,644
CONCORDIA,2019,3,ANTIOQUIA,1145,3872,1265,83,13,5,6383,160,398,79,8,645
CONCORDIA,2019,4,ANTIOQUIA,1146,3872,1265,83,13,5,6384,162,397,80,8,647
CONCORDIA,2019,5,ANTIOQUIA,1149,3882,1258,83,13,5,6390,163,403,80,9,655
CONCORDIA,2019,6,ANTIOQUIA,1157,3886,1252,85,13,5,6398,162,404,80,9,655
CONCORDIA,2019,7,ANTIOQUIA,1159,3887,1254,84,13,5,6402,161,404,80,8,653
CONCORDIA,2019,8,ANTIOQUIA,1164,3889,1252,84,13,5,6407,161,406,81,8,656
CONCORDIA,2019,9,ANTIOQUIA,1164,3900,1256,83,13,5,6421,161,406,81,8,656
CONCORDIA,2020,1,ANTIOQUIA,1170,3919,1269,90,12,5,6465,162,415,82,8,667
CONCORDIA,2020,10,ANTIOQUIA,1200,3972,1294,83,12,5,6566,158,429,82,82,751
CONCORDIA,2020,11,ANTIOQUIA,1200,3967,1293,83,12,5,6560,158,436,82,82,758
CONCORDIA,2020,12,ANTIOQUIA,1199,3976,1293,82,12,5,6567,159,437,83,82,761
CONCORDIA,2020,2,ANTIOQUIA,1170,3922,1267,91,12,5,6467,163,415,88,82,748
CONCORDIA,2020,3,ANTIOQUIA,1171,3926,1267,94,12,5,6475,162,415,88,82,747
CONCORDIA,2020,4,ANTIOQUIA,1172,3932,1273,82,12,5,6476,163,421,82,82,748
CONCORDIA,2020,5,ANTIOQUIA,1187,3948,1276,82,12,5,6510,161,422,82,82,747
CONCORDIA,2020,6,ANTIOQUIA,1189,3951,1292,82,12,5,6531,162,421,82,82,747
CONCORDIA,2020,7,ANTIOQUIA,1190,3952,1294,82,12,5,6535,162,421,82,82,747
CONCORDIA,2020,8,ANTIOQUIA,1197,3962,1294,82,12,5,6552,162,423,82,82,749
CONCORDIA,2020,9,ANTIOQUIA,1199,3971,1293,84,12,5,6564,157,430,82,82,751
CONCORDIA,2021,1,ANTIOQUIA,1201,3986,1295,83,12,5,6582,158,439,83,82,762
CONCORDIA,2021,10,ANTIOQUIA,1212,4087,1329,83,11,5,6727,161,453,84,82,780
CONCORDIA,2021,11,ANTIOQUIA,1215,4093,1329,81,11,5,6734,162,455,84,82,783
CONCORDIA,2021,12,ANTIOQUIA,1217,4094,1332,81,11,5,6740,163,457,84,82,786
CONCORDIA,2021,2,ANTIOQUIA,1202,3988,1295,83,12,5,6585,160,437,83,82,762
CONCORDIA,2021,3,ANTIOQUIA,1203,3990,1297,83,12,5,6590,160,439,83,82,764
CONCORDIA,2021,4,ANTIOQUIA,1205,3994,1297,83,11,5,6595,159,443,83,82,767
CONCORDIA,2021,5,ANTIOQUIA,1205,3995,1297,84,11,5,6597,159,443,84,81,767
CONCORDIA,2021,6,ANTIOQUIA,1207,4069,1297,83,11,5,6672,159,444,84,82,769
CONCORDIA,2021,7,ANTIOQUIA,1210,4078,1297,83,11,5,6684,159,443,84,82,768
CONCORDIA,2021,8,ANTIOQUIA,1210,4081,1295,83,11,5,6685,159,443,84,82,768
CONCORDIA,2021,9,ANTIOQUIA,1209,4086,1298,83,11,5,6692,159,444,84,82,769
CONCORDIA,2022,1,ANTIOQUIA,1224,4098,1333,81,11,5,6752,164,458,84,82,788
CONCORDIA,2022,10,ANTIOQUIA,1251,4116,1335,80,11,5,6798,165,460,85,82,792
CONCORDIA,2022,11,ANTIOQUIA,1254,4119,1337,81,11,5,6807,165,458,85,82,790
CONCORDIA,2022,12,ANTIOQUIA,1258,4122,1339,81,11,5,6816,166,459,85,82,792
CONCORDIA,2022,2,ANTIOQUIA,1224,4106,1336,80,11,5,6762,165,458,84,82,789
CONCORDIA,2022,3,ANTIOQUIA,1229,4113,1336,79,11,5,6773,164,458,86,82,790
CONCORDIA,2022,4,ANTIOQUIA,1237,4126,1334,83,11,5,6796,162,463,86,82,793
CONCORDIA,2022,5,ANTIOQUIA,1232,4139,1336,82,11,5,6805,163,462,86,82,793
CONCORDIA,2022,6,ANTIOQUIA,1233,4142,1341,83,11,5,6815,163,464,86,82,795
CONCORDIA,2022,7,ANTIOQUIA,1239,4162,1345,82,11,5,6844,163,465,86,82,796
CONCORDIA,2022,8,ANTIOQUIA,1230,4117,1332,82,11,5,6777,162,463,85,82,792
CONCORDIA,2022,9,ANTIOQUIA,1247,4113,1333,80,11,5,6789,164,460,85,82,791
CONCORDIA,2023,1,ANTIOQUIA,1260,4130,1336,82,10,5,6823,166,461,85,82,794
CONCORDIA,2023,2,ANTIOQUIA,1260,4134,1339,82,9,5,6829,167,463,85,82,797
CONCORDIA,2023,3,ANTIOQUIA,1263,4151,1340,83,9,5,6851,166,463,86,83,798
CONCORDIA,2023,4,ANTIOQUIA,1272,4168,1341,82,9,5,6877,168,462,86,83,799
CONCORDIA,2023,5,ANTIOQUIA,1269,4162,1341,81,9,5,6867,167,463,86,83,799
CONCORDIA,2023,6,ANTIOQUIA,1270,4173,1371,81,9,5,6909,168,462,86,83,799
CONCORDIA,2023,7,ANTIOQUIA,1274,4183,1370,81,9,5,6922,167,462,86,83,798
CONCORDIA,2023,8,ANTIOQUIA,1276,4190,1368,81,9,5,6929,168,462,86,83,799
CONCORDIA,2023,9,ANTIOQUIA,1278,4200,1370,83,9,5,6945,167,462,86,83,798
COPACABANA,2018,1,ANTIOQUIA,1355,15498,8148,563,168,124,25856,217,1289,68,26,1600
COPACABANA,2018,10,ANTIOQUIA,1376,16034,8392,411,173,121,26507,229,1311,65,27,1632
COPACABANA,2018,11,ANTIOQUIA,1378,16066,8389,413,173,122,26541,232,1310,65,27,1634
COPACABANA,2018,12,ANTIOQUIA,1383,16091,8405,413,173,121,26586,232,1313,65,27,1637
COPACABANA,2018,2,ANTIOQUIA,1356,15718,8175,409,168,124,25950,216,1288,68,26,1598
COPACABANA,2018,3,ANTIOQUIA,1358,15764,8182,407,168,124,26003,221,1297,68,26,1612
COPACABANA,2018,4,ANTIOQUIA,1363,15819,8188,409,168,124,26071,224,1301,68,28,1621
COPACABANA,2018,5,ANTIOQUIA,1370,15833,8201,409,169,124,26106,223,1303,68,27,1621
COPACABANA,2018,6,ANTIOQUIA,1372,15855,8265,408,172,124,26196,230,1304,67,27,1628
COPACABANA,2018,7,ANTIOQUIA,1372,15906,8273,412,172,123,26258,229,1308,67,27,1631
COPACABANA,2018,8,ANTIOQUIA,1372,15980,8350,412,173,122,26409,232,1306,67,27,1632
COPACABANA,2018,9,ANTIOQUIA,1372,16010,8379,411,173,121,26466,230,1303,67,27,1627
COPACABANA,2019,1,ANTIOQUIA,1385,16133,8417,414,172,121,26642,233,1315,64,27,1639
COPACABANA,2019,10,ANTIOQUIA,1415,16477,8499,421,172,120,27104,250,1341,66,26,1683
COPACABANA,2019,11,ANTIOQUIA,1419,16521,8515,421,173,120,27169,257,1351,66,26,1700
COPACABANA,2019,12,ANTIOQUIA,1422,16567,8531,425,175,122,27242,255,1360,67,27,1709
COPACABANA,2019,2,ANTIOQUIA,1388,16156,8442,413,173,121,26693,232,1318,64,27,1641
COPACABANA,2019,3,ANTIOQUIA,1393,16186,8468,415,172,121,26755,235,1326,64,27,1652
COPACABANA,2019,4,ANTIOQUIA,1393,16245,8461,416,172,121,26808,232,1327,64,27,1650
COPACABANA,2019,5,ANTIOQUIA,1396,16263,8480,417,172,120,26848,235,1330,63,27,1655
COPACABANA,2019,6,ANTIOQUIA,1400,16292,8493,419,173,120,26897,237,1331,63,27,1658
COPACABANA,2019,7,ANTIOQUIA,1402,16320,8500,419,173,120,26934,242,1341,65,27,1675
COPACABANA,2019,8,ANTIOQUIA,1405,16362,8498,418,173,120,26976,243,1343,66,26,1678
COPACABANA,2019,9,ANTIOQUIA,1412,16424,8490,419,173,120,27038,249,1339,67,25,1680
COPACABANA,2020,1,ANTIOQUIA,1426,16558,8523,442,175,120,27244,256,1354,67,27,1704
COPACABANA,2020,10,ANTIOQUIA,1463,17535,8635,447,177,123,28380,272,1405,67,817,2561
COPACABANA,2020,11,ANTIOQUIA,1463,17559,8641,451,173,123,28410,272,1407,67,817,2563
COPACABANA,2020,12,ANTIOQUIA,1467,17597,8646,457,174,123,28464,276,1416,67,817,2576
COPACABANA,2020,2,ANTIOQUIA,1436,16583,8527,465,175,120,27306,258,1358,92,817,2525
COPACABANA,2020,3,ANTIOQUIA,1441,16599,8534,467,175,120,27336,256,1372,92,817,2537
COPACABANA,2020,4,ANTIOQUIA,1445,16638,8578,429,175,122,27387,260,1394,68,817,2539
COPACABANA,2020,5,ANTIOQUIA,1449,16707,8593,442,178,124,27493,255,1402,65,817,2539
COPACABANA,2020,6,ANTIOQUIA,1447,16769,8601,441,175,123,27556,264,1397,65,817,2543
COPACABANA,2020,7,ANTIOQUIA,1448,16937,8605,442,175,124,27731,267,1405,65,817,2554
COPACABANA,2020,8,ANTIOQUIA,1453,17129,8594,441,176,123,27916,269,1401,66,817,2553
COPACABANA,2020,9,ANTIOQUIA,1459,17461,8618,443,176,123,28280,273,1408,66,817,2564
COPACABANA,2021,1,ANTIOQUIA,1470,17569,8718,452,174,123,28506,280,1422,67,817,2586
COPACABANA,2021,10,ANTIOQUIA,1509,18058,9141,445,174,123,29450,293,1420,67,817,2597
COPACABANA,2021,11,ANTIOQUIA,1513,18092,9271,444,172,123,29615,297,1423,68,817,2605
COPACABANA,2021,12,ANTIOQUIA,1518,18310,9267,446,173,123,29837,296,1432,66,819,2613
COPACABANA,2021,2,ANTIOQUIA,1479,17491,8836,443,174,124,28547,282,1426,67,817,2592
COPACABANA,2021,3,ANTIOQUIA,1481,17557,8835,442,175,124,28614,282,1424,67,817,2590
COPACABANA,2021,4,ANTIOQUIA,1482,17641,8822,446,174,123,28688,289,1427,67,817,2600
COPACABANA,2021,5,ANTIOQUIA,1483,17660,8899,448,174,123,28787,295,1428,67,817,2607
COPACABANA,2021,6,ANTIOQUIA,1487,17694,8894,658,174,123,29030,291,1423,67,817,2598
COPACABANA,2021,7,ANTIOQUIA,1493,17789,8852,659,174,123,29090,293,1422,67,817,2599
COPACABANA,2021,8,ANTIOQUIA,1498,17839,8854,659,173,123,29146,290,1430,67,816,2603
COPACABANA,2021,9,ANTIOQUIA,1507,17929,8862,658,174,123,29253,293,1429,67,817,2606
COPACABANA,2022,1,ANTIOQUIA,1520,18351,9271,448,173,122,29885,300,1430,66,819,2615
COPACABANA,2022,10,ANTIOQUIA,1514,18941,9435,463,177,121,30651,324,1459,67,818,2668
COPACABANA,2022,11,ANTIOQUIA,1517,18993,9443,462,177,120,30712,323,1467,66,818,2674
COPACABANA,2022,12,ANTIOQUIA,1520,19029,9441,465,177,120,30752,324,1468,65,818,2675
COPACABANA,2022,2,ANTIOQUIA,1524,18421,9288,447,172,122,29974,308,1431,67,818,2624
COPACABANA,2022,3,ANTIOQUIA,1524,18560,9287,451,172,122,30116,314,1432,67,817,2630
COPACABANA,2022,4,ANTIOQUIA,1527,18603,9308,449,172,122,30181,316,1434,67,817,2634
COPACABANA,2022,5,ANTIOQUIA,1466,18719,9340,451,172,121,30269,317,1436,67,817,2637
COPACABANA,2022,6,ANTIOQUIA,1486,18753,9358,454,173,121,30345,317,1440,67,817,2641
COPACABANA,2022,7,ANTIOQUIA,1504,18793,9351,456,173,121,30398,321,1443,67,817,2648
COPACABANA,2022,8,ANTIOQUIA,1508,18842,9372,455,175,121,30473,323,1442,67,817,2649
COPACABANA,2022,9,ANTIOQUIA,1509,18868,9408,460,177,121,30543,327,1453,67,817,2664
COPACABANA,2023,1,ANTIOQUIA,1521,19071,9451,472,177,120,30812,326,1471,65,818,2680
COPACABANA,2023,2,ANTIOQUIA,1523,19119,9460,467,177,120,30866,324,1471,65,817,2677
COPACABANA,2023,3,ANTIOQUIA,1524,19183,9469,464,177,120,30937,330,1470,65,817,2682
COPACABANA,2023,4,ANTIOQUIA,1525,19227,9486,470,178,120,31006,329,1479,65,817,2690
COPACABANA,2023,5,ANTIOQUIA,1530,19281,9499,470,178,120,31078,334,1479,66,817,2696
COPACABANA,2023,6,ANTIOQUIA,1532,19286,9494,474,177,120,31083,333,1472,66,817,2688
COPACABANA,2023,7,ANTIOQUIA,1537,19319,9490,476,180,120,31122,338,1474,66,817,2695
COPACABANA,2023,8,ANTIOQUIA,1538,19366,9505,476,180,120,31185,339,1480,67,817,2703
COPACABANA,2023,9,ANTIOQUIA,1539,19411,9508,478,182,121,31239,344,1476,67,817,2704
DABEIBA,2018,1,ANTIOQUIA,3086,2142,1028,15,0,0,6271,19,353,130,9,511
DABEIBA,2018,10,ANTIOQUIA,3186,2204,1045,12,0,0,6447,21,353,130,9,513
DABEIBA,2018,11,ANTIOQUIA,3194,2210,1049,12,0,0,6465,21,352,130,9,512
DABEIBA,2018,12,ANTIOQUIA,3199,2213,1051,12,0,0,6475,22,354,130,9,515
DABEIBA,2018,2,ANTIOQUIA,3095,2151,1029,15,0,0,6290,20,350,130,9,509
DABEIBA,2018,3,ANTIOQUIA,3124,2157,1028,15,0,0,6324,20,351,130,9,510
DABEIBA,2018,4,ANTIOQUIA,3158,2167,1029,13,0,0,6367,20,351,130,9,510
DABEIBA,2018,5,ANTIOQUIA,3129,2167,1028,13,0,0,6337,20,350,130,9,509
DABEIBA,2018,6,ANTIOQUIA,3140,2171,1028,13,0,0,6352,20,350,130,9,509
DABEIBA,2018,7,ANTIOQUIA,3153,2179,1036,13,0,0,6381,20,351,130,9,510
DABEIBA,2018,8,ANTIOQUIA,3162,2184,1035,13,0,0,6394,20,353,130,9,512
DABEIBA,2018,9,ANTIOQUIA,3165,2196,1044,13,0,0,6418,21,353,130,9,513
DABEIBA,2019,1,ANTIOQUIA,3205,2228,1053,11,0,0,6497,22,356,132,9,519
DABEIBA,2019,10,ANTIOQUIA,3339,2309,1064,12,0,0,6724,22,368,133,9,532
DABEIBA,2019,11,ANTIOQUIA,3348,2314,1064,12,0,0,6738,22,370,133,9,534
DABEIBA,2019,12,ANTIOQUIA,3359,2324,1064,13,0,0,6760,21,372,133,9,535
DABEIBA,2019,2,ANTIOQUIA,3211,2233,1054,11,0,0,6509,22,359,132,9,522
DABEIBA,2019,3,ANTIOQUIA,3246,2238,1055,12,0,0,6551,21,358,132,9,520
DABEIBA,2019,4,ANTIOQUIA,3258,2252,1055,12,0,0,6577,21,358,132,9,520
DABEIBA,2019,5,ANTIOQUIA,3283,2266,1062,12,0,0,6623,22,359,132,9,522
DABEIBA,2019,6,ANTIOQUIA,3301,2272,1062,11,0,0,6646,21,363,132,9,525
DABEIBA,2019,7,ANTIOQUIA,3308,2287,1058,11,0,0,6664,21,364,133,9,527
DABEIBA,2019,8,ANTIOQUIA,3323,2296,1062,10,0,0,6691,21,363,133,9,526
DABEIBA,2019,9,ANTIOQUIA,3336,2302,1063,10,0,0,6711,21,369,133,9,532
DABEIBA,2020,1,ANTIOQUIA,3362,2325,1059,21,0,0,6767,21,372,133,9,535
DABEIBA,2020,10,ANTIOQUIA,3456,2388,1077,17,0,0,6938,23,383,133,92,631
DABEIBA,2020,11,ANTIOQUIA,3461,2390,1078,16,0,0,6945,23,383,133,93,632
DABEIBA,2020,12,ANTIOQUIA,3472,2402,1073,19,0,0,6966,25,390,133,93,641
DABEIBA,2020,2,ANTIOQUIA,3368,2333,1058,28,0,0,6787,21,374,140,93,628
DABEIBA,2020,3,ANTIOQUIA,3382,2343,1059,32,0,0,6816,21,375,140,93,629
DABEIBA,2020,4,ANTIOQUIA,3393,2347,1057,17,0,0,6814,21,382,133,93,629
DABEIBA,2020,5,ANTIOQUIA,3402,2351,1057,17,0,0,6827,21,383,133,93,630
DABEIBA,2020,6,ANTIOQUIA,3417,2355,1059,19,0,0,6850,21,382,133,93,629
DABEIBA,2020,7,ANTIOQUIA,3432,2369,1062,18,0,0,6881,23,383,134,93,633
DABEIBA,2020,8,ANTIOQUIA,3436,2374,1074,18,0,0,6902,23,383,133,93,632
DABEIBA,2020,9,ANTIOQUIA,3448,2383,1076,17,0,0,6924,23,382,133,93,631
DABEIBA,2021,1,ANTIOQUIA,3478,2412,1070,19,0,0,6979,25,391,133,93,642
DABEIBA,2021,10,ANTIOQUIA,3576,2510,1084,14,0,0,7184,28,402,132,93,655
DABEIBA,2021,11,ANTIOQUIA,3587,2517,1083,15,0,0,7202,28,403,133,93,657
DABEIBA,2021,12,ANTIOQUIA,3598,2526,1083,15,0,0,7222,28,403,132,93,656
DABEIBA,2021,2,ANTIOQUIA,3492,2421,1068,20,0,0,7001,25,392,133,93,643
DABEIBA,2021,3,ANTIOQUIA,3503,2427,1073,21,0,0,7024,25,391,133,93,642
DABEIBA,2021,4,ANTIOQUIA,3516,2446,1079,22,0,0,7063,25,394,133,93,645
DABEIBA,2021,5,ANTIOQUIA,3530,2459,1079,21,0,0,7089,26,401,133,93,653
DABEIBA,2021,6,ANTIOQUIA,3538,2463,1077,20,0,0,7098,26,402,133,93,654
DABEIBA,2021,7,ANTIOQUIA,3549,2483,1078,19,0,0,7129,26,401,133,93,653
DABEIBA,2021,8,ANTIOQUIA,3561,2489,1079,18,0,0,7147,26,399,133,93,651
DABEIBA,2021,9,ANTIOQUIA,3569,2501,1081,13,0,0,7164,26,401,133,93,653
DABEIBA,2022,1,ANTIOQUIA,3603,2537,1084,16,0,0,7240,28,403,132,93,656
DABEIBA,2022,10,ANTIOQUIA,3684,2653,1110,10,0,0,7457,26,413,132,93,664
DABEIBA,2022,11,ANTIOQUIA,3699,2662,1109,10,0,0,7480,26,414,132,93,665
DABEIBA,2022,12,ANTIOQUIA,3704,2666,1109,11,0,0,7490,26,414,132,93,665
DABEIBA,2022,2,ANTIOQUIA,3612,2542,1093,16,0,0,7263,28,403,132,93,656
DABEIBA,2022,3,ANTIOQUIA,3621,2569,1090,16,0,0,7296,27,402,133,93,655
DABEIBA,2022,4,ANTIOQUIA,3635,2579,1089,14,0,0,7317,27,402,133,93,655
DABEIBA,2022,5,ANTIOQUIA,3626,2598,1097,13,0,0,7334,27,402,133,93,655
DABEIBA,2022,6,ANTIOQUIA,3641,2605,1096,12,0,0,7354,27,405,133,93,658
DABEIBA,2022,7,ANTIOQUIA,3644,2612,1095,12,0,0,7363,27,406,132,93,658
DABEIBA,2022,8,ANTIOQUIA,3658,2628,1101,11,0,0,7398,26,406,132,93,657
DABEIBA,2022,9,ANTIOQUIA,3673,2644,1104,11,0,0,7432,26,413,132,93,664
DABEIBA,2023,1,ANTIOQUIA,3714,2679,1111,11,0,0,7515,26,413,132,93,664
DABEIBA,2023,2,ANTIOQUIA,3723,2684,1112,12,0,0,7531,27,413,131,94,665
DABEIBA,2023,3,ANTIOQUIA,3753,2691,1111,16,0,0,7571,25,412,132,94,663
DABEIBA,2023,4,ANTIOQUIA,3775,2701,1112,14,0,0,7602,23,413,131,94,661
DABEIBA,2023,5,ANTIOQUIA,3785,2704,1110,15,0,0,7614,25,412,132,95,664
DABEIBA,2023,6,ANTIOQUIA,3813,2721,1110,11,0,0,7655,23,413,131,95,662
DABEIBA,2023,7,ANTIOQUIA,3824,2716,1113,11,0,0,7664,27,413,131,95,666
DABEIBA,2023,8,ANTIOQUIA,3835,2718,1117,11,0,0,7681,22,414,131,95,662
DABEIBA,2023,9,ANTIOQUIA,3859,2729,1119,11,0,0,7718,24,414,132,95,665
DONMATIAS,2018,1,ANTIOQUIA,367,4706,2080,189,2,2,7346,319,870,102,6,1297
DONMATIAS,2018,10,ANTIOQUIA,561,4444,2350,327,44,2,7728,334,938,104,7,1383
DONMATIAS,2018,11,ANTIOQUIA,650,3829,2506,494,83,4,7566,337,905,103,6,1351
DONMATIAS,2018,12,ANTIOQUIA,652,3831,2555,491,83,4,7616,337,922,103,6,1368
DONMATIAS,2018,2,ANTIOQUIA,368,4714,2123,191,2,2,7400,318,875,102,6,1301
DONMATIAS,2018,3,ANTIOQUIA,368,4749,2127,195,2,2,7443,318,877,102,6,1303
DONMATIAS,2018,4,ANTIOQUIA,368,4776,2128,198,2,2,7474,318,880,102,6,1306
DONMATIAS,2018,5,ANTIOQUIA,367,4773,2133,202,2,2,7479,321,881,102,6,1310
DONMATIAS,2018,6,ANTIOQUIA,376,4781,2132,203,2,2,7496,325,883,102,6,1316
DONMATIAS,2018,7,ANTIOQUIA,378,4783,2128,202,2,2,7495,328,895,102,6,1331
DONMATIAS,2018,8,ANTIOQUIA,379,4795,2128,202,2,2,7508,331,902,103,6,1342
DONMATIAS,2018,9,ANTIOQUIA,380,4801,2141,202,2,2,7528,331,901,103,6,1341
DONMATIAS,2019,1,ANTIOQUIA,652,3837,2578,492,88,3,7650,337,924,104,6,1371
DONMATIAS,2019,10,ANTIOQUIA,696,3932,2676,487,82,3,7876,355,938,107,7,1407
DONMATIAS,2019,11,ANTIOQUIA,697,3938,2687,495,79,2,7898,356,941,107,7,1411
DONMATIAS,2019,12,ANTIOQUIA,701,3943,2691,492,76,2,7905,359,944,107,7,1417
DONMATIAS,2019,2,ANTIOQUIA,655,3839,2576,492,89,3,7654,339,923,105,6,1373
DONMATIAS,2019,3,ANTIOQUIA,666,3854,2569,490,89,3,7671,339,924,105,6,1374
DONMATIAS,2019,4,ANTIOQUIA,668,3860,2655,487,88,3,7761,340,924,105,6,1375
DONMATIAS,2019,5,ANTIOQUIA,681,3887,2663,490,86,3,7810,341,927,105,6,1379
DONMATIAS,2019,6,ANTIOQUIA,688,3900,2650,485,84,3,7810,343,928,106,6,1383
DONMATIAS,2019,7,ANTIOQUIA,689,3910,2657,481,84,3,7824,344,928,106,6,1384
DONMATIAS,2019,8,ANTIOQUIA,694,3913,2672,488,84,3,7854,347,940,108,7,1402
DONMATIAS,2019,9,ANTIOQUIA,695,3926,2673,487,83,3,7867,353,941,109,6,1409
DONMATIAS,2020,1,ANTIOQUIA,703,3944,2690,500,75,2,7914,370,945,107,7,1429
DONMATIAS,2020,10,ANTIOQUIA,713,4146,2781,529,76,1,8246,397,981,108,222,1708
DONMATIAS,2020,11,ANTIOQUIA,713,4175,2809,529,76,1,8303,401,984,108,223,1716
DONMATIAS,2020,12,ANTIOQUIA,713,4181,2807,532,76,1,8310,411,986,109,223,1729
DONMATIAS,2020,2,ANTIOQUIA,704,3954,2725,514,75,2,7974,376,953,110,222,1661
DONMATIAS,2020,3,ANTIOQUIA,704,3958,2726,543,75,2,8008,377,956,110,222,1665
DONMATIAS,2020,4,ANTIOQUIA,707,3967,2745,516,74,1,8010,379,961,108,222,1670
DONMATIAS,2020,5,ANTIOQUIA,707,3971,2768,523,75,1,8045,390,972,108,222,1692
DONMATIAS,2020,6,ANTIOQUIA,708,3974,2778,519,76,1,8056,388,964,108,222,1682
DONMATIAS,2020,7,ANTIOQUIA,708,3977,2781,527,76,1,8070,392,966,108,222,1688
DONMATIAS,2020,8,ANTIOQUIA,711,4051,2780,526,76,1,8145,393,974,108,223,1698
DONMATIAS,2020,9,ANTIOQUIA,712,4076,2780,528,76,1,8173,395,978,108,223,1704
DONMATIAS,2021,1,ANTIOQUIA,718,4189,2817,550,76,1,8351,410,985,109,222,1726
DONMATIAS,2021,10,ANTIOQUIA,731,4278,2988,554,75,1,8627,430,1025,108,222,1785
DONMATIAS,2021,11,ANTIOQUIA,735,4296,3024,563,75,1,8694,431,1025,108,221,1785
DONMATIAS,2021,12,ANTIOQUIA,736,4303,3023,563,74,1,8700,436,1028,108,221,1793
DONMATIAS,2021,2,ANTIOQUIA,720,4194,2819,550,76,1,8360,411,987,109,222,1729
DONMATIAS,2021,3,ANTIOQUIA,720,4205,2846,554,76,1,8402,411,992,109,222,1734
DONMATIAS,2021,4,ANTIOQUIA,720,4211,2850,556,75,1,8413,410,993,109,221,1733
DONMATIAS,2021,5,ANTIOQUIA,720,4214,2869,558,75,1,8437,411,999,109,220,1739
DONMATIAS,2021,6,ANTIOQUIA,721,4214,2872,557,75,1,8440,417,1001,109,221,1748
DONMATIAS,2021,7,ANTIOQUIA,722,4242,2876,557,76,1,8474,419,1002,109,221,1751
DONMATIAS,2021,8,ANTIOQUIA,723,4253,2877,557,75,1,8486,424,1003,109,219,1755
DONMATIAS,2021,9,ANTIOQUIA,728,4263,2896,556,75,1,8519,428,1015,109,221,1773
DONMATIAS,2022,1,ANTIOQUIA,740,4345,3025,566,76,1,8753,443,1027,108,221,1799
DONMATIAS,2022,10,ANTIOQUIA,830,3591,3304,1113,73,0,8911,467,1035,107,219,1828
DONMATIAS,2022,11,ANTIOQUIA,829,3638,3298,1130,73,0,8968,470,1036,107,217,1830
DONMATIAS,2022,12,ANTIOQUIA,829,3648,3290,1125,73,0,8965,476,1035,107,217,1835
DONMATIAS,2022,2,ANTIOQUIA,743,4348,3026,566,76,1,8760,444,1027,109,220,1800
DONMATIAS,2022,3,ANTIOQUIA,754,4344,3039,570,75,1,8783,449,1031,109,220,1809
DONMATIAS,2022,4,ANTIOQUIA,828,3487,3312,1113,75,1,8816,452,1037,109,220,1818
DONMATIAS,2022,5,ANTIOQUIA,825,3492,3319,1115,75,1,8827,454,1035,109,220,1818
DONMATIAS,2022,6,ANTIOQUIA,827,3501,3320,1128,75,1,8852,456,1036,109,220,1821
DONMATIAS,2022,7,ANTIOQUIA,826,3482,3353,1134,70,0,8865,456,1033,107,220,1816
DONMATIAS,2022,8,ANTIOQUIA,829,3528,3317,1132,73,0,8879,457,1036,107,220,1820
DONMATIAS,2022,9,ANTIOQUIA,830,3572,3301,1121,73,0,8897,462,1036,107,221,1826
DONMATIAS,2023,1,ANTIOQUIA,830,3661,3289,1127,70,0,8977,473,1034,107,217,1831
DONMATIAS,2023,2,ANTIOQUIA,831,3664,3300,1119,70,0,8984,473,1033,108,217,1831
DONMATIAS,2023,3,ANTIOQUIA,833,3683,3296,1138,70,0,9020,477,1030,108,217,1832
DONMATIAS,2023,4,ANTIOQUIA,836,3694,3296,1149,70,0,9045,479,1032,108,217,1836
DONMATIAS,2023,5,ANTIOQUIA,835,3692,3297,1151,70,0,9045,483,1031,108,217,1839
DONMATIAS,2023,6,ANTIOQUIA,834,3695,3295,1156,70,0,9050,484,1030,110,217,1841
DONMATIAS,2023,7,ANTIOQUIA,829,3691,3290,1158,69,0,9037,490,1028,110,222,1850
DONMATIAS,2023,8,ANTIOQUIA,833,3710,3282,1159,69,0,9053,491,1033,111,222,1857
DONMATIAS,2023,9,ANTIOQUIA,830,3716,3277,1163,68,0,9054,495,1034,111,222,1862
EBEJICO,2018,1,ANTIOQUIA,3177,1415,427,24,4,21,5068,34,249,67,10,360
EBEJICO,2018,10,ANTIOQUIA,3202,1440,428,24,3,19,5116,33,252,67,10,362
EBEJICO,2018,11,ANTIOQUIA,3206,1437,428,25,3,20,5119,33,252,67,10,362
EBEJICO,2018,12,ANTIOQUIA,3248,1454,428,30,3,19,5182,33,252,67,10,362
EBEJICO,2018,2,ANTIOQUIA,3176,1415,425,24,3,21,5064,34,252,67,10,363
EBEJICO,2018,3,ANTIOQUIA,3179,1413,425,24,3,21,5065,34,253,67,10,364
EBEJICO,2018,4,ANTIOQUIA,3187,1414,425,24,3,21,5074,34,253,67,10,364
EBEJICO,2018,5,ANTIOQUIA,3174,1415,428,24,3,20,5064,33,253,67,10,363
EBEJICO,2018,6,ANTIOQUIA,3180,1422,428,24,3,20,5077,33,253,67,10,363
EBEJICO,2018,7,ANTIOQUIA,3187,1429,427,24,3,20,5090,33,253,67,10,363
EBEJICO,2018,8,ANTIOQUIA,3194,1431,427,24,3,20,5099,33,252,67,10,362
EBEJICO,2018,9,ANTIOQUIA,3195,1434,427,24,3,19,5102,33,251,67,10,361
EBEJICO,2019,1,ANTIOQUIA,3257,1456,428,32,3,19,5195,33,251,67,10,361
EBEJICO,2019,10,ANTIOQUIA,3386,1481,431,32,3,17,5350,40,250,67,10,367
EBEJICO,2019,11,ANTIOQUIA,3386,1482,432,33,3,17,5353,40,249,67,10,366
EBEJICO,2019,12,ANTIOQUIA,3394,1483,432,33,3,17,5362,40,249,67,10,366
EBEJICO,2019,2,ANTIOQUIA,3259,1457,428,32,3,19,5198,33,251,67,10,361
EBEJICO,2019,3,ANTIOQUIA,3262,1457,427,32,3,19,5200,33,252,67,10,362
EBEJICO,2019,4,ANTIOQUIA,3363,1470,429,32,3,19,5316,33,253,67,10,363
EBEJICO,2019,5,ANTIOQUIA,3373,1475,431,32,3,19,5333,33,253,67,10,363
EBEJICO,2019,6,ANTIOQUIA,3375,1479,428,31,3,19,5335,36,253,67,10,366
EBEJICO,2019,7,ANTIOQUIA,3379,1481,429,30,3,17,5339,40,251,67,10,368
EBEJICO,2019,8,ANTIOQUIA,3382,1481,429,32,3,17,5344,40,250,67,10,367
EBEJICO,2019,9,ANTIOQUIA,3383,1480,431,31,3,17,5345,40,250,67,10,367
EBEJICO,2020,1,ANTIOQUIA,3389,1484,432,33,3,17,5358,40,249,67,10,366
EBEJICO,2020,10,ANTIOQUIA,3460,1504,442,34,3,18,5461,41,254,68,78,441
EBEJICO,2020,11,ANTIOQUIA,3461,1506,443,35,3,18,5466,41,253,68,78,440
EBEJICO,2020,12,ANTIOQUIA,3473,1513,443,35,3,18,5485,41,254,68,78,441
EBEJICO,2020,2,ANTIOQUIA,3391,1485,432,34,3,17,5362,41,249,75,78,443
EBEJICO,2020,3,ANTIOQUIA,3397,1487,434,34,3,17,5372,41,249,76,78,444
EBEJICO,2020,4,ANTIOQUIA,3398,1488,435,31,3,18,5373,41,257,68,78,444
EBEJICO,2020,5,ANTIOQUIA,3402,1489,436,32,3,18,5380,41,257,68,78,444
EBEJICO,2020,6,ANTIOQUIA,3409,1489,435,32,3,18,5386,41,257,68,78,444
EBEJICO,2020,7,ANTIOQUIA,3412,1492,437,34,3,18,5396,41,257,68,78,444
EBEJICO,2020,8,ANTIOQUIA,3419,1493,436,34,3,18,5403,41,255,68,78,442
EBEJICO,2020,9,ANTIOQUIA,3430,1496,442,34,3,18,5423,41,257,68,78,444
EBEJICO,2021,1,ANTIOQUIA,3487,1523,443,34,3,18,5508,41,253,68,78,440
EBEJICO,2021,10,ANTIOQUIA,3529,1569,449,36,3,17,5603,41,257,68,78,444
EBEJICO,2021,11,ANTIOQUIA,3532,1571,447,36,3,18,5607,41,260,68,78,447
EBEJICO,2021,12,ANTIOQUIA,3536,1575,446,35,3,17,5612,41,260,68,78,447
EBEJICO,2021,2,ANTIOQUIA,3493,1527,443,34,3,18,5518,41,254,68,78,441
EBEJICO,2021,3,ANTIOQUIA,3494,1531,442,35,3,18,5523,41,253,68,78,440
EBEJICO,2021,4,ANTIOQUIA,3504,1539,442,36,3,18,5542,41,253,68,78,440
EBEJICO,2021,5,ANTIOQUIA,3508,1542,441,36,3,20,5550,41,254,68,77,440
EBEJICO,2021,6,ANTIOQUIA,3510,1546,441,36,3,19,5555,41,253,68,78,440
EBEJICO,2021,7,ANTIOQUIA,3514,1552,442,38,3,19,5568,41,254,68,78,441
EBEJICO,2021,8,ANTIOQUIA,3517,1553,445,38,3,20,5576,41,255,68,78,442
EBEJICO,2021,9,ANTIOQUIA,3522,1560,445,38,3,19,5587,41,258,68,78,445
EBEJICO,2022,1,ANTIOQUIA,3545,1583,444,35,3,17,5627,41,260,68,78,447
EBEJICO,2022,10,ANTIOQUIA,3543,1639,443,33,3,16,5677,40,265,69,81,455
EBEJICO,2022,11,ANTIOQUIA,3561,1643,443,31,3,16,5697,41,265,69,81,456
EBEJICO,2022,12,ANTIOQUIA,3567,1649,444,31,3,16,5710,41,265,69,81,456
EBEJICO,2022,2,ANTIOQUIA,3548,1585,444,35,3,17,5632,41,260,68,78,447
EBEJICO,2022,3,ANTIOQUIA,3558,1597,443,35,3,17,5653,40,260,69,78,447
EBEJICO,2022,4,ANTIOQUIA,3558,1609,444,34,3,16,5664,40,261,69,78,448
EBEJICO,2022,5,ANTIOQUIA,3561,1616,446,34,3,16,5676,40,262,69,78,449
EBEJICO,2022,6,ANTIOQUIA,3566,1623,447,34,3,16,5689,40,262,69,78,449
EBEJICO,2022,7,ANTIOQUIA,3524,1614,445,35,3,16,5637,40,262,69,78,449
EBEJICO,2022,8,ANTIOQUIA,3529,1621,443,35,3,16,5647,40,263,69,79,451
EBEJICO,2022,9,ANTIOQUIA,3537,1625,445,33,3,16,5659,40,263,69,81,453
EBEJICO,2023,1,ANTIOQUIA,3570,1653,445,32,3,16,5719,41,265,69,81,456
EBEJICO,2023,2,ANTIOQUIA,3581,1654,442,31,3,16,5727,41,265,69,81,456
EBEJICO,2023,3,ANTIOQUIA,3601,1659,443,31,3,16,5753,41,265,69,81,456
EBEJICO,2023,4,ANTIOQUIA,3611,1662,444,31,3,16,5767,40,266,69,81,456
EBEJICO,2023,5,ANTIOQUIA,3616,1667,444,33,3,15,5778,40,266,69,81,456
EBEJICO,2023,6,ANTIOQUIA,3633,1673,444,32,3,15,5800,42,266,69,81,458
EBEJICO,2023,7,ANTIOQUIA,3649,1677,444,33,3,17,5823,40,265,69,81,455
EBEJICO,2023,8,ANTIOQUIA,3668,1689,443,33,3,17,5853,41,264,69,81,455
EBEJICO,2023,9,ANTIOQUIA,3668,1689,444,32,2,17,5852,41,263,69,81,454
EL BAGRE,2018,1,ANTIOQUIA,10785,3542,402,52,0,0,14781,23,866,96,25,1010
EL BAGRE,2018,10,ANTIOQUIA,11127,3621,395,59,0,0,15202,23,916,98,26,1063
EL BAGRE,2018,11,ANTIOQUIA,11200,3617,394,59,0,0,15270,24,918,98,25,1065
EL BAGRE,2018,12,ANTIOQUIA,11266,3617,394,62,0,0,15339,24,916,100,25,1065
EL BAGRE,2018,2,ANTIOQUIA,10944,3559,401,53,0,0,14957,22,852,98,25,997
EL BAGRE,2018,3,ANTIOQUIA,11048,3614,401,55,0,0,15118,22,861,98,25,1006
EL BAGRE,2018,4,ANTIOQUIA,11161,3635,402,55,0,0,15253,22,863,98,25,1008
EL BAGRE,2018,5,ANTIOQUIA,10985,3622,396,55,0,0,15058,22,855,98,25,1000
EL BAGRE,2018,6,ANTIOQUIA,11033,3624,395,55,0,0,15107,22,867,98,25,1012
EL BAGRE,2018,7,ANTIOQUIA,11147,3618,394,55,0,0,15214,22,910,98,25,1055
EL BAGRE,2018,8,ANTIOQUIA,11206,3626,394,56,0,0,15282,23,916,98,25,1062
EL BAGRE,2018,9,ANTIOQUIA,11059,3611,394,57,0,0,15121,23,908,98,25,1054
EL BAGRE,2019,1,ANTIOQUIA,11292,3617,393,62,0,0,15364,24,917,100,26,1067
EL BAGRE,2019,10,ANTIOQUIA,11974,3643,390,59,0,0,16066,24,948,103,25,1100
EL BAGRE,2019,11,ANTIOQUIA,11990,3643,388,59,0,0,16080,24,947,103,26,1100
EL BAGRE,2019,12,ANTIOQUIA,12107,3654,392,61,0,0,16214,25,954,103,25,1107
EL BAGRE,2019,2,ANTIOQUIA,11420,3606,391,65,0,0,15482,24,913,100,26,1063
EL BAGRE,2019,3,ANTIOQUIA,11512,3607,391,65,0,0,15575,24,913,100,25,1062
EL BAGRE,2019,4,ANTIOQUIA,11558,3607,388,63,0,0,15616,23,916,100,25,1064
EL BAGRE,2019,5,ANTIOQUIA,11703,3621,390,62,0,0,15776,25,917,100,25,1067
EL BAGRE,2019,6,ANTIOQUIA,11688,3628,391,60,0,0,15767,25,914,100,25,1064
EL BAGRE,2019,7,ANTIOQUIA,11826,3635,393,64,0,0,15918,25,915,103,25,1068
EL BAGRE,2019,8,ANTIOQUIA,11876,3638,392,60,0,0,15966,25,935,104,25,1089
EL BAGRE,2019,9,ANTIOQUIA,11919,3631,393,59,0,0,16002,24,937,104,26,1091
EL BAGRE,2020,1,ANTIOQUIA,12081,3647,389,57,0,0,16174,24,952,103,25,1104
EL BAGRE,2020,10,ANTIOQUIA,12403,3685,383,52,0,0,16523,26,1001,106,302,1435
EL BAGRE,2020,11,ANTIOQUIA,12468,3688,383,52,0,0,16591,26,1007,107,303,1443
EL BAGRE,2020,12,ANTIOQUIA,12553,3688,383,54,0,0,16678,26,1012,106,303,1447
EL BAGRE,2020,2,ANTIOQUIA,12053,3657,391,57,0,0,16158,25,952,127,303,1407
EL BAGRE,2020,3,ANTIOQUIA,12082,3660,390,57,0,0,16189,25,954,127,303,1409
EL BAGRE,2020,4,ANTIOQUIA,12157,3661,386,52,0,0,16256,25,984,104,303,1416
EL BAGRE,2020,5,ANTIOQUIA,12271,3676,386,52,0,0,16385,26,987,103,303,1419
EL BAGRE,2020,6,ANTIOQUIA,12286,3684,387,53,0,0,16410,25,984,106,303,1418
EL BAGRE,2020,7,ANTIOQUIA,12315,3691,385,52,0,0,16443,25,990,105,303,1423
EL BAGRE,2020,8,ANTIOQUIA,12349,3687,385,53,0,0,16474,25,986,106,303,1420
EL BAGRE,2020,9,ANTIOQUIA,12368,3681,383,52,0,0,16484,26,999,106,303,1434
EL BAGRE,2021,1,ANTIOQUIA,12625,3693,383,54,0,0,16755,26,1015,105,302,1448
EL BAGRE,2021,10,ANTIOQUIA,12923,3727,376,63,0,0,17089,28,1047,103,302,1480
EL BAGRE,2021,11,ANTIOQUIA,13013,3724,377,63,0,0,17177,28,1055,103,302,1488
EL BAGRE,2021,12,ANTIOQUIA,13144,3739,379,64,0,0,17326,28,1061,102,302,1493
EL BAGRE,2021,2,ANTIOQUIA,12660,3699,381,54,0,0,16794,26,1017,105,302,1450
EL BAGRE,2021,3,ANTIOQUIA,12733,3709,381,57,0,0,16880,26,1022,105,302,1455
EL BAGRE,2021,4,ANTIOQUIA,12755,3715,380,56,0,0,16906,26,1022,106,301,1455
EL BAGRE,2021,5,ANTIOQUIA,12765,3721,375,58,0,0,16919,27,1028,104,302,1461
EL BAGRE,2021,6,ANTIOQUIA,12811,3714,376,58,0,0,16959,27,1029,104,302,1462
EL BAGRE,2021,7,ANTIOQUIA,12803,3713,380,60,0,0,16956,27,1025,104,302,1458
EL BAGRE,2021,8,ANTIOQUIA,12820,3723,381,60,0,0,16984,28,1032,104,300,1464
EL BAGRE,2021,9,ANTIOQUIA,12824,3725,378,59,0,0,16986,28,1046,104,302,1480
EL BAGRE,2022,1,ANTIOQUIA,13154,3740,379,65,0,0,17338,28,1059,102,302,1491
EL BAGRE,2022,10,ANTIOQUIA,13483,3751,378,69,0,0,17681,26,1081,109,303,1519
EL BAGRE,2022,11,ANTIOQUIA,13507,3756,378,70,0,0,17711,26,1084,110,303,1523
EL BAGRE,2022,12,ANTIOQUIA,13532,3757,378,69,0,0,17736,26,1085,110,303,1524
EL BAGRE,2022,2,ANTIOQUIA,13204,3745,379,65,0,0,17393,28,1061,102,302,1493
EL BAGRE,2022,3,ANTIOQUIA,13251,3750,380,64,0,0,17445,26,1067,107,302,1502
EL BAGRE,2022,4,ANTIOQUIA,13285,3748,380,66,0,0,17479,27,1073,107,302,1509
EL BAGRE,2022,5,ANTIOQUIA,13277,3743,379,67,0,0,17466,27,1074,107,302,1510
EL BAGRE,2022,6,ANTIOQUIA,13310,3738,378,68,0,0,17494,27,1074,108,302,1511
EL BAGRE,2022,7,ANTIOQUIA,13358,3736,378,69,0,0,17541,27,1077,108,302,1514
EL BAGRE,2022,8,ANTIOQUIA,13419,3738,378,67,0,0,17602,27,1081,108,303,1519
EL BAGRE,2022,9,ANTIOQUIA,13448,3749,378,70,0,0,17645,26,1076,108,303,1513
EL BAGRE,2023,1,ANTIOQUIA,13553,3763,381,75,0,0,17772,28,1086,109,303,1526
EL BAGRE,2023,2,ANTIOQUIA,13580,3769,381,76,0,0,17806,28,1090,109,303,1530
EL BAGRE,2023,3,ANTIOQUIA,13592,3767,381,76,0,0,17816,27,1089,109,303,1528
EL BAGRE,2023,4,ANTIOQUIA,13627,3768,379,80,0,0,17854,27,1090,109,303,1529
EL BAGRE,2023,5,ANTIOQUIA,13683,3765,379,88,0,0,17915,27,1092,109,303,1531
EL BAGRE,2023,6,ANTIOQUIA,13595,3749,378,87,0,0,17809,29,1085,110,303,1527
EL BAGRE,2023,7,ANTIOQUIA,13654,3750,374,84,0,0,17862,27,1115,109,304,1555
EL BAGRE,2023,8,ANTIOQUIA,13654,3765,374,80,0,0,17873,28,1162,109,304,1603
EL BAGRE,2023,9,ANTIOQUIA,13634,3764,373,98,0,0,17869,27,1154,109,304,1594
EL CARMEN DE VIBORAL,2018,1,ANTIOQUIA,843,7614,8042,291,93,35,16918,176,1284,90,19,1569
EL CARMEN DE VIBORAL,2018,10,ANTIOQUIA,939,7984,8422,313,104,40,17802,187,1339,92,22,1640
EL CARMEN DE VIBORAL,2018,11,ANTIOQUIA,942,8014,8435,313,105,40,17849,182,1343,92,20,1637
EL CARMEN DE VIBORAL,2018,12,ANTIOQUIA,962,8099,8482,315,105,42,18005,181,1345,92,20,1638
EL CARMEN DE VIBORAL,2018,2,ANTIOQUIA,864,7725,8149,293,93,35,17159,176,1296,91,20,1583
EL CARMEN DE VIBORAL,2018,3,ANTIOQUIA,867,7751,8187,295,93,35,17228,176,1300,91,20,1587
EL CARMEN DE VIBORAL,2018,4,ANTIOQUIA,870,7764,8229,296,100,35,17294,176,1304,91,20,1591
EL CARMEN DE VIBORAL,2018,5,ANTIOQUIA,852,7733,8235,300,101,36,17257,177,1315,92,19,1603
EL CARMEN DE VIBORAL,2018,6,ANTIOQUIA,872,7844,8280,303,101,36,17436,176,1326,91,20,1613
EL CARMEN DE VIBORAL,2018,7,ANTIOQUIA,872,7907,8300,306,101,40,17526,179,1326,91,20,1616
EL CARMEN DE VIBORAL,2018,8,ANTIOQUIA,880,7945,8326,308,101,40,17600,179,1330,91,20,1620
EL CARMEN DE VIBORAL,2018,9,ANTIOQUIA,881,7950,8353,308,103,40,17635,183,1332,91,20,1626
EL CARMEN DE VIBORAL,2019,1,ANTIOQUIA,988,8235,8600,322,108,42,18295,184,1366,94,20,1664
EL CARMEN DE VIBORAL,2019,10,ANTIOQUIA,1157,8608,8908,348,114,43,19178,191,1430,94,20,1735
EL CARMEN DE VIBORAL,2019,11,ANTIOQUIA,1161,8639,8931,348,115,43,19237,194,1432,94,20,1740
EL CARMEN DE VIBORAL,2019,12,ANTIOQUIA,1096,8547,8869,350,116,43,19021,191,1417,92,20,1720
EL CARMEN DE VIBORAL,2019,2,ANTIOQUIA,982,8272,8633,322,109,41,18359,189,1364,92,20,1665
EL CARMEN DE VIBORAL,2019,3,ANTIOQUIA,1015,8341,8687,326,110,41,18520,190,1386,94,20,1690
EL CARMEN DE VIBORAL,2019,4,ANTIOQUIA,1021,8318,8694,327,110,41,18511,188,1381,92,20,1681
EL CARMEN DE VIBORAL,2019,5,ANTIOQUIA,1055,8382,8729,330,110,41,18647,191,1400,94,20,1705
EL CARMEN DE VIBORAL,2019,6,ANTIOQUIA,1043,8358,8738,333,112,41,18625,187,1395,92,20,1694
EL CARMEN DE VIBORAL,2019,7,ANTIOQUIA,1060,8430,8777,335,113,41,18756,189,1410,94,20,1713
EL CARMEN DE VIBORAL,2019,8,ANTIOQUIA,1055,8413,8780,342,112,41,18743,187,1403,92,20,1702
EL CARMEN DE VIBORAL,2019,9,ANTIOQUIA,1094,8479,8821,341,114,41,18890,191,1415,95,19,1720
EL CARMEN DE VIBORAL,2020,1,ANTIOQUIA,1168,8677,8948,388,116,43,19340,190,1442,94,20,1746
EL CARMEN DE VIBORAL,2020,10,ANTIOQUIA,1202,8978,9175,396,118,49,19918,197,1483,94,520,2294
EL CARMEN DE VIBORAL,2020,11,ANTIOQUIA,1205,9011,9328,396,118,49,20107,195,1497,95,520,2307
EL CARMEN DE VIBORAL,2020,12,ANTIOQUIA,1206,9059,9349,399,118,49,20180,199,1499,95,520,2313
EL CARMEN DE VIBORAL,2020,2,ANTIOQUIA,1093,8487,8820,412,116,48,18976,195,1416,106,521,2238
EL CARMEN DE VIBORAL,2020,3,ANTIOQUIA,1093,8503,8845,442,116,48,19047,193,1428,106,520,2247
EL CARMEN DE VIBORAL,2020,4,ANTIOQUIA,1093,8540,8880,384,116,48,19061,193,1440,92,521,2246
EL CARMEN DE VIBORAL,2020,5,ANTIOQUIA,1124,8631,8981,390,116,48,19290,192,1451,92,521,2256
EL CARMEN DE VIBORAL,2020,6,ANTIOQUIA,1124,8677,8999,391,117,48,19356,197,1453,92,521,2263
EL CARMEN DE VIBORAL,2020,7,ANTIOQUIA,1186,8843,9106,393,118,48,19694,198,1481,94,521,2294
EL CARMEN DE VIBORAL,2020,8,ANTIOQUIA,1193,8881,9138,390,116,49,19767,198,1483,94,521,2296
EL CARMEN DE VIBORAL,2020,9,ANTIOQUIA,1194,8914,9159,392,118,49,19826,198,1485,94,521,2298
EL CARMEN DE VIBORAL,2021,1,ANTIOQUIA,1209,9117,9360,401,118,49,20254,203,1504,95,520,2322
EL CARMEN DE VIBORAL,2021,10,ANTIOQUIA,1236,9468,9844,536,125,53,21262,218,1576,99,520,2413
EL CARMEN DE VIBORAL,2021,11,ANTIOQUIA,1241,9496,9904,516,127,53,21337,219,1581,99,520,2419
EL CARMEN DE VIBORAL,2021,12,ANTIOQUIA,1243,9528,9926,510,128,54,21389,221,1588,99,520,2428
EL CARMEN DE VIBORAL,2021,2,ANTIOQUIA,1210,9171,9415,405,118,49,20368,205,1511,96,519,2331
EL CARMEN DE VIBORAL,2021,3,ANTIOQUIA,1213,9223,9457,407,119,49,20468,206,1514,96,519,2335
EL CARMEN DE VIBORAL,2021,4,ANTIOQUIA,1215,9261,9496,434,120,50,20576,209,1517,96,519,2341
EL CARMEN DE VIBORAL,2021,5,ANTIOQUIA,1224,9287,9676,438,119,50,20794,213,1551,96,520,2380
EL CARMEN DE VIBORAL,2021,6,ANTIOQUIA,1228,9318,9682,443,120,50,20841,214,1554,96,520,2384
EL CARMEN DE VIBORAL,2021,7,ANTIOQUIA,1233,9334,9697,544,120,50,20978,212,1562,98,520,2392
EL CARMEN DE VIBORAL,2021,8,ANTIOQUIA,1233,9368,9732,544,121,50,21048,214,1566,98,521,2399
EL CARMEN DE VIBORAL,2021,9,ANTIOQUIA,1237,9418,9778,548,123,51,21155,216,1566,99,521,2402
EL CARMEN DE VIBORAL,2022,1,ANTIOQUIA,1244,9559,9979,492,128,55,21457,226,1597,101,520,2444
EL CARMEN DE VIBORAL,2022,10,ANTIOQUIA,1258,9918,10470,518,138,60,22362,241,1645,107,519,2512
EL CARMEN DE VIBORAL,2022,11,ANTIOQUIA,1262,9978,10531,519,139,61,22490,249,1657,108,520,2534
EL CARMEN DE VIBORAL,2022,12,ANTIOQUIA,1263,10022,10552,522,139,62,22560,255,1660,108,520,2543
EL CARMEN DE VIBORAL,2022,2,ANTIOQUIA,1244,9582,10033,465,130,56,21510,225,1604,102,520,2451
EL CARMEN DE VIBORAL,2022,3,ANTIOQUIA,1247,9643,10072,467,130,58,21617,228,1607,106,518,2459
EL CARMEN DE VIBORAL,2022,4,ANTIOQUIA,1242,9685,10156,467,130,58,21738,229,1612,106,519,2466
EL CARMEN DE VIBORAL,2022,5,ANTIOQUIA,1247,9743,10213,475,130,59,21867,231,1621,105,519,2476
EL CARMEN DE VIBORAL,2022,6,ANTIOQUIA,1248,9773,10257,479,130,59,21946,234,1628,105,519,2486
EL CARMEN DE VIBORAL,2022,7,ANTIOQUIA,1254,9805,10283,480,135,59,22016,239,1632,104,519,2494
EL CARMEN DE VIBORAL,2022,8,ANTIOQUIA,1256,9852,10315,508,135,59,22125,237,1637,107,519,2500
EL CARMEN DE VIBORAL,2022,9,ANTIOQUIA,1257,9873,10423,514,137,59,22263,240,1641,107,519,2507
EL CARMEN DE VIBORAL,2023,1,ANTIOQUIA,1271,10079,10614,528,140,63,22695,258,1664,108,520,2550
EL CARMEN DE VIBORAL,2023,2,ANTIOQUIA,1272,10173,10633,531,140,62,22811,265,1668,108,521,2562
EL CARMEN DE VIBORAL,2023,3,ANTIOQUIA,1278,10250,10715,534,142,63,22982,270,1672,108,521,2571
EL CARMEN DE VIBORAL,2023,4,ANTIOQUIA,1280,10313,10739,535,142,65,23074,271,1679,108,522,2580
EL CARMEN DE VIBORAL,2023,5,ANTIOQUIA,1288,10406,10772,534,144,64,23208,280,1691,108,524,2603
EL CARMEN DE VIBORAL,2023,6,ANTIOQUIA,1290,10460,10803,537,144,65,23299,280,1697,109,526,2612
EL CARMEN DE VIBORAL,2023,7,ANTIOQUIA,1298,10509,10831,539,145,64,23386,286,1701,110,525,2622
EL CARMEN DE VIBORAL,2023,8,ANTIOQUIA,1303,10527,10841,538,145,64,23418,278,1703,110,526,2617
EL CARMEN DE VIBORAL,2023,9,ANTIOQUIA,1314,10602,10875,539,146,64,23540,277,1712,111,527,2627
EL SANTUARIO,2018,1,ANTIOQUIA,1289,7382,3260,121,39,1,12092,117,1048,79,17,1261
EL SANTUARIO,2018,10,ANTIOQUIA,1312,7511,3259,127,35,1,12245,130,1069,79,18,1296
EL SANTUARIO,2018,11,ANTIOQUIA,1310,7529,3262,127,34,1,12263,126,1069,80,18,1293
EL SANTUARIO,2018,12,ANTIOQUIA,1312,7545,3259,130,34,1,12281,125,1073,80,18,1296
EL SANTUARIO,2018,2,ANTIOQUIA,1291,7412,3259,122,39,1,12124,118,1049,79,17,1263
EL SANTUARIO,2018,3,ANTIOQUIA,1295,7442,3265,124,39,1,12166,118,1052,79,17,1266
EL SANTUARIO,2018,4,ANTIOQUIA,1299,7457,3264,124,38,1,12183,118,1052,79,17,1266
EL SANTUARIO,2018,5,ANTIOQUIA,1295,7457,3262,124,37,1,12176,117,1062,79,18,1276
EL SANTUARIO,2018,6,ANTIOQUIA,1300,7466,3260,124,37,1,12188,117,1067,79,18,1281
EL SANTUARIO,2018,7,ANTIOQUIA,1300,7486,3263,123,37,1,12210,118,1066,79,18,1281
EL SANTUARIO,2018,8,ANTIOQUIA,1307,7486,3264,124,36,1,12218,121,1068,79,18,1286
EL SANTUARIO,2018,9,ANTIOQUIA,1304,7502,3263,126,36,1,12232,127,1071,79,18,1295
EL SANTUARIO,2019,1,ANTIOQUIA,1310,7552,3262,130,34,1,12289,130,1072,80,18,1300
EL SANTUARIO,2019,10,ANTIOQUIA,1353,7717,3285,129,30,1,12515,137,1103,82,18,1340
EL SANTUARIO,2019,11,ANTIOQUIA,1366,7731,3287,128,30,1,12543,138,1104,82,18,1342
EL SANTUARIO,2019,12,ANTIOQUIA,1367,7744,3285,131,30,1,12558,138,1105,83,18,1344
EL SANTUARIO,2019,2,ANTIOQUIA,1314,7578,3261,130,34,1,12318,132,1073,80,18,1303
EL SANTUARIO,2019,3,ANTIOQUIA,1315,7592,3263,129,34,1,12334,134,1073,80,18,1305
EL SANTUARIO,2019,4,ANTIOQUIA,1319,7600,3263,129,34,1,12346,134,1073,80,18,1305
EL SANTUARIO,2019,5,ANTIOQUIA,1321,7628,3276,131,35,1,12392,134,1077,80,18,1309
EL SANTUARIO,2019,6,ANTIOQUIA,1328,7635,3272,132,34,1,12402,133,1077,80,18,1308
EL SANTUARIO,2019,7,ANTIOQUIA,1328,7676,3277,134,34,1,12450,131,1092,80,18,1321
EL SANTUARIO,2019,8,ANTIOQUIA,1336,7692,3277,132,34,1,12472,135,1092,80,18,1325
EL SANTUARIO,2019,9,ANTIOQUIA,1345,7705,3286,131,31,1,12499,135,1105,82,18,1340
EL SANTUARIO,2020,1,ANTIOQUIA,1368,7831,3292,151,29,1,12672,137,1107,83,18,1345
EL SANTUARIO,2020,10,ANTIOQUIA,1408,8009,3308,184,31,1,12941,139,1154,83,217,1593
EL SANTUARIO,2020,11,ANTIOQUIA,1407,8022,3311,183,31,1,12955,138,1152,83,217,1590
EL SANTUARIO,2020,12,ANTIOQUIA,1410,8053,3308,184,31,1,12987,138,1157,83,218,1596
EL SANTUARIO,2020,2,ANTIOQUIA,1373,7862,3287,174,30,1,12727,138,1117,92,217,1564
EL SANTUARIO,2020,3,ANTIOQUIA,1373,7901,3288,176,30,1,12769,139,1120,92,216,1567
EL SANTUARIO,2020,4,ANTIOQUIA,1377,7925,3286,160,30,1,12779,138,1132,83,217,1570
EL SANTUARIO,2020,5,ANTIOQUIA,1377,7958,3298,191,31,1,12856,141,1140,83,217,1581
EL SANTUARIO,2020,6,ANTIOQUIA,1378,7948,3293,192,30,1,12842,139,1141,83,217,1580
EL SANTUARIO,2020,7,ANTIOQUIA,1375,7964,3299,192,32,1,12863,140,1143,83,217,1583
EL SANTUARIO,2020,8,ANTIOQUIA,1387,7975,3303,190,32,1,12888,139,1145,83,217,1584
EL SANTUARIO,2020,9,ANTIOQUIA,1404,8001,3313,183,32,1,12934,140,1148,83,217,1588
EL SANTUARIO,2021,1,ANTIOQUIA,1405,8073,3305,184,31,1,12999,138,1157,83,218,1596
EL SANTUARIO,2021,10,ANTIOQUIA,1445,8297,3327,181,29,1,13280,143,1192,83,218,1636
EL SANTUARIO,2021,11,ANTIOQUIA,1447,8321,3334,181,29,1,13313,143,1188,83,218,1632
EL SANTUARIO,2021,12,ANTIOQUIA,1454,8333,3343,181,34,1,13346,144,1191,83,218,1636
EL SANTUARIO,2021,2,ANTIOQUIA,1415,8087,3311,185,30,1,13029,138,1158,83,218,1597
EL SANTUARIO,2021,3,ANTIOQUIA,1415,8127,3309,184,30,1,13066,139,1166,83,218,1606
EL SANTUARIO,2021,4,ANTIOQUIA,1422,8141,3306,184,30,1,13084,139,1166,83,218,1606
EL SANTUARIO,2021,5,ANTIOQUIA,1421,8163,3311,192,30,1,13118,140,1172,83,218,1613
EL SANTUARIO,2021,6,ANTIOQUIA,1426,8180,3313,189,30,1,13139,140,1175,83,217,1615
EL SANTUARIO,2021,7,ANTIOQUIA,1427,8195,3312,188,29,1,13152,141,1183,83,217,1624
EL SANTUARIO,2021,8,ANTIOQUIA,1439,8225,3324,180,29,1,13198,141,1191,83,217,1632
EL SANTUARIO,2021,9,ANTIOQUIA,1439,8272,3324,181,29,1,13246,142,1192,83,218,1635
EL SANTUARIO,2022,1,ANTIOQUIA,1452,8348,3361,179,34,1,13375,146,1196,83,218,1643
EL SANTUARIO,2022,10,ANTIOQUIA,1474,8698,3552,187,28,1,13940,148,1256,84,220,1708
EL SANTUARIO,2022,11,ANTIOQUIA,1482,8722,3560,185,28,1,13978,147,1264,84,220,1715
EL SANTUARIO,2022,12,ANTIOQUIA,1484,8747,3563,184,28,1,14007,149,1263,84,220,1716
EL SANTUARIO,2022,2,ANTIOQUIA,1461,8373,3373,179,34,1,13421,146,1199,82,218,1645
EL SANTUARIO,2022,3,ANTIOQUIA,1466,8402,3414,181,33,1,13497,142,1209,84,217,1652
EL SANTUARIO,2022,4,ANTIOQUIA,1477,8418,3435,181,29,1,13541,142,1215,84,217,1658
EL SANTUARIO,2022,5,ANTIOQUIA,1454,8471,3456,181,29,1,13592,144,1220,84,217,1665
EL SANTUARIO,2022,6,ANTIOQUIA,1459,8480,3494,181,29,1,13644,144,1232,84,217,1677
EL SANTUARIO,2022,7,ANTIOQUIA,1459,8495,3484,185,28,1,13652,150,1231,84,218,1683
EL SANTUARIO,2022,8,ANTIOQUIA,1468,8555,3488,185,28,1,13725,148,1234,84,219,1685
EL SANTUARIO,2022,9,ANTIOQUIA,1471,8593,3500,183,28,1,13776,149,1233,84,220,1686
EL SANTUARIO,2023,1,ANTIOQUIA,1493,8793,3575,186,28,1,14076,150,1271,84,220,1725
EL SANTUARIO,2023,2,ANTIOQUIA,1497,8858,3580,189,28,1,14153,151,1279,84,220,1734
EL SANTUARIO,2023,3,ANTIOQUIA,1510,8926,3581,189,28,1,14235,153,1290,84,220,1747
EL SANTUARIO,2023,4,ANTIOQUIA,1513,8960,3589,188,28,1,14279,154,1293,84,220,1751
EL SANTUARIO,2023,5,ANTIOQUIA,1512,8989,3593,189,28,1,14312,160,1294,84,220,1758
EL SANTUARIO,2023,6,ANTIOQUIA,1519,9037,3605,187,28,1,14377,157,1301,84,220,1762
EL SANTUARIO,2023,7,ANTIOQUIA,1524,9076,3611,188,28,1,14428,159,1309,84,220,1772
EL SANTUARIO,2023,8,ANTIOQUIA,1528,9096,3608,187,28,1,14448,160,1310,84,220,1774
EL SANTUARIO,2023,9,ANTIOQUIA,1565,9183,3619,189,28,1,14585,160,1319,84,220,1783
ENTRERRIOS,2018,1,ANTIOQUIA,180,1188,1784,391,16,8,3567,252,652,42,3,949
ENTRERRIOS,2018,10,ANTIOQUIA,284,626,1860,571,148,130,3619,272,660,42,3,977
ENTRERRIOS,2018,11,ANTIOQUIA,284,632,1859,575,149,131,3630,272,663,42,3,980
ENTRERRIOS,2018,12,ANTIOQUIA,285,633,1860,575,149,131,3633,274,662,42,3,981
ENTRERRIOS,2018,2,ANTIOQUIA,273,618,1827,569,154,133,3574,257,651,42,3,953
ENTRERRIOS,2018,3,ANTIOQUIA,276,619,1829,568,155,133,3580,257,649,42,3,951
ENTRERRIOS,2018,4,ANTIOQUIA,281,621,1837,569,152,133,3593,261,649,42,3,955
ENTRERRIOS,2018,5,ANTIOQUIA,281,619,1844,572,149,130,3595,259,651,42,3,955
ENTRERRIOS,2018,6,ANTIOQUIA,282,619,1850,571,149,130,3601,260,656,42,3,961
ENTRERRIOS,2018,7,ANTIOQUIA,283,625,1847,568,148,130,3601,266,663,42,3,974
ENTRERRIOS,2018,8,ANTIOQUIA,283,625,1854,569,148,130,3609,272,660,42,3,977
ENTRERRIOS,2018,9,ANTIOQUIA,282,625,1859,569,148,129,3612,272,659,42,3,976
ENTRERRIOS,2019,1,ANTIOQUIA,289,633,1869,584,149,131,3655,275,663,42,3,983
ENTRERRIOS,2019,10,ANTIOQUIA,291,662,1896,596,147,128,3720,301,670,45,3,1019
ENTRERRIOS,2019,11,ANTIOQUIA,293,663,1901,609,140,128,3734,304,675,45,3,1027
ENTRERRIOS,2019,12,ANTIOQUIA,293,663,1906,610,141,128,3741,307,673,45,3,1028
ENTRERRIOS,2019,2,ANTIOQUIA,289,633,1874,585,148,130,3659,279,662,42,3,986
ENTRERRIOS,2019,3,ANTIOQUIA,288,634,1878,586,148,130,3664,280,664,43,3,990
ENTRERRIOS,2019,4,ANTIOQUIA,289,633,1882,586,148,130,3668,280,665,43,3,991
ENTRERRIOS,2019,5,ANTIOQUIA,291,635,1887,594,147,129,3683,284,668,43,3,998
ENTRERRIOS,2019,6,ANTIOQUIA,291,635,1888,594,147,129,3684,288,667,43,3,1001
ENTRERRIOS,2019,7,ANTIOQUIA,291,648,1888,594,147,128,3696,290,672,43,3,1008
ENTRERRIOS,2019,8,ANTIOQUIA,291,651,1890,595,147,129,3703,293,668,44,3,1008
ENTRERRIOS,2019,9,ANTIOQUIA,291,656,1894,593,147,130,3711,296,671,45,3,1015
ENTRERRIOS,2020,1,ANTIOQUIA,293,663,1911,614,141,128,3750,309,677,45,3,1034
ENTRERRIOS,2020,10,ANTIOQUIA,300,662,1953,633,143,128,3819,324,689,45,76,1134
ENTRERRIOS,2020,11,ANTIOQUIA,300,663,1954,633,143,126,3819,329,686,45,76,1136
ENTRERRIOS,2020,12,ANTIOQUIA,301,666,1962,638,143,126,3836,333,685,45,76,1139
ENTRERRIOS,2020,2,ANTIOQUIA,294,663,1929,616,142,128,3772,313,678,47,76,1114
ENTRERRIOS,2020,3,ANTIOQUIA,294,664,1933,617,143,128,3779,317,679,47,76,1119
ENTRERRIOS,2020,4,ANTIOQUIA,294,664,1937,615,143,128,3781,317,680,45,76,1118
ENTRERRIOS,2020,5,ANTIOQUIA,294,665,1944,612,143,128,3786,317,698,51,76,1142
ENTRERRIOS,2020,6,ANTIOQUIA,295,665,1945,612,143,128,3788,320,682,45,76,1123
ENTRERRIOS,2020,7,ANTIOQUIA,297,665,1946,613,143,128,3792,321,686,45,76,1128
ENTRERRIOS,2020,8,ANTIOQUIA,300,663,1948,616,143,128,3798,322,686,45,76,1129
ENTRERRIOS,2020,9,ANTIOQUIA,300,662,1949,630,143,128,3812,322,688,45,76,1131
ENTRERRIOS,2021,1,ANTIOQUIA,301,665,1960,641,143,125,3835,336,696,45,76,1153
ENTRERRIOS,2021,10,ANTIOQUIA,302,670,2013,648,141,118,3892,390,673,45,76,1184
ENTRERRIOS,2021,11,ANTIOQUIA,303,670,2027,649,141,115,3905,394,672,45,76,1187
ENTRERRIOS,2021,12,ANTIOQUIA,303,672,2037,649,141,116,3918,397,672,45,76,1190
ENTRERRIOS,2021,2,ANTIOQUIA,301,665,1963,647,143,125,3844,336,694,45,76,1151
ENTRERRIOS,2021,3,ANTIOQUIA,301,665,1967,650,144,125,3852,342,693,45,76,1156
ENTRERRIOS,2021,4,ANTIOQUIA,302,667,1967,651,144,124,3855,346,690,45,76,1157
ENTRERRIOS,2021,5,ANTIOQUIA,302,669,1969,653,141,120,3854,358,687,45,76,1166
ENTRERRIOS,2021,6,ANTIOQUIA,301,670,1981,652,141,119,3864,361,685,45,76,1167
ENTRERRIOS,2021,7,ANTIOQUIA,301,669,1991,649,141,119,3870,363,684,45,76,1168
ENTRERRIOS,2021,8,ANTIOQUIA,302,671,1993,649,141,119,3875,374,675,45,76,1170
ENTRERRIOS,2021,9,ANTIOQUIA,302,670,2006,651,141,118,3888,387,673,45,76,1181
ENTRERRIOS,2022,1,ANTIOQUIA,304,673,2041,650,139,116,3923,403,669,45,75,1192
ENTRERRIOS,2022,10,ANTIOQUIA,306,671,2098,683,131,108,3997,455,660,45,76,1236
ENTRERRIOS,2022,11,ANTIOQUIA,307,671,2104,688,131,107,4008,462,656,45,75,1238
ENTRERRIOS,2022,12,ANTIOQUIA,307,675,2111,688,131,107,4019,463,656,45,75,1239
ENTRERRIOS,2022,2,ANTIOQUIA,304,675,2046,653,134,112,3924,414,669,45,76,1204
ENTRERRIOS,2022,3,ANTIOQUIA,304,673,2047,657,132,112,3925,417,668,45,76,1206
ENTRERRIOS,2022,4,ANTIOQUIA,304,673,2049,658,131,110,3925,426,668,45,76,1215
ENTRERRIOS,2022,5,ANTIOQUIA,305,673,2047,670,132,110,3937,433,664,45,76,1218
ENTRERRIOS,2022,6,ANTIOQUIA,304,673,2080,673,132,111,3973,437,668,45,76,1226
ENTRERRIOS,2022,7,ANTIOQUIA,304,671,2093,673,129,109,3979,442,664,45,76,1227
ENTRERRIOS,2022,8,ANTIOQUIA,306,671,2093,680,129,109,3988,446,664,45,76,1231
ENTRERRIOS,2022,9,ANTIOQUIA,306,671,2098,683,129,109,3996,451,662,45,76,1234
ENTRERRIOS,2023,1,ANTIOQUIA,307,675,2110,691,131,103,4017,468,653,45,75,1241
ENTRERRIOS,2023,2,ANTIOQUIA,310,677,2112,691,131,104,4025,470,653,45,75,1243
ENTRERRIOS,2023,3,ANTIOQUIA,310,678,2115,693,131,102,4029,474,653,45,75,1247
ENTRERRIOS,2023,4,ANTIOQUIA,310,678,2117,696,131,103,4035,478,653,45,75,1251
ENTRERRIOS,2023,5,ANTIOQUIA,310,678,2123,695,131,103,4040,481,653,46,75,1255
ENTRERRIOS,2023,6,ANTIOQUIA,310,678,2138,695,131,103,4055,485,660,45,75,1265
ENTRERRIOS,2023,7,ANTIOQUIA,310,678,2149,690,130,103,4060,490,660,45,75,1270
ENTRERRIOS,2023,8,ANTIOQUIA,311,678,2150,696,130,103,4068,491,658,45,75,1269
ENTRERRIOS,2023,9,ANTIOQUIA,311,676,2151,697,130,103,4068,494,657,45,75,1271
ENVIGADO,2018,1,ANTIOQUIA,347,14848,27331,15989,17893,1788,78196,959,5963,177,113,7212
ENVIGADO,2018,10,ANTIOQUIA,218,15198,27728,16594,18755,1930,80423,1015,6141,181,120,7457
ENVIGADO,2018,11,ANTIOQUIA,230,15321,27796,16677,18766,1939,80729,1124,6191,180,123,7618
ENVIGADO,2018,12,ANTIOQUIA,232,15336,27836,16430,18201,1894,79929,1114,6219,181,123,7637
ENVIGADO,2018,2,ANTIOQUIA,213,14849,27329,16247,18066,1854,78558,960,6024,177,113,7274
ENVIGADO,2018,3,ANTIOQUIA,214,14817,27488,16358,18070,1869,78816,964,6019,179,113,7275
ENVIGADO,2018,4,ANTIOQUIA,214,14933,27510,16445,18076,1881,79059,982,6054,179,114,7329
ENVIGADO,2018,5,ANTIOQUIA,215,14924,27499,16449,18106,1863,79056,984,6032,181,114,7311
ENVIGADO,2018,6,ANTIOQUIA,216,14938,27654,16521,18232,1862,79423,990,6044,183,115,7332
ENVIGADO,2018,7,ANTIOQUIA,216,15044,27677,16527,18391,1844,79699,991,6057,183,115,7346
ENVIGADO,2018,8,ANTIOQUIA,216,15070,27694,16455,18734,1928,80097,1005,6096,182,119,7402
ENVIGADO,2018,9,ANTIOQUIA,217,15167,27696,16509,18732,1926,80247,1014,6087,180,120,7401
ENVIGADO,2019,1,ANTIOQUIA,232,15415,27867,16706,19143,2005,81368,1122,6239,176,123,7660
ENVIGADO,2019,10,ANTIOQUIA,381,15519,28298,17214,19922,2072,83406,1288,6358,176,126,7948
ENVIGADO,2019,11,ANTIOQUIA,381,15535,28345,17230,19929,2076,83496,1300,6396,177,126,7999
ENVIGADO,2019,12,ANTIOQUIA,386,15547,28375,17235,19960,2077,83580,1308,6423,194,130,8055
ENVIGADO,2019,2,ANTIOQUIA,233,15448,27959,16819,19375,2008,81842,1121,6265,175,124,7685
ENVIGADO,2019,3,ANTIOQUIA,377,15317,27987,16907,19399,2023,82010,1153,6292,177,124,7746
ENVIGADO,2019,4,ANTIOQUIA,377,15339,28013,16804,19522,2046,82101,1194,6309,182,123,7808
ENVIGADO,2019,5,ANTIOQUIA,377,15508,28125,16815,19526,2049,82400,1197,6307,177,123,7804
ENVIGADO,2019,6,ANTIOQUIA,378,15523,28146,16838,19699,2054,82638,1209,6312,178,124,7823
ENVIGADO,2019,7,ANTIOQUIA,378,15548,28163,16931,19720,2058,82798,1218,6300,177,125,7820
ENVIGADO,2019,8,ANTIOQUIA,379,15554,28158,16951,19777,2063,82882,1235,6347,176,125,7883
ENVIGADO,2019,9,ANTIOQUIA,381,15559,28172,17024,19840,2059,83035,1286,6345,179,123,7933
ENVIGADO,2020,1,ANTIOQUIA,380,15580,28466,17274,20029,2076,83805,1299,6401,191,134,8025
ENVIGADO,2020,10,ANTIOQUIA,383,15742,28608,17327,20549,1944,84553,1312,6732,206,1594,9844
ENVIGADO,2020,11,ANTIOQUIA,380,15754,28640,17394,20633,1972,84773,1306,6743,205,1594,9848
ENVIGADO,2020,12,ANTIOQUIA,381,15777,28724,17394,20785,1975,85036,1272,6744,207,1594,9817
ENVIGADO,2020,2,ANTIOQUIA,380,15603,28477,17196,20023,2034,83713,1308,6632,261,1591,9792
ENVIGADO,2020,3,ANTIOQUIA,380,15609,28519,17224,20124,2035,83891,1310,6656,262,1590,9818
ENVIGADO,2020,4,ANTIOQUIA,382,15626,28474,17239,20182,2037,83940,1309,6709,201,1596,9815
ENVIGADO,2020,5,ANTIOQUIA,382,15635,28501,17301,20010,2086,83915,1329,6871,205,1595,10000
ENVIGADO,2020,6,ANTIOQUIA,381,15643,28502,17311,20283,1954,84074,1313,6723,203,1594,9833
ENVIGADO,2020,7,ANTIOQUIA,381,15709,28509,17306,20303,1943,84151,1316,6723,206,1594,9839
ENVIGADO,2020,8,ANTIOQUIA,381,15728,28571,17309,20298,1942,84229,1317,6723,205,1594,9839
ENVIGADO,2020,9,ANTIOQUIA,378,15726,28576,17318,20362,1941,84301,1315,6731,205,1595,9846
ENVIGADO,2021,1,ANTIOQUIA,381,15809,28737,17390,20872,1983,85172,1272,6752,208,1600,9832
ENVIGADO,2021,10,ANTIOQUIA,384,16039,28925,17898,20982,2104,86332,1295,6906,215,1609,10025
ENVIGADO,2021,11,ANTIOQUIA,385,16058,28947,17904,20986,2104,86384,1302,6911,219,1607,10039
ENVIGADO,2021,12,ANTIOQUIA,385,16078,29101,17917,21142,2106,86729,1304,6923,221,1608,10056
ENVIGADO,2021,2,ANTIOQUIA,380,15787,28770,17350,20875,2063,85225,1268,6833,210,1600,9911
ENVIGADO,2021,3,ANTIOQUIA,379,15798,28775,17368,20885,2063,85268,1271,6835,210,1601,9917
ENVIGADO,2021,4,ANTIOQUIA,379,15817,28800,17369,20886,2073,85324,1274,6841,210,1602,9927
ENVIGADO,2021,5,ANTIOQUIA,379,15959,28816,17467,20886,2075,85582,1277,6854,213,1612,9956
ENVIGADO,2021,6,ANTIOQUIA,379,15970,28830,17511,20911,2077,85678,1275,6853,213,1610,9951
ENVIGADO,2021,7,ANTIOQUIA,382,15981,28855,17517,20916,2099,85750,1270,6877,211,1612,9970
ENVIGADO,2021,8,ANTIOQUIA,382,16005,28874,17827,20922,2098,86108,1282,6889,214,1609,9994
ENVIGADO,2021,9,ANTIOQUIA,382,16022,28905,17828,20968,2100,86205,1290,6901,214,1610,10015
ENVIGADO,2022,1,ANTIOQUIA,388,16089,29111,17921,21147,2104,86760,1301,6927,219,1609,10056
ENVIGADO,2022,10,ANTIOQUIA,360,16592,29315,18383,21523,1994,88167,1464,6922,227,1607,10220
ENVIGADO,2022,11,ANTIOQUIA,362,16728,29400,18309,21605,1995,88399,1470,6894,229,1605,10198
ENVIGADO,2022,12,ANTIOQUIA,361,16745,29408,18413,21642,1996,88565,1469,6895,228,1607,10199
ENVIGADO,2022,2,ANTIOQUIA,387,16181,29133,17923,21152,2103,86879,1302,6926,223,1612,10063
ENVIGADO,2022,3,ANTIOQUIA,385,16295,29183,18068,21162,2103,87196,1407,6904,223,1608,10142
ENVIGADO,2022,4,ANTIOQUIA,363,16365,29204,18218,21236,2177,87563,1412,6938,226,1608,10184
ENVIGADO,2022,5,ANTIOQUIA,355,16403,29225,18257,21250,2183,87673,1421,6940,221,1606,10188
ENVIGADO,2022,6,ANTIOQUIA,349,16414,29247,18259,21249,2177,87695,1428,6951,219,1606,10204
ENVIGADO,2022,7,ANTIOQUIA,362,16424,29263,18270,21354,2083,87756,1445,6935,218,1607,10205
ENVIGADO,2022,8,ANTIOQUIA,360,16450,29282,18281,21427,2065,87865,1460,6931,223,1602,10216
ENVIGADO,2022,9,ANTIOQUIA,360,16569,29300,18283,21521,1994,88027,1462,6933,227,1603,10225
ENVIGADO,2023,1,ANTIOQUIA,359,16753,29516,18551,21650,2007,88836,1463,6884,231,1608,10186
ENVIGADO,2023,2,ANTIOQUIA,359,16764,29583,18688,21667,2008,89069,1475,6903,223,1616,10217
ENVIGADO,2023,3,ANTIOQUIA,359,16780,29615,18701,21669,2011,89135,1473,6896,221,1617,10207
ENVIGADO,2023,4,ANTIOQUIA,358,16784,29656,18804,21675,2026,89303,1471,6926,225,1615,10237
ENVIGADO,2023,5,ANTIOQUIA,358,16856,29727,18803,21679,2029,89452,1480,6918,223,1616,10237
ENVIGADO,2023,6,ANTIOQUIA,358,16858,29774,18810,21757,2033,89590,1475,6965,215,1622,10277
ENVIGADO,2023,7,ANTIOQUIA,357,16880,29788,18907,21790,2038,89760,1486,6949,212,1625,10272
ENVIGADO,2023,8,ANTIOQUIA,358,16903,29802,18906,21965,2039,89973,1471,6979,210,1628,10288
ENVIGADO,2023,9,ANTIOQUIA,357,16912,29831,18987,21294,2039,89420,1478,7695,208,1629,11010
FREDONIA,2018,1,ANTIOQUIA,2656,2756,1813,260,206,50,7741,150,552,82,13,797
FREDONIA,2018,10,ANTIOQUIA,2676,2780,1816,259,206,51,7788,149,550,82,13,794
FREDONIA,2018,11,ANTIOQUIA,2687,2773,1819,260,206,51,7796,149,551,81,13,794
FREDONIA,2018,12,ANTIOQUIA,2689,2776,1819,264,207,51,7806,149,551,81,13,794
FREDONIA,2018,2,ANTIOQUIA,2662,2761,1814,260,206,50,7753,150,551,83,13,797
FREDONIA,2018,3,ANTIOQUIA,2660,2762,1813,260,206,50,7751,149,552,82,13,796
FREDONIA,2018,4,ANTIOQUIA,2665,2767,1813,260,206,50,7761,149,552,83,13,797
FREDONIA,2018,5,ANTIOQUIA,2662,2767,1812,260,206,50,7757,148,551,83,13,795
FREDONIA,2018,6,ANTIOQUIA,2665,2771,1812,259,206,50,7763,148,549,82,13,792
FREDONIA,2018,7,ANTIOQUIA,2667,2775,1813,259,206,50,7770,148,550,82,13,793
FREDONIA,2018,8,ANTIOQUIA,2670,2774,1814,259,206,50,7773,148,550,82,13,793
FREDONIA,2018,9,ANTIOQUIA,2674,2775,1815,259,206,50,7779,148,549,82,13,792
FREDONIA,2019,1,ANTIOQUIA,2687,2784,1835,266,207,51,7830,148,551,81,13,793
FREDONIA,2019,10,ANTIOQUIA,2738,2835,1862,268,206,51,7960,144,558,81,14,797
FREDONIA,2019,11,ANTIOQUIA,2740,2838,1865,269,205,51,7968,145,556,81,13,795
FREDONIA,2019,12,ANTIOQUIA,2747,2853,1866,271,205,52,7994,145,555,81,13,794
FREDONIA,2019,2,ANTIOQUIA,2690,2783,1839,268,207,51,7838,146,552,81,13,792
FREDONIA,2019,3,ANTIOQUIA,2693,2787,1838,270,207,51,7846,146,551,81,13,791
FREDONIA,2019,4,ANTIOQUIA,2693,2791,1842,268,207,51,7852,145,551,81,13,790
FREDONIA,2019,5,ANTIOQUIA,2699,2798,1843,269,207,51,7867,145,552,81,13,791
FREDONIA,2019,6,ANTIOQUIA,2697,2803,1852,270,207,51,7880,145,556,81,13,795
FREDONIA,2019,7,ANTIOQUIA,2696,2814,1855,268,207,51,7891,145,555,81,13,794
FREDONIA,2019,8,ANTIOQUIA,2700,2814,1860,268,207,51,7900,145,558,81,13,797
FREDONIA,2019,9,ANTIOQUIA,2723,2825,1861,268,207,51,7935,144,558,81,13,796
FREDONIA,2020,1,ANTIOQUIA,2751,2848,1863,286,205,52,8005,143,555,81,13,792
FREDONIA,2020,10,ANTIOQUIA,2775,2871,1883,275,204,51,8059,143,570,81,231,1025
FREDONIA,2020,11,ANTIOQUIA,2783,2874,1883,274,203,51,8068,143,571,81,231,1026
FREDONIA,2020,12,ANTIOQUIA,2783,2873,1884,274,204,51,8069,144,572,81,231,1028
FREDONIA,2020,2,ANTIOQUIA,2752,2851,1864,289,205,52,8013,143,555,90,231,1019
FREDONIA,2020,3,ANTIOQUIA,2755,2856,1864,291,205,52,8023,144,555,90,231,1020
FREDONIA,2020,4,ANTIOQUIA,2756,2861,1877,271,205,51,8021,144,563,81,231,1019
FREDONIA,2020,5,ANTIOQUIA,2760,2860,1889,272,205,51,8037,144,566,81,231,1022
FREDONIA,2020,6,ANTIOQUIA,2761,2860,1877,271,204,51,8024,144,561,81,231,1017
FREDONIA,2020,7,ANTIOQUIA,2763,2865,1878,273,205,51,8035,145,563,81,231,1020
FREDONIA,2020,8,ANTIOQUIA,2764,2867,1880,272,203,51,8037,144,562,81,231,1018
FREDONIA,2020,9,ANTIOQUIA,2766,2869,1881,274,202,51,8043,145,564,81,231,1021
FREDONIA,2021,1,ANTIOQUIA,2784,2883,1885,275,204,51,8082,144,572,80,231,1027
FREDONIA,2021,10,ANTIOQUIA,2798,2915,1911,279,204,50,8157,147,580,80,231,1038
FREDONIA,2021,11,ANTIOQUIA,2781,2913,1910,280,203,49,8136,146,578,79,231,1034
FREDONIA,2021,12,ANTIOQUIA,2783,2915,1916,283,201,50,8148,146,585,79,231,1041
FREDONIA,2021,2,ANTIOQUIA,2786,2889,1896,276,203,51,8101,144,572,80,231,1027
FREDONIA,2021,3,ANTIOQUIA,2789,2891,1893,282,203,51,8109,144,579,81,231,1035
FREDONIA,2021,4,ANTIOQUIA,2790,2895,1897,282,203,51,8118,143,579,81,231,1034
FREDONIA,2021,5,ANTIOQUIA,2791,2900,1898,284,203,51,8127,146,578,81,231,1036
FREDONIA,2021,6,ANTIOQUIA,2793,2903,1903,278,203,51,8131,146,577,81,231,1035
FREDONIA,2021,7,ANTIOQUIA,2794,2907,1904,279,203,50,8137,146,578,81,231,1036
FREDONIA,2021,8,ANTIOQUIA,2794,2910,1905,278,204,50,8141,149,578,81,231,1039
FREDONIA,2021,9,ANTIOQUIA,2787,2910,1906,279,202,49,8133,149,575,78,231,1033
FREDONIA,2022,1,ANTIOQUIA,2789,2915,1921,282,201,47,8155,146,587,79,231,1043
FREDONIA,2022,10,ANTIOQUIA,2813,2950,1928,283,200,47,8221,148,583,81,231,1043
FREDONIA,2022,11,ANTIOQUIA,2816,2952,1931,283,199,47,8228,152,582,81,231,1046
FREDONIA,2022,12,ANTIOQUIA,2817,2953,1943,282,199,47,8241,148,582,81,231,1042
FREDONIA,2022,2,ANTIOQUIA,2793,2916,1923,282,201,48,8163,147,587,79,231,1044
FREDONIA,2022,3,ANTIOQUIA,2797,2926,1922,282,201,48,8176,145,588,81,229,1043
FREDONIA,2022,4,ANTIOQUIA,2804,2926,1924,283,200,47,8184,147,590,81,230,1048
FREDONIA,2022,5,ANTIOQUIA,2800,2933,1926,282,200,47,8188,146,589,81,230,1046
FREDONIA,2022,6,ANTIOQUIA,2805,2932,1927,282,200,47,8193,146,589,81,230,1046
FREDONIA,2022,7,ANTIOQUIA,2813,2933,1927,282,199,47,8201,149,588,81,230,1048
FREDONIA,2022,8,ANTIOQUIA,2806,2943,1928,281,200,47,8205,148,588,81,231,1048
FREDONIA,2022,9,ANTIOQUIA,2808,2949,1928,282,200,47,8214,149,583,81,231,1044
FREDONIA,2023,1,ANTIOQUIA,2820,2960,1941,283,199,47,8250,148,582,80,231,1041
FREDONIA,2023,2,ANTIOQUIA,2822,2965,1944,284,199,47,8261,149,583,80,231,1043
FREDONIA,2023,3,ANTIOQUIA,2828,2969,1946,281,199,47,8270,149,582,80,231,1042
FREDONIA,2023,4,ANTIOQUIA,2828,2968,1946,279,199,47,8267,149,580,80,231,1040
FREDONIA,2023,5,ANTIOQUIA,2835,2978,1949,280,198,47,8287,149,582,80,231,1042
FREDONIA,2023,6,ANTIOQUIA,1998,2978,2497,523,236,51,8283,149,581,80,231,1041
FREDONIA,2023,7,ANTIOQUIA,1427,2905,2939,751,218,46,8286,148,577,80,231,1036
FREDONIA,2023,8,ANTIOQUIA,1437,2893,2941,750,222,45,8288,149,578,80,231,1038
FREDONIA,2023,9,ANTIOQUIA,1457,2951,2879,725,226,43,8281,150,578,80,233,1041
FRONTINO,2018,1,ANTIOQUIA,2136,2926,1241,144,0,6,6453,49,448,97,9,603
FRONTINO,2018,10,ANTIOQUIA,2160,2956,1239,141,0,5,6501,49,454,96,11,610
FRONTINO,2018,11,ANTIOQUIA,2163,2958,1235,141,0,5,6502,48,455,96,11,610
FRONTINO,2018,12,ANTIOQUIA,2163,2971,1238,139,0,5,6516,48,459,96,11,614
FRONTINO,2018,2,ANTIOQUIA,2138,2928,1241,141,0,6,6454,48,451,97,9,605
FRONTINO,2018,3,ANTIOQUIA,2136,2934,1239,140,0,6,6455,49,452,96,9,606
FRONTINO,2018,4,ANTIOQUIA,2148,2940,1241,138,0,6,6473,48,453,96,11,608
FRONTINO,2018,5,ANTIOQUIA,2141,2941,1241,139,0,6,6468,48,455,96,11,610
FRONTINO,2018,6,ANTIOQUIA,2139,2943,1243,140,0,6,6471,49,457,96,11,613
FRONTINO,2018,7,ANTIOQUIA,2149,2949,1244,141,0,5,6488,49,457,96,11,613
FRONTINO,2018,8,ANTIOQUIA,2154,2953,1243,141,0,5,6496,49,455,96,11,611
FRONTINO,2018,9,ANTIOQUIA,2156,2953,1239,141,0,5,6494,49,455,96,11,611
FRONTINO,2019,1,ANTIOQUIA,2170,2978,1239,138,0,4,6529,49,459,96,11,615
FRONTINO,2019,10,ANTIOQUIA,2219,3019,1252,138,0,4,6632,50,468,97,11,626
FRONTINO,2019,11,ANTIOQUIA,2224,3023,1251,137,0,4,6639,50,467,97,11,625
FRONTINO,2019,12,ANTIOQUIA,2234,3032,1256,139,0,4,6665,51,466,97,11,625
FRONTINO,2019,2,ANTIOQUIA,2185,2980,1241,138,0,4,6548,50,461,96,11,618
FRONTINO,2019,3,ANTIOQUIA,2195,2984,1243,138,0,4,6564,50,468,96,11,625
FRONTINO,2019,4,ANTIOQUIA,2200,2989,1246,138,0,4,6577,50,470,96,11,627
FRONTINO,2019,5,ANTIOQUIA,2201,3001,1247,138,0,4,6591,50,470,96,11,627
FRONTINO,2019,6,ANTIOQUIA,2201,2997,1248,139,0,4,6589,50,468,96,11,625
FRONTINO,2019,7,ANTIOQUIA,2204,3002,1249,140,0,4,6599,50,467,97,11,625
FRONTINO,2019,8,ANTIOQUIA,2206,3007,1251,140,0,4,6608,51,468,97,11,627
FRONTINO,2019,9,ANTIOQUIA,2210,3016,1250,140,0,4,6620,51,467,97,11,626
FRONTINO,2020,1,ANTIOQUIA,2230,3028,1254,146,0,4,6662,50,467,97,11,625
FRONTINO,2020,10,ANTIOQUIA,2275,3074,1259,139,0,4,6751,51,485,98,147,781
FRONTINO,2020,11,ANTIOQUIA,2276,3083,1263,136,0,4,6762,51,485,98,147,781
FRONTINO,2020,12,ANTIOQUIA,2281,3090,1265,134,0,4,6774,51,487,98,147,783
FRONTINO,2020,2,ANTIOQUIA,2228,3032,1252,146,0,4,6662,50,470,107,147,774
FRONTINO,2020,3,ANTIOQUIA,2232,3037,1252,149,0,4,6674,50,469,107,147,773
FRONTINO,2020,4,ANTIOQUIA,2232,3042,1253,141,0,4,6672,50,482,98,147,777
FRONTINO,2020,5,ANTIOQUIA,2328,3060,1255,139,0,4,6786,53,484,99,147,783
FRONTINO,2020,6,ANTIOQUIA,2260,3050,1256,139,0,4,6709,52,485,98,147,782
FRONTINO,2020,7,ANTIOQUIA,2263,3053,1257,139,0,4,6716,52,485,98,147,782
FRONTINO,2020,8,ANTIOQUIA,2270,3060,1257,140,0,4,6731,52,485,98,147,782
FRONTINO,2020,9,ANTIOQUIA,2272,3067,1256,139,0,4,6738,51,485,98,147,781
FRONTINO,2021,1,ANTIOQUIA,2308,3095,1266,134,0,4,6807,51,487,98,147,783
FRONTINO,2021,10,ANTIOQUIA,2320,3175,1274,145,0,4,6918,49,506,99,148,802
FRONTINO,2021,11,ANTIOQUIA,2306,3181,1275,144,0,5,6911,49,506,99,147,801
FRONTINO,2021,12,ANTIOQUIA,2311,3185,1279,146,0,5,6926,49,509,99,147,804
FRONTINO,2021,2,ANTIOQUIA,2312,3103,1269,134,0,4,6822,51,489,98,146,784
FRONTINO,2021,3,ANTIOQUIA,2313,3105,1269,135,0,4,6826,51,489,98,147,785
FRONTINO,2021,4,ANTIOQUIA,2316,3109,1271,138,0,4,6838,51,489,98,147,785
FRONTINO,2021,5,ANTIOQUIA,2317,3114,1269,139,0,4,6843,51,493,98,148,790
FRONTINO,2021,6,ANTIOQUIA,2317,3113,1269,140,0,4,6843,49,496,98,148,791
FRONTINO,2021,7,ANTIOQUIA,2313,3119,1269,140,0,4,6845,49,496,98,148,791
FRONTINO,2021,8,ANTIOQUIA,2319,3127,1271,141,0,4,6862,49,504,99,148,800
FRONTINO,2021,9,ANTIOQUIA,2315,3169,1273,143,0,4,6904,49,507,99,148,803
FRONTINO,2022,1,ANTIOQUIA,2311,3199,1279,145,0,6,6940,49,508,99,147,803
FRONTINO,2022,10,ANTIOQUIA,2327,3243,1283,145,0,4,7002,49,512,102,147,810
FRONTINO,2022,11,ANTIOQUIA,2328,3253,1291,145,0,4,7021,49,515,102,147,813
FRONTINO,2022,12,ANTIOQUIA,2329,3261,1287,146,0,4,7027,49,518,102,147,816
FRONTINO,2022,2,ANTIOQUIA,2313,3209,1281,147,0,6,6956,49,508,99,147,803
FRONTINO,2022,3,ANTIOQUIA,2315,3218,1280,148,0,6,6967,48,509,100,147,804
FRONTINO,2022,4,ANTIOQUIA,2318,3232,1280,148,0,6,6984,48,511,100,147,806
FRONTINO,2022,5,ANTIOQUIA,2313,3248,1282,148,0,6,6997,48,511,100,147,806
FRONTINO,2022,6,ANTIOQUIA,2320,3252,1287,146,0,5,7010,49,511,100,147,807
FRONTINO,2022,7,ANTIOQUIA,2312,3217,1287,148,0,5,6969,49,509,100,147,805
FRONTINO,2022,8,ANTIOQUIA,2319,3224,1283,146,0,4,6976,49,510,102,147,808
FRONTINO,2022,9,ANTIOQUIA,2323,3236,1284,145,0,4,6992,49,513,102,147,811
FRONTINO,2023,1,ANTIOQUIA,2331,3268,1288,145,0,4,7036,50,519,102,148,819
FRONTINO,2023,2,ANTIOQUIA,2333,3280,1298,147,0,4,7062,50,518,102,148,818
FRONTINO,2023,3,ANTIOQUIA,2348,3299,1299,151,0,4,7101,50,526,102,148,826
FRONTINO,2023,4,ANTIOQUIA,2361,3304,1299,149,0,4,7117,50,526,103,148,827
FRONTINO,2023,5,ANTIOQUIA,2366,3311,1298,149,0,4,7128,50,527,103,149,829
FRONTINO,2023,6,ANTIOQUIA,2360,3318,1298,150,0,4,7130,48,527,103,149,827
FRONTINO,2023,7,ANTIOQUIA,2365,3327,1299,149,0,4,7144,48,528,103,149,828
FRONTINO,2023,8,ANTIOQUIA,2371,3338,1299,149,0,4,7161,48,528,103,150,829
FRONTINO,2023,9,ANTIOQUIA,2371,3355,1304,149,0,4,7183,48,531,103,150,832
GIRALDO,2018,1,ANTIOQUIA,1051,840,64,0,0,0,1955,9,93,31,6,139
GIRALDO,2018,10,ANTIOQUIA,1064,845,70,1,0,0,1980,10,94,31,6,141
GIRALDO,2018,11,ANTIOQUIA,1063,845,68,1,0,0,1977,10,93,31,6,140
GIRALDO,2018,12,ANTIOQUIA,1065,846,68,1,0,0,1980,10,93,31,6,140
GIRALDO,2018,2,ANTIOQUIA,1052,839,66,0,0,0,1957,9,93,31,6,139
GIRALDO,2018,3,ANTIOQUIA,1053,839,66,0,0,0,1958,9,94,31,6,140
GIRALDO,2018,4,ANTIOQUIA,1061,839,66,1,0,0,1967,9,94,31,6,140
GIRALDO,2018,5,ANTIOQUIA,1055,840,66,1,0,0,1962,10,93,31,6,140
GIRALDO,2018,6,ANTIOQUIA,1056,841,66,0,0,0,1963,10,94,31,6,141
GIRALDO,2018,7,ANTIOQUIA,1058,842,68,0,0,0,1968,10,95,31,6,142
GIRALDO,2018,8,ANTIOQUIA,1058,845,68,1,0,0,1972,10,94,31,6,141
GIRALDO,2018,9,ANTIOQUIA,1058,846,68,1,0,0,1973,10,94,31,6,141
GIRALDO,2019,1,ANTIOQUIA,1064,847,68,1,0,0,1980,10,95,31,6,142
GIRALDO,2019,10,ANTIOQUIA,1098,855,69,1,0,0,2023,10,96,31,6,143
GIRALDO,2019,11,ANTIOQUIA,1103,857,69,1,0,0,2030,10,96,31,6,143
GIRALDO,2019,12,ANTIOQUIA,1096,853,68,1,0,0,2018,11,96,31,6,144
GIRALDO,2019,2,ANTIOQUIA,1069,849,68,1,0,0,1987,10,94,31,6,141
GIRALDO,2019,3,ANTIOQUIA,1071,849,69,1,0,0,1990,10,94,31,6,141
GIRALDO,2019,4,ANTIOQUIA,1073,848,69,1,0,0,1991,10,94,31,6,141
GIRALDO,2019,5,ANTIOQUIA,1076,852,69,1,0,0,1998,10,94,31,6,141
GIRALDO,2019,6,ANTIOQUIA,1078,849,69,1,0,0,1997,10,94,31,6,141
GIRALDO,2019,7,ANTIOQUIA,1081,849,69,1,0,0,2000,10,94,31,6,141
GIRALDO,2019,8,ANTIOQUIA,1083,850,69,1,0,0,2003,10,96,31,6,143
GIRALDO,2019,9,ANTIOQUIA,1085,851,69,1,0,0,2006,10,96,31,6,143
GIRALDO,2020,1,ANTIOQUIA,1105,857,68,2,0,0,2032,11,96,31,6,144
GIRALDO,2020,10,ANTIOQUIA,1145,871,70,3,0,0,2089,12,105,31,58,206
GIRALDO,2020,11,ANTIOQUIA,1151,871,70,3,0,0,2095,12,105,31,58,206
GIRALDO,2020,12,ANTIOQUIA,1160,872,70,4,0,0,2106,12,106,31,58,207
GIRALDO,2020,2,ANTIOQUIA,1096,855,68,4,0,0,2023,11,98,36,58,203
GIRALDO,2020,3,ANTIOQUIA,1097,855,68,4,0,0,2024,11,98,36,58,203
GIRALDO,2020,4,ANTIOQUIA,1100,855,68,1,0,0,2024,11,103,31,58,203
GIRALDO,2020,5,ANTIOQUIA,1104,857,68,1,0,0,2030,12,103,31,58,204
GIRALDO,2020,6,ANTIOQUIA,1106,857,69,1,0,0,2033,12,104,31,58,205
GIRALDO,2020,7,ANTIOQUIA,1126,862,69,1,0,0,2058,12,103,31,58,204
GIRALDO,2020,8,ANTIOQUIA,1128,862,69,1,0,0,2060,12,104,31,58,205
GIRALDO,2020,9,ANTIOQUIA,1137,862,69,1,0,0,2069,13,104,31,58,206
GIRALDO,2021,1,ANTIOQUIA,1168,876,70,4,0,0,2118,12,106,31,58,207
GIRALDO,2021,10,ANTIOQUIA,1199,908,72,4,0,0,2183,12,107,31,58,208
GIRALDO,2021,11,ANTIOQUIA,1203,915,72,4,0,0,2194,12,107,31,58,208
GIRALDO,2021,12,ANTIOQUIA,1204,920,72,4,0,0,2200,12,108,31,58,209
GIRALDO,2021,2,ANTIOQUIA,1170,880,70,4,0,0,2124,12,106,31,58,207
GIRALDO,2021,3,ANTIOQUIA,1171,882,70,3,0,0,2126,12,106,31,58,207
GIRALDO,2021,4,ANTIOQUIA,1177,888,70,2,0,0,2137,12,107,31,58,208
GIRALDO,2021,5,ANTIOQUIA,1179,889,70,3,0,0,2141,12,107,31,57,207
GIRALDO,2021,6,ANTIOQUIA,1181,890,70,4,0,0,2145,12,106,31,58,207
GIRALDO,2021,7,ANTIOQUIA,1189,895,70,5,0,0,2159,12,106,31,58,207
GIRALDO,2021,8,ANTIOQUIA,1195,902,70,5,0,0,2172,12,106,31,58,207
GIRALDO,2021,9,ANTIOQUIA,1198,904,70,5,0,0,2177,12,107,31,58,208
GIRALDO,2022,1,ANTIOQUIA,1204,923,72,4,0,0,2203,12,108,31,58,209
GIRALDO,2022,10,ANTIOQUIA,1230,958,74,7,0,0,2269,12,117,31,60,220
GIRALDO,2022,11,ANTIOQUIA,1231,965,74,8,0,0,2278,12,118,31,61,222
GIRALDO,2022,12,ANTIOQUIA,1234,968,72,9,0,0,2283,13,118,31,61,223
GIRALDO,2022,2,ANTIOQUIA,1204,926,73,3,0,0,2206,12,108,31,58,209
GIRALDO,2022,3,ANTIOQUIA,1210,937,73,5,0,0,2225,12,108,31,58,209
GIRALDO,2022,4,ANTIOQUIA,1211,943,73,5,0,0,2232,12,109,31,58,210
GIRALDO,2022,5,ANTIOQUIA,1212,945,73,5,0,0,2235,12,109,31,58,210
GIRALDO,2022,6,ANTIOQUIA,1217,946,73,4,0,0,2240,12,109,31,58,210
GIRALDO,2022,7,ANTIOQUIA,1218,951,74,6,0,0,2249,12,110,31,59,212
GIRALDO,2022,8,ANTIOQUIA,1222,953,74,4,0,0,2253,12,110,31,60,213
GIRALDO,2022,9,ANTIOQUIA,1228,953,74,5,0,0,2260,12,113,31,60,216
GIRALDO,2023,1,ANTIOQUIA,1243,968,73,8,0,0,2292,13,118,31,61,223
GIRALDO,2023,2,ANTIOQUIA,1245,974,73,5,0,0,2297,13,118,31,61,223
GIRALDO,2023,3,ANTIOQUIA,1254,984,73,4,0,0,2315,13,119,31,61,224
GIRALDO,2023,4,ANTIOQUIA,1261,986,73,4,0,0,2324,13,119,31,61,224
GIRALDO,2023,5,ANTIOQUIA,1268,993,72,4,0,0,2337,13,119,31,62,225
GIRALDO,2023,6,ANTIOQUIA,1272,995,71,4,0,0,2342,13,118,31,62,224
GIRALDO,2023,7,ANTIOQUIA,1277,993,71,4,0,0,2345,14,120,31,62,227
GIRALDO,2023,8,ANTIOQUIA,1276,995,70,4,0,0,2345,13,120,32,62,227
GIRALDO,2023,9,ANTIOQUIA,1290,1000,69,4,0,0,2363,13,120,32,63,228
GIRARDOTA,2018,1,ANTIOQUIA,1074,12660,1940,284,117,103,16178,174,1030,71,16,1291
GIRARDOTA,2018,10,ANTIOQUIA,1114,13084,1972,289,116,103,16678,184,1051,71,16,1322
GIRARDOTA,2018,11,ANTIOQUIA,1116,13079,1968,289,116,103,16671,189,1053,70,17,1329
GIRARDOTA,2018,12,ANTIOQUIA,1122,13115,1966,291,116,103,16713,194,1054,70,17,1335
GIRARDOTA,2018,2,ANTIOQUIA,1076,12721,1945,284,117,104,16247,175,1037,71,16,1299
GIRARDOTA,2018,3,ANTIOQUIA,1077,12869,1947,285,117,104,16399,178,1041,71,16,1306
GIRARDOTA,2018,4,ANTIOQUIA,1079,12911,1950,285,117,104,16446,177,1042,72,16,1307
GIRARDOTA,2018,5,ANTIOQUIA,1082,12952,1959,285,117,104,16499,175,1044,72,16,1307
GIRARDOTA,2018,6,ANTIOQUIA,1085,12983,1959,288,117,103,16535,176,1041,72,16,1305
GIRARDOTA,2018,7,ANTIOQUIA,1089,13002,1962,288,117,103,16561,177,1045,71,16,1309
GIRARDOTA,2018,8,ANTIOQUIA,1110,13012,1968,288,117,103,16598,181,1054,71,16,1322
GIRARDOTA,2018,9,ANTIOQUIA,1110,13040,1970,288,116,103,16627,184,1051,70,16,1321
GIRARDOTA,2019,1,ANTIOQUIA,1123,13134,1967,293,116,103,16736,196,1055,70,17,1338
GIRARDOTA,2019,10,ANTIOQUIA,1139,13464,2051,296,119,102,17171,215,1096,70,16,1397
GIRARDOTA,2019,11,ANTIOQUIA,1147,13487,2051,296,119,102,17202,216,1096,70,16,1398
GIRARDOTA,2019,12,ANTIOQUIA,1151,13528,2062,299,120,102,17262,219,1097,70,16,1402
GIRARDOTA,2019,2,ANTIOQUIA,1125,13157,1969,293,116,103,16763,198,1057,70,17,1342
GIRARDOTA,2019,3,ANTIOQUIA,1128,13196,1984,319,117,103,16847,200,1063,70,17,1350
GIRARDOTA,2019,4,ANTIOQUIA,1127,13233,2000,318,117,103,16898,199,1069,70,17,1355
GIRARDOTA,2019,5,ANTIOQUIA,1126,13270,2029,318,117,103,16963,199,1074,70,17,1360
GIRARDOTA,2019,6,ANTIOQUIA,1130,13313,2029,293,117,103,16985,199,1077,70,17,1363
GIRARDOTA,2019,7,ANTIOQUIA,1130,13350,2039,294,117,103,17033,203,1083,70,17,1373
GIRARDOTA,2019,8,ANTIOQUIA,1130,13419,2039,296,119,102,17105,211,1094,70,17,1392
GIRARDOTA,2019,9,ANTIOQUIA,1135,13437,2046,296,119,102,17135,213,1096,71,15,1395
GIRARDOTA,2020,1,ANTIOQUIA,1154,13523,2060,308,119,102,17266,220,1098,70,16,1404
GIRARDOTA,2020,10,ANTIOQUIA,1202,13734,2124,315,120,101,17596,236,1153,71,647,2107
GIRARDOTA,2020,11,ANTIOQUIA,1200,13778,2128,318,120,101,17645,234,1153,71,647,2105
GIRARDOTA,2020,12,ANTIOQUIA,1205,13809,2130,323,120,100,17687,238,1155,71,646,2110
GIRARDOTA,2020,2,ANTIOQUIA,1163,13553,2079,311,119,102,17327,224,1106,78,646,2054
GIRARDOTA,2020,3,ANTIOQUIA,1165,13571,2082,316,119,102,17355,225,1100,78,646,2049
GIRARDOTA,2020,4,ANTIOQUIA,1169,13580,2083,304,120,102,17358,224,1134,71,645,2074
GIRARDOTA,2020,5,ANTIOQUIA,1171,13614,2086,307,123,103,17404,220,1146,71,645,2082
GIRARDOTA,2020,6,ANTIOQUIA,1177,13619,2114,308,120,103,17441,227,1149,71,645,2092
GIRARDOTA,2020,7,ANTIOQUIA,1178,13665,2117,311,119,104,17494,227,1154,71,645,2097
GIRARDOTA,2020,8,ANTIOQUIA,1180,13682,2118,310,120,101,17511,231,1155,71,647,2104
GIRARDOTA,2020,9,ANTIOQUIA,1184,13720,2125,311,120,101,17561,231,1154,71,647,2103
GIRARDOTA,2021,1,ANTIOQUIA,1213,13829,2141,322,120,100,17725,238,1157,71,646,2112
GIRARDOTA,2021,10,ANTIOQUIA,1236,14293,2221,362,122,100,18334,257,1190,73,647,2167
GIRARDOTA,2021,11,ANTIOQUIA,1236,14343,2224,412,122,100,18437,256,1190,73,647,2166
GIRARDOTA,2021,12,ANTIOQUIA,1250,14364,2228,413,122,100,18477,257,1188,74,647,2166
GIRARDOTA,2021,2,ANTIOQUIA,1216,13895,2144,317,121,100,17793,240,1162,71,646,2119
GIRARDOTA,2021,3,ANTIOQUIA,1215,13967,2150,325,122,100,17879,242,1159,71,646,2118
GIRARDOTA,2021,4,ANTIOQUIA,1222,14054,2153,326,122,100,17977,252,1167,73,646,2138
GIRARDOTA,2021,5,ANTIOQUIA,1221,14097,2187,329,123,100,18057,254,1165,72,646,2137
GIRARDOTA,2021,6,ANTIOQUIA,1219,14098,2196,327,123,100,18063,254,1171,72,646,2143
GIRARDOTA,2021,7,ANTIOQUIA,1228,14135,2195,322,123,100,18103,254,1169,72,646,2141
GIRARDOTA,2021,8,ANTIOQUIA,1231,14187,2211,362,122,100,18213,253,1173,73,646,2145
GIRARDOTA,2021,9,ANTIOQUIA,1233,14230,2216,363,122,100,18264,255,1185,73,646,2159
GIRARDOTA,2022,1,ANTIOQUIA,1253,14387,2231,413,122,100,18506,265,1190,74,647,2176
GIRARDOTA,2022,10,ANTIOQUIA,1196,14881,2291,422,122,101,19013,286,1248,77,644,2255
GIRARDOTA,2022,11,ANTIOQUIA,1198,14911,2301,424,122,100,19056,286,1245,77,644,2252
GIRARDOTA,2022,12,ANTIOQUIA,1201,14949,2302,427,122,100,19101,289,1248,77,645,2259
GIRARDOTA,2022,2,ANTIOQUIA,1253,14443,2232,413,122,100,18563,267,1192,76,646,2181
GIRARDOTA,2022,3,ANTIOQUIA,1252,14478,2235,417,122,100,18604,271,1196,77,645,2189
GIRARDOTA,2022,4,ANTIOQUIA,1232,14547,2241,417,122,100,18659,270,1198,77,645,2190
GIRARDOTA,2022,5,ANTIOQUIA,1172,14637,2255,419,122,100,18705,273,1227,77,645,2222
GIRARDOTA,2022,6,ANTIOQUIA,1103,14755,2266,420,122,100,18766,276,1240,78,645,2239
GIRARDOTA,2022,7,ANTIOQUIA,1187,14752,2257,416,122,100,18834,279,1241,78,646,2244
GIRARDOTA,2022,8,ANTIOQUIA,1190,14791,2272,422,122,100,18897,277,1244,77,645,2243
GIRARDOTA,2022,9,ANTIOQUIA,1193,14837,2290,422,122,101,18965,282,1247,77,645,2251
GIRARDOTA,2023,1,ANTIOQUIA,1205,14971,2299,433,122,100,19130,289,1249,77,645,2260
GIRARDOTA,2023,2,ANTIOQUIA,1209,15011,2312,433,122,100,19187,294,1247,77,645,2263
GIRARDOTA,2023,3,ANTIOQUIA,1212,15064,2317,434,122,100,19249,292,1248,77,645,2262
GIRARDOTA,2023,4,ANTIOQUIA,1214,15092,2321,433,122,100,19282,298,1245,77,645,2265
GIRARDOTA,2023,5,ANTIOQUIA,1215,15136,2344,471,122,100,19388,296,1251,79,645,2271
GIRARDOTA,2023,6,ANTIOQUIA,1219,15156,2357,566,122,100,19520,297,1243,79,645,2264
GIRARDOTA,2023,7,ANTIOQUIA,1220,15185,2358,568,122,100,19553,295,1242,79,647,2263
GIRARDOTA,2023,8,ANTIOQUIA,1228,15212,2369,621,122,100,19652,296,1247,80,647,2270
GIRARDOTA,2023,9,ANTIOQUIA,1234,15244,2450,623,122,100,19773,298,1250,81,648,2277
GOMEZ PLATA,2018,1,ANTIOQUIA,1387,2596,138,32,12,6,4171,28,265,66,1,360
GOMEZ PLATA,2018,10,ANTIOQUIA,1405,2637,135,33,11,7,4228,29,267,66,1,363
GOMEZ PLATA,2018,11,ANTIOQUIA,1407,2640,135,34,10,7,4233,29,267,66,1,363
GOMEZ PLATA,2018,12,ANTIOQUIA,1407,2643,134,34,10,7,4235,29,267,66,1,363
GOMEZ PLATA,2018,2,ANTIOQUIA,1390,2602,138,33,12,6,4181,29,265,66,1,361
GOMEZ PLATA,2018,3,ANTIOQUIA,1395,2613,137,33,12,6,4196,28,265,66,1,360
GOMEZ PLATA,2018,4,ANTIOQUIA,1396,2614,138,34,11,6,4199,28,265,66,1,360
GOMEZ PLATA,2018,5,ANTIOQUIA,1397,2615,137,33,11,6,4199,28,265,66,1,360
GOMEZ PLATA,2018,6,ANTIOQUIA,1398,2623,137,33,11,6,4208,28,264,66,1,359
GOMEZ PLATA,2018,7,ANTIOQUIA,1401,2625,137,33,11,6,4213,29,265,66,1,361
GOMEZ PLATA,2018,8,ANTIOQUIA,1403,2627,135,33,11,6,4215,29,265,66,1,361
GOMEZ PLATA,2018,9,ANTIOQUIA,1403,2634,136,33,11,6,4223,29,267,66,1,363
GOMEZ PLATA,2019,1,ANTIOQUIA,1410,2645,133,34,10,7,4239,29,267,66,1,363
GOMEZ PLATA,2019,10,ANTIOQUIA,1450,2687,131,34,10,7,4319,26,283,68,1,378
GOMEZ PLATA,2019,11,ANTIOQUIA,1451,2698,132,34,10,7,4332,26,283,68,1,378
GOMEZ PLATA,2019,12,ANTIOQUIA,1455,2709,132,33,10,7,4346,27,283,68,1,379
GOMEZ PLATA,2019,2,ANTIOQUIA,1411,2649,133,34,10,7,4244,29,268,66,1,364
GOMEZ PLATA,2019,3,ANTIOQUIA,1412,2655,132,34,10,7,4250,29,269,66,1,365
GOMEZ PLATA,2019,4,ANTIOQUIA,1416,2659,132,34,10,7,4258,28,270,66,1,365
GOMEZ PLATA,2019,5,ANTIOQUIA,1424,2666,133,34,10,7,4274,28,281,66,1,376
GOMEZ PLATA,2019,6,ANTIOQUIA,1434,2675,131,34,10,7,4291,27,280,66,1,374
GOMEZ PLATA,2019,7,ANTIOQUIA,1441,2677,131,33,10,7,4299,26,281,67,1,375
GOMEZ PLATA,2019,8,ANTIOQUIA,1444,2680,131,33,10,7,4305,26,281,67,1,375
GOMEZ PLATA,2019,9,ANTIOQUIA,1444,2688,131,34,10,7,4314,26,281,68,1,376
GOMEZ PLATA,2020,1,ANTIOQUIA,1453,2711,132,36,10,7,4349,27,284,68,1,380
GOMEZ PLATA,2020,10,ANTIOQUIA,1488,2767,136,50,10,7,4458,25,290,68,94,477
GOMEZ PLATA,2020,11,ANTIOQUIA,1488,2771,135,50,10,7,4461,25,291,68,94,478
GOMEZ PLATA,2020,12,ANTIOQUIA,1492,2779,135,50,10,7,4473,25,290,68,94,477
GOMEZ PLATA,2020,2,ANTIOQUIA,1455,2719,133,38,10,7,4362,25,284,68,94,471
GOMEZ PLATA,2020,3,ANTIOQUIA,1455,2728,135,38,10,7,4373,25,285,68,94,472
GOMEZ PLATA,2020,4,ANTIOQUIA,1460,2727,135,33,10,7,4372,25,285,68,94,472
GOMEZ PLATA,2020,5,ANTIOQUIA,1464,2736,136,33,10,7,4386,25,286,68,94,473
GOMEZ PLATA,2020,6,ANTIOQUIA,1466,2737,136,33,10,7,4389,25,285,68,94,472
GOMEZ PLATA,2020,7,ANTIOQUIA,1468,2740,137,33,10,7,4395,25,289,68,94,476
GOMEZ PLATA,2020,8,ANTIOQUIA,1478,2747,137,32,10,7,4411,25,290,69,94,478
GOMEZ PLATA,2020,9,ANTIOQUIA,1483,2752,136,37,10,7,4425,25,291,68,94,478
GOMEZ PLATA,2021,1,ANTIOQUIA,1499,2783,135,48,10,7,4482,25,290,68,94,477
GOMEZ PLATA,2021,10,ANTIOQUIA,1523,2834,136,52,10,7,4562,25,294,68,94,481
GOMEZ PLATA,2021,11,ANTIOQUIA,1525,2841,137,53,10,7,4573,26,294,68,94,482
GOMEZ PLATA,2021,12,ANTIOQUIA,1530,2845,137,55,10,7,4584,29,295,68,94,486
GOMEZ PLATA,2021,2,ANTIOQUIA,1505,2792,135,55,10,7,4504,25,290,68,94,477
GOMEZ PLATA,2021,3,ANTIOQUIA,1508,2802,135,55,10,7,4517,25,291,68,94,478
GOMEZ PLATA,2021,4,ANTIOQUIA,1517,2810,134,49,10,7,4527,26,291,68,94,479
GOMEZ PLATA,2021,5,ANTIOQUIA,1518,2813,134,52,10,7,4534,25,291,68,94,478
GOMEZ PLATA,2021,6,ANTIOQUIA,1518,2817,134,51,10,7,4537,25,291,68,94,478
GOMEZ PLATA,2021,7,ANTIOQUIA,1519,2822,134,51,10,7,4543,25,291,68,94,478
GOMEZ PLATA,2021,8,ANTIOQUIA,1519,2825,134,51,10,7,4546,25,291,68,94,478
GOMEZ PLATA,2021,9,ANTIOQUIA,1520,2832,137,51,10,7,4557,25,294,68,94,481
GOMEZ PLATA,2022,1,ANTIOQUIA,1531,2849,138,54,10,7,4589,32,294,68,94,488
GOMEZ PLATA,2022,10,ANTIOQUIA,1524,2893,135,47,9,7,4615,32,294,67,94,487
GOMEZ PLATA,2022,11,ANTIOQUIA,1528,2899,134,49,9,7,4626,31,295,67,94,487
GOMEZ PLATA,2022,12,ANTIOQUIA,1529,2907,135,50,9,7,4637,33,295,67,94,489
GOMEZ PLATA,2022,2,ANTIOQUIA,1532,2852,138,53,10,7,4592,33,294,68,94,489
GOMEZ PLATA,2022,3,ANTIOQUIA,1544,2865,138,49,10,7,4613,33,294,68,94,489
GOMEZ PLATA,2022,4,ANTIOQUIA,1549,2873,138,49,10,7,4626,34,295,68,94,491
GOMEZ PLATA,2022,5,ANTIOQUIA,1545,2883,139,48,10,7,4632,33,295,68,94,490
GOMEZ PLATA,2022,6,ANTIOQUIA,1545,2897,139,46,10,7,4644,33,295,68,94,490
GOMEZ PLATA,2022,7,ANTIOQUIA,1519,2878,136,45,8,7,4593,33,294,67,94,488
GOMEZ PLATA,2022,8,ANTIOQUIA,1523,2887,133,46,8,7,4604,33,294,67,94,488
GOMEZ PLATA,2022,9,ANTIOQUIA,1524,2888,135,45,8,7,4607,32,294,67,94,487
GOMEZ PLATA,2023,1,ANTIOQUIA,1530,2915,135,53,8,7,4648,33,297,67,94,491
GOMEZ PLATA,2023,2,ANTIOQUIA,1534,2924,136,50,8,7,4659,32,297,64,94,487
GOMEZ PLATA,2023,3,ANTIOQUIA,1537,2932,140,49,8,7,4673,36,299,67,94,496
GOMEZ PLATA,2023,4,ANTIOQUIA,1541,2938,140,51,8,7,4685,37,301,68,94,500
GOMEZ PLATA,2023,5,ANTIOQUIA,1545,2945,140,50,8,7,4695,38,300,68,94,500
GOMEZ PLATA,2023,6,ANTIOQUIA,1551,2954,140,51,8,7,4711,38,301,68,94,501
GOMEZ PLATA,2023,7,ANTIOQUIA,1558,2962,140,49,8,7,4724,39,301,68,94,502
GOMEZ PLATA,2023,8,ANTIOQUIA,1564,2967,142,52,8,7,4740,39,299,68,94,500
GOMEZ PLATA,2023,9,ANTIOQUIA,1563,2966,143,53,8,7,4740,39,298,68,94,499
GRANADA,2018,1,ANTIOQUIA,982,2603,1927,14,1,1,5528,12,236,87,5,340
GRANADA,2018,10,ANTIOQUIA,994,2667,1939,14,1,1,5616,13,238,87,5,343
GRANADA,2018,11,ANTIOQUIA,995,2669,1940,14,1,2,5621,13,238,87,5,343
GRANADA,2018,12,ANTIOQUIA,994,2675,1940,14,1,2,5626,13,238,87,5,343
GRANADA,2018,2,ANTIOQUIA,985,2630,1931,14,1,1,5562,12,237,87,5,341
GRANADA,2018,3,ANTIOQUIA,985,2633,1929,13,1,1,5562,12,236,87,5,340
GRANADA,2018,4,ANTIOQUIA,988,2639,1931,14,1,1,5574,12,237,87,5,341
GRANADA,2018,5,ANTIOQUIA,988,2631,1927,13,1,1,5561,12,236,87,5,340
GRANADA,2018,6,ANTIOQUIA,987,2637,1928,13,1,1,5567,12,238,87,5,342
GRANADA,2018,7,ANTIOQUIA,989,2645,1930,13,1,1,5579,12,239,87,5,343
GRANADA,2018,8,ANTIOQUIA,991,2654,1933,14,1,1,5594,13,238,87,5,343
GRANADA,2018,9,ANTIOQUIA,992,2658,1936,14,1,1,5602,13,238,87,5,343
GRANADA,2019,1,ANTIOQUIA,997,2681,1942,14,1,2,5637,13,239,87,5,344
GRANADA,2019,10,ANTIOQUIA,1006,2721,1951,18,3,2,5701,13,242,87,5,347
GRANADA,2019,11,ANTIOQUIA,1009,2725,1952,18,3,2,5709,13,242,87,5,347
GRANADA,2019,12,ANTIOQUIA,1011,2746,1952,18,3,2,5732,13,242,87,5,347
GRANADA,2019,2,ANTIOQUIA,1000,2687,1944,14,1,2,5648,13,239,87,5,344
GRANADA,2019,3,ANTIOQUIA,999,2690,1948,14,1,2,5654,13,240,87,5,345
GRANADA,2019,4,ANTIOQUIA,1000,2694,1949,17,1,2,5663,13,240,87,5,345
GRANADA,2019,5,ANTIOQUIA,1015,2733,1949,17,1,2,5717,13,240,87,5,345
GRANADA,2019,6,ANTIOQUIA,1002,2702,1947,17,1,2,5671,13,242,87,5,347
GRANADA,2019,7,ANTIOQUIA,1003,2705,1947,18,1,2,5676,13,243,87,5,348
GRANADA,2019,8,ANTIOQUIA,1004,2712,1949,18,1,2,5686,13,242,87,5,347
GRANADA,2019,9,ANTIOQUIA,1005,2719,1949,18,3,2,5696,13,242,87,5,347
GRANADA,2020,1,ANTIOQUIA,1010,2730,1951,19,3,2,5715,13,243,87,5,348
GRANADA,2020,10,ANTIOQUIA,1037,2808,1958,20,2,2,5827,15,246,87,66,414
GRANADA,2020,11,ANTIOQUIA,1044,2814,1959,20,2,2,5841,15,247,87,66,415
GRANADA,2020,12,ANTIOQUIA,1047,2830,1958,20,2,2,5859,15,249,87,66,417
GRANADA,2020,2,ANTIOQUIA,1008,2736,1951,19,3,2,5719,15,243,89,66,413
GRANADA,2020,3,ANTIOQUIA,1010,2737,1953,20,3,2,5725,15,243,89,66,413
GRANADA,2020,4,ANTIOQUIA,1014,2745,1949,19,2,2,5731,15,245,87,66,413
GRANADA,2020,5,ANTIOQUIA,1022,2763,1954,20,2,2,5763,15,245,87,66,413
GRANADA,2020,6,ANTIOQUIA,1023,2765,1953,20,2,2,5765,15,245,87,66,413
GRANADA,2020,7,ANTIOQUIA,1029,2772,1953,21,2,2,5779,15,245,87,66,413
GRANADA,2020,8,ANTIOQUIA,1029,2783,1954,21,2,2,5791,15,245,87,66,413
GRANADA,2020,9,ANTIOQUIA,1033,2797,1956,20,2,2,5810,15,245,87,66,413
GRANADA,2021,1,ANTIOQUIA,1052,2832,1959,20,2,2,5867,15,249,87,66,417
GRANADA,2021,10,ANTIOQUIA,1071,2913,1969,20,1,2,5976,15,254,87,66,422
GRANADA,2021,11,ANTIOQUIA,1073,2924,1971,21,1,2,5992,15,255,87,66,423
GRANADA,2021,12,ANTIOQUIA,1076,2928,1976,21,1,2,6004,15,255,87,66,423
GRANADA,2021,2,ANTIOQUIA,1055,2844,1962,19,2,2,5884,15,250,87,66,418
GRANADA,2021,3,ANTIOQUIA,1060,2865,1965,19,1,2,5912,14,251,87,66,418
GRANADA,2021,4,ANTIOQUIA,1063,2870,1967,19,1,2,5922,15,252,87,66,420
GRANADA,2021,5,ANTIOQUIA,1063,2879,1969,19,1,2,5933,16,253,87,66,422
GRANADA,2021,6,ANTIOQUIA,1065,2893,1968,19,1,2,5948,16,253,87,66,422
GRANADA,2021,7,ANTIOQUIA,1067,2903,1971,20,1,2,5964,16,253,87,66,422
GRANADA,2021,8,ANTIOQUIA,1068,2904,1972,21,1,2,5968,15,253,87,66,421
GRANADA,2021,9,ANTIOQUIA,1068,2907,1971,21,1,2,5970,15,253,87,66,421
GRANADA,2022,1,ANTIOQUIA,1077,2929,1976,21,1,2,6006,15,255,87,66,423
GRANADA,2022,10,ANTIOQUIA,1073,2959,1988,20,0,2,6042,14,259,89,66,428
GRANADA,2022,11,ANTIOQUIA,1077,2968,1988,20,0,2,6055,14,259,89,66,428
GRANADA,2022,12,ANTIOQUIA,1077,2974,1990,20,0,2,6063,14,259,89,66,428
GRANADA,2022,2,ANTIOQUIA,1079,2935,1979,19,1,2,6015,15,255,87,66,423
GRANADA,2022,3,ANTIOQUIA,1079,2943,1986,19,1,2,6030,13,254,89,66,422
GRANADA,2022,4,ANTIOQUIA,1083,2949,1984,20,1,2,6039,13,256,89,66,424
GRANADA,2022,5,ANTIOQUIA,1078,2959,1995,20,1,2,6055,13,257,89,66,425
GRANADA,2022,6,ANTIOQUIA,1086,2960,1992,20,1,2,6061,13,257,89,66,425
GRANADA,2022,7,ANTIOQUIA,1066,2926,1989,20,1,2,6004,13,258,89,66,426
GRANADA,2022,8,ANTIOQUIA,1070,2932,1990,20,0,2,6014,13,257,89,66,425
GRANADA,2022,9,ANTIOQUIA,1070,2947,1989,20,0,2,6028,14,258,89,66,427
GRANADA,2023,1,ANTIOQUIA,1078,2987,1990,20,0,2,6077,14,259,89,66,428
GRANADA,2023,2,ANTIOQUIA,1081,2995,1993,20,0,2,6091,14,259,89,66,428
GRANADA,2023,3,ANTIOQUIA,1085,3005,1993,22,0,2,6107,14,260,90,66,430
GRANADA,2023,4,ANTIOQUIA,1089,3015,1994,22,0,2,6122,13,261,90,66,430
GRANADA,2023,5,ANTIOQUIA,1092,3026,1997,23,0,2,6140,13,261,90,66,430
GRANADA,2023,6,ANTIOQUIA,1098,3046,1999,22,0,2,6167,13,262,90,66,431
GRANADA,2023,7,ANTIOQUIA,1101,3052,2001,22,0,2,6178,13,262,90,66,431
GRANADA,2023,8,ANTIOQUIA,1108,3063,1999,21,0,2,6193,13,262,90,66,431
GRANADA,2023,9,ANTIOQUIA,1114,3076,2000,21,0,1,6212,13,263,90,66,432
GUADALUPE,2018,1,ANTIOQUIA,679,1614,114,3,0,0,2410,44,152,79,2,277
GUADALUPE,2018,10,ANTIOQUIA,679,1628,115,3,0,0,2425,45,153,78,2,278
GUADALUPE,2018,11,ANTIOQUIA,678,1618,114,3,0,0,2413,44,153,78,2,277
GUADALUPE,2018,12,ANTIOQUIA,678,1618,114,3,0,0,2413,44,153,78,2,277
GUADALUPE,2018,2,ANTIOQUIA,678,1614,114,3,0,0,2409,45,152,79,2,278
GUADALUPE,2018,3,ANTIOQUIA,676,1611,114,4,0,0,2405,45,152,78,2,277
GUADALUPE,2018,4,ANTIOQUIA,678,1618,114,4,0,0,2414,45,152,79,2,278
GUADALUPE,2018,5,ANTIOQUIA,673,1608,113,4,0,0,2398,44,152,78,2,276
GUADALUPE,2018,6,ANTIOQUIA,674,1616,114,3,0,0,2407,44,152,78,2,276
GUADALUPE,2018,7,ANTIOQUIA,678,1616,115,3,0,0,2412,45,153,78,2,278
GUADALUPE,2018,8,ANTIOQUIA,679,1618,115,3,0,0,2415,45,153,78,2,278
GUADALUPE,2018,9,ANTIOQUIA,679,1618,115,3,0,0,2415,44,153,78,2,277
GUADALUPE,2019,1,ANTIOQUIA,679,1618,114,3,0,0,2414,44,153,78,2,277
GUADALUPE,2019,10,ANTIOQUIA,689,1628,114,4,0,0,2435,42,164,78,2,286
GUADALUPE,2019,11,ANTIOQUIA,690,1632,114,3,0,0,2439,42,165,78,2,287
GUADALUPE,2019,12,ANTIOQUIA,694,1634,114,3,0,0,2445,43,165,78,2,288
GUADALUPE,2019,2,ANTIOQUIA,679,1619,114,3,0,0,2415,44,153,78,2,277
GUADALUPE,2019,3,ANTIOQUIA,678,1619,114,3,0,0,2414,44,162,78,2,286
GUADALUPE,2019,4,ANTIOQUIA,678,1623,114,3,0,0,2418,44,161,78,2,285
GUADALUPE,2019,5,ANTIOQUIA,686,1627,114,3,0,0,2430,44,162,78,2,286
GUADALUPE,2019,6,ANTIOQUIA,685,1621,114,4,0,0,2424,44,162,78,2,286
GUADALUPE,2019,7,ANTIOQUIA,686,1621,114,5,0,0,2426,43,162,78,2,285
GUADALUPE,2019,8,ANTIOQUIA,688,1622,114,5,0,0,2429,44,162,78,2,286
GUADALUPE,2019,9,ANTIOQUIA,688,1625,114,5,0,0,2432,42,163,78,2,285
GUADALUPE,2020,1,ANTIOQUIA,691,1633,114,3,0,0,2441,42,165,78,2,287
GUADALUPE,2020,10,ANTIOQUIA,694,1643,114,18,0,0,2469,42,166,78,32,318
GUADALUPE,2020,11,ANTIOQUIA,697,1651,114,9,0,0,2471,42,166,78,32,318
GUADALUPE,2020,12,ANTIOQUIA,699,1656,114,10,0,0,2479,42,165,78,32,317
GUADALUPE,2020,2,ANTIOQUIA,686,1632,115,3,0,0,2436,42,165,79,32,318
GUADALUPE,2020,3,ANTIOQUIA,691,1636,115,4,0,0,2446,42,165,79,32,318
GUADALUPE,2020,4,ANTIOQUIA,687,1634,114,4,0,0,2439,42,166,78,32,318
GUADALUPE,2020,5,ANTIOQUIA,692,1637,114,4,0,0,2447,42,168,78,32,320
GUADALUPE,2020,6,ANTIOQUIA,693,1639,114,4,0,0,2450,42,166,80,32,320
GUADALUPE,2020,7,ANTIOQUIA,692,1641,114,4,0,0,2451,42,167,78,32,319
GUADALUPE,2020,8,ANTIOQUIA,693,1640,114,4,0,0,2451,42,166,78,32,318
GUADALUPE,2020,9,ANTIOQUIA,714,1683,114,16,0,0,2527,42,166,78,32,318
GUADALUPE,2021,1,ANTIOQUIA,702,1655,112,10,0,0,2479,42,166,78,32,318
GUADALUPE,2021,10,ANTIOQUIA,716,1663,108,10,0,0,2497,42,165,78,32,317
GUADALUPE,2021,11,ANTIOQUIA,716,1663,109,9,0,0,2497,42,165,78,32,317
GUADALUPE,2021,12,ANTIOQUIA,717,1669,109,9,0,0,2504,42,165,78,32,317
GUADALUPE,2021,2,ANTIOQUIA,704,1658,111,11,0,0,2484,42,165,78,32,317
GUADALUPE,2021,3,ANTIOQUIA,705,1658,111,11,0,0,2485,42,165,78,32,317
GUADALUPE,2021,4,ANTIOQUIA,711,1659,110,8,0,0,2488,42,167,78,32,319
GUADALUPE,2021,5,ANTIOQUIA,713,1659,110,8,0,0,2490,42,167,78,31,318
GUADALUPE,2021,6,ANTIOQUIA,713,1660,110,8,0,0,2491,42,166,78,32,318
GUADALUPE,2021,7,ANTIOQUIA,715,1660,109,9,0,0,2493,42,166,78,32,318
GUADALUPE,2021,8,ANTIOQUIA,714,1663,109,9,0,0,2495,42,166,78,32,318
GUADALUPE,2021,9,ANTIOQUIA,716,1661,109,9,0,0,2495,42,166,78,32,318
GUADALUPE,2022,1,ANTIOQUIA,718,1670,109,9,0,0,2506,42,165,78,32,317
GUADALUPE,2022,10,ANTIOQUIA,706,1676,109,6,0,0,2497,41,166,72,32,311
GUADALUPE,2022,11,ANTIOQUIA,706,1676,109,7,0,0,2498,40,167,72,32,311
GUADALUPE,2022,12,ANTIOQUIA,709,1679,109,10,0,0,2507,40,167,72,33,312
GUADALUPE,2022,2,ANTIOQUIA,718,1671,109,9,0,0,2507,42,165,78,32,317
GUADALUPE,2022,3,ANTIOQUIA,720,1673,109,9,0,0,2511,42,165,78,32,317
GUADALUPE,2022,4,ANTIOQUIA,719,1675,110,8,0,0,2512,42,165,78,32,317
GUADALUPE,2022,5,ANTIOQUIA,712,1678,110,7,0,0,2507,42,166,78,32,318
GUADALUPE,2022,6,ANTIOQUIA,717,1675,110,7,0,0,2509,42,165,77,32,316
GUADALUPE,2022,7,ANTIOQUIA,703,1666,110,7,0,0,2486,41,165,74,32,312
GUADALUPE,2022,8,ANTIOQUIA,704,1670,110,8,0,0,2492,41,165,73,32,311
GUADALUPE,2022,9,ANTIOQUIA,706,1670,110,7,0,0,2493,41,166,72,32,311
GUADALUPE,2023,1,ANTIOQUIA,711,1681,109,11,0,0,2512,40,167,72,33,312
GUADALUPE,2023,2,ANTIOQUIA,711,1692,109,9,0,0,2521,40,167,72,33,312
GUADALUPE,2023,3,ANTIOQUIA,711,1699,109,8,0,0,2527,40,167,72,33,312
GUADALUPE,2023,4,ANTIOQUIA,710,1701,108,9,0,0,2528,41,167,72,33,313
GUADALUPE,2023,5,ANTIOQUIA,663,1655,104,9,0,0,2431,36,160,68,33,297
GUADALUPE,2023,6,ANTIOQUIA,663,1660,104,9,0,0,2436,36,160,69,33,298
GUADALUPE,2023,7,ANTIOQUIA,665,1667,103,8,0,0,2443,36,160,69,33,298
GUADALUPE,2023,8,ANTIOQUIA,667,1667,104,10,0,0,2448,36,159,69,33,297
GUADALUPE,2023,9,ANTIOQUIA,665,1664,103,11,0,0,2443,37,158,69,33,297
GUARNE,2018,1,ANTIOQUIA,1868,7650,7173,832,220,7,17750,171,1229,128,25,1553
GUARNE,2018,10,ANTIOQUIA,2405,7865,7350,877,219,12,18728,183,1227,122,26,1558
GUARNE,2018,11,ANTIOQUIA,2439,7869,7346,874,218,12,18758,184,1227,120,26,1557
GUARNE,2018,12,ANTIOQUIA,2443,7920,7397,907,212,12,18891,187,1240,121,25,1573
GUARNE,2018,2,ANTIOQUIA,1875,7669,7173,829,222,7,17775,168,1224,127,25,1544
GUARNE,2018,3,ANTIOQUIA,1878,7705,7191,836,221,7,17838,167,1235,126,24,1552
GUARNE,2018,4,ANTIOQUIA,1878,7741,7202,838,221,7,17887,170,1233,127,24,1554
GUARNE,2018,5,ANTIOQUIA,1951,7751,7202,837,221,6,17968,171,1214,127,24,1536
GUARNE,2018,6,ANTIOQUIA,2029,7767,7213,836,221,6,18072,174,1214,126,24,1538
GUARNE,2018,7,ANTIOQUIA,2128,7775,7246,838,220,6,18213,174,1215,125,24,1538
GUARNE,2018,8,ANTIOQUIA,2297,7817,7261,841,219,12,18447,178,1219,124,25,1546
GUARNE,2018,9,ANTIOQUIA,2357,7834,7297,872,218,12,18590,180,1223,122,26,1551
GUARNE,2019,1,ANTIOQUIA,2481,7928,7410,909,212,12,18952,191,1245,120,25,1581
GUARNE,2019,10,ANTIOQUIA,2776,8292,7629,913,212,12,19834,200,1274,123,26,1623
GUARNE,2019,11,ANTIOQUIA,2796,8313,7648,916,212,12,19897,202,1278,123,26,1629
GUARNE,2019,12,ANTIOQUIA,2803,8353,7668,917,214,12,19967,202,1283,124,27,1636
GUARNE,2019,2,ANTIOQUIA,2483,7987,7426,888,213,12,19009,195,1246,120,25,1586
GUARNE,2019,3,ANTIOQUIA,2499,8004,7436,882,213,12,19046,198,1249,122,25,1594
GUARNE,2019,4,ANTIOQUIA,2590,8115,7454,902,211,12,19284,197,1255,123,25,1600
GUARNE,2019,5,ANTIOQUIA,2619,8152,7490,914,211,12,19398,198,1264,125,25,1612
GUARNE,2019,6,ANTIOQUIA,2662,8206,7509,919,210,12,19518,194,1261,125,25,1605
GUARNE,2019,7,ANTIOQUIA,2680,8215,7518,919,211,12,19555,194,1264,125,26,1609
GUARNE,2019,8,ANTIOQUIA,2695,8250,7527,917,211,12,19612,197,1269,124,26,1616
GUARNE,2019,9,ANTIOQUIA,2709,8259,7552,914,211,12,19657,199,1271,124,26,1620
GUARNE,2020,1,ANTIOQUIA,2810,8349,7674,933,213,12,19991,207,1284,125,28,1644
GUARNE,2020,10,ANTIOQUIA,2908,8636,7837,937,217,10,20545,217,1326,124,666,2333
GUARNE,2020,11,ANTIOQUIA,2924,8658,7853,938,218,10,20601,214,1326,124,665,2329
GUARNE,2020,12,ANTIOQUIA,2937,8706,7874,944,218,10,20689,220,1329,124,665,2338
GUARNE,2020,2,ANTIOQUIA,2815,8375,7688,955,213,12,20058,210,1301,135,666,2312
GUARNE,2020,3,ANTIOQUIA,2825,8395,7708,963,216,12,20119,207,1307,135,664,2313
GUARNE,2020,4,ANTIOQUIA,2833,8425,7732,929,214,11,20144,206,1315,125,666,2312
GUARNE,2020,5,ANTIOQUIA,2862,8460,7760,936,216,11,20245,196,1329,126,666,2317
GUARNE,2020,6,ANTIOQUIA,2857,8475,7756,935,215,11,20249,203,1321,125,666,2315
GUARNE,2020,7,ANTIOQUIA,2883,8510,7788,944,220,11,20356,203,1328,125,666,2322
GUARNE,2020,8,ANTIOQUIA,2885,8555,7796,938,218,11,20403,207,1319,125,667,2318
GUARNE,2020,9,ANTIOQUIA,2901,8582,7812,940,217,10,20462,213,1324,126,666,2329
GUARNE,2021,1,ANTIOQUIA,2946,8725,7879,951,218,10,20729,226,1331,124,666,2347
GUARNE,2021,10,ANTIOQUIA,3203,7912,8722,1438,458,44,21777,247,1358,120,667,2392
GUARNE,2021,11,ANTIOQUIA,3237,7964,8727,1419,449,43,21839,246,1356,121,667,2390
GUARNE,2021,12,ANTIOQUIA,3261,8032,8747,1399,437,41,21917,244,1358,121,667,2390
GUARNE,2021,2,ANTIOQUIA,2966,8751,7905,949,217,10,20798,232,1340,124,666,2362
GUARNE,2021,3,ANTIOQUIA,2989,8978,7924,946,219,10,21066,235,1342,124,666,2367
GUARNE,2021,4,ANTIOQUIA,3087,8484,8193,1087,272,11,21134,236,1344,123,665,2368
GUARNE,2021,5,ANTIOQUIA,2888,7861,8758,1278,391,24,21200,240,1345,123,665,2373
GUARNE,2021,6,ANTIOQUIA,2865,6749,9133,1772,685,59,21263,239,1345,123,665,2372
GUARNE,2021,7,ANTIOQUIA,2963,6970,9007,1694,631,58,21323,235,1347,123,664,2369
GUARNE,2021,8,ANTIOQUIA,3061,7450,8860,1554,551,49,21525,239,1355,123,664,2381
GUARNE,2021,9,ANTIOQUIA,3154,7735,8755,1479,490,45,21658,243,1358,122,665,2388
GUARNE,2022,1,ANTIOQUIA,3289,8081,8769,1385,428,42,21994,251,1360,121,666,2398
GUARNE,2022,10,ANTIOQUIA,3489,8397,9177,1353,369,36,22821,279,1376,124,668,2447
GUARNE,2022,11,ANTIOQUIA,3531,8442,9194,1358,367,36,22928,284,1379,124,670,2457
GUARNE,2022,12,ANTIOQUIA,3548,8460,9226,1360,363,36,22993,284,1380,124,671,2459
GUARNE,2022,2,ANTIOQUIA,3311,8130,8764,1376,405,41,22027,253,1361,121,666,2401
GUARNE,2022,3,ANTIOQUIA,3354,8182,8788,1362,399,41,22126,250,1366,125,666,2407
GUARNE,2022,4,ANTIOQUIA,3357,8242,8796,1356,390,41,22182,252,1364,125,665,2406
GUARNE,2022,5,ANTIOQUIA,3352,8309,8830,1356,386,40,22273,256,1366,126,665,2413
GUARNE,2022,6,ANTIOQUIA,3367,8368,8849,1354,384,40,22362,259,1368,125,665,2417
GUARNE,2022,7,ANTIOQUIA,3413,8406,8848,1355,382,39,22443,265,1372,124,664,2425
GUARNE,2022,8,ANTIOQUIA,3436,8462,8871,1348,379,39,22535,269,1366,124,665,2424
GUARNE,2022,9,ANTIOQUIA,3469,8324,9127,1349,375,38,22682,277,1372,124,668,2441
GUARNE,2023,1,ANTIOQUIA,3577,8507,9250,1364,364,36,23098,288,1380,124,672,2464
GUARNE,2023,2,ANTIOQUIA,3591,8553,9367,1373,362,36,23282,289,1386,124,672,2471
GUARNE,2023,3,ANTIOQUIA,3622,8639,9554,1395,361,36,23607,299,1438,124,674,2535
GUARNE,2023,4,ANTIOQUIA,3635,8684,9589,1395,361,36,23700,307,1442,124,674,2547
GUARNE,2023,5,ANTIOQUIA,3677,8758,9653,1399,360,36,23883,311,1444,124,676,2555
GUARNE,2023,6,ANTIOQUIA,3709,8837,9698,1402,360,36,24042,316,1448,123,677,2564
GUARNE,2023,7,ANTIOQUIA,3751,8880,9717,1405,360,37,24150,322,1449,124,683,2578
GUARNE,2023,8,ANTIOQUIA,3766,8909,9781,1401,359,37,24253,325,1455,124,683,2587
GUARNE,2023,9,ANTIOQUIA,3805,8960,9827,1388,358,37,24375,333,1463,125,683,2604
GUATAPE,2018,1,ANTIOQUIA,159,2404,725,119,21,23,3451,9,379,50,10,448
GUATAPE,2018,10,ANTIOQUIA,167,2462,744,120,21,24,3538,16,387,51,10,464
GUATAPE,2018,11,ANTIOQUIA,167,2467,746,121,21,24,3546,16,387,51,10,464
GUATAPE,2018,12,ANTIOQUIA,167,2464,760,121,21,24,3557,16,387,51,10,464
GUATAPE,2018,2,ANTIOQUIA,159,2405,728,119,21,23,3455,9,379,51,10,449
GUATAPE,2018,3,ANTIOQUIA,162,2414,729,119,21,23,3468,9,380,51,10,450
GUATAPE,2018,4,ANTIOQUIA,162,2426,734,119,21,23,3485,9,380,51,10,450
GUATAPE,2018,5,ANTIOQUIA,163,2429,735,119,21,24,3491,9,380,50,10,449
GUATAPE,2018,6,ANTIOQUIA,163,2432,737,119,21,24,3496,12,379,50,10,451
GUATAPE,2018,7,ANTIOQUIA,165,2436,739,119,21,24,3504,13,383,50,10,456
GUATAPE,2018,8,ANTIOQUIA,168,2441,741,119,21,24,3514,14,384,50,10,458
GUATAPE,2018,9,ANTIOQUIA,168,2444,742,119,21,24,3518,13,383,50,10,456
GUATAPE,2019,1,ANTIOQUIA,142,1478,1719,170,21,24,3554,16,386,51,10,463
GUATAPE,2019,10,ANTIOQUIA,120,1347,1873,228,21,24,3613,17,423,52,10,502
GUATAPE,2019,11,ANTIOQUIA,120,1348,1873,228,21,24,3614,17,422,52,10,501
GUATAPE,2019,12,ANTIOQUIA,121,1349,1881,230,21,24,3626,17,423,52,10,502
GUATAPE,2019,2,ANTIOQUIA,140,1409,1791,176,21,24,3561,16,385,51,10,462
GUATAPE,2019,3,ANTIOQUIA,141,1344,1846,195,21,24,3571,16,386,51,10,463
GUATAPE,2019,4,ANTIOQUIA,141,1345,1843,194,21,24,3568,16,387,51,10,464
GUATAPE,2019,5,ANTIOQUIA,122,1343,1857,226,21,24,3593,15,391,51,10,467
GUATAPE,2019,6,ANTIOQUIA,120,1342,1857,226,21,24,3590,16,391,51,10,468
GUATAPE,2019,7,ANTIOQUIA,120,1345,1859,227,21,24,3596,17,391,51,10,469
GUATAPE,2019,8,ANTIOQUIA,120,1345,1862,227,21,24,3599,17,391,51,10,469
GUATAPE,2019,9,ANTIOQUIA,120,1346,1865,228,21,24,3604,17,423,53,9,502
GUATAPE,2020,1,ANTIOQUIA,121,1349,1893,232,21,24,3640,17,426,66,10,519
GUATAPE,2020,10,ANTIOQUIA,122,1363,1910,240,21,24,3680,16,452,67,112,647
GUATAPE,2020,11,ANTIOQUIA,126,1447,1916,248,21,24,3782,16,455,67,112,650
GUATAPE,2020,12,ANTIOQUIA,127,1454,1918,253,21,24,3797,17,453,67,114,651
GUATAPE,2020,2,ANTIOQUIA,121,1348,1894,233,21,24,3641,17,428,73,113,631
GUATAPE,2020,3,ANTIOQUIA,121,1351,1895,233,21,24,3645,17,430,73,113,633
GUATAPE,2020,4,ANTIOQUIA,122,1351,1895,230,21,24,3643,17,437,66,113,633
GUATAPE,2020,5,ANTIOQUIA,122,1353,1899,231,21,24,3650,18,438,66,113,635
GUATAPE,2020,6,ANTIOQUIA,122,1353,1897,233,21,24,3650,17,439,66,113,635
GUATAPE,2020,7,ANTIOQUIA,122,1355,1900,235,21,24,3657,18,440,66,113,637
GUATAPE,2020,8,ANTIOQUIA,122,1357,1902,232,21,24,3658,16,447,66,112,641
GUATAPE,2020,9,ANTIOQUIA,122,1361,1906,234,21,24,3668,16,447,67,112,642
GUATAPE,2021,1,ANTIOQUIA,127,1460,1925,253,21,24,3810,16,455,67,112,650
GUATAPE,2021,10,ANTIOQUIA,128,1489,1972,272,21,24,3906,26,488,55,113,682
GUATAPE,2021,11,ANTIOQUIA,128,1493,1985,269,21,24,3920,27,487,56,113,683
GUATAPE,2021,12,ANTIOQUIA,128,1493,1992,275,21,24,3933,28,485,56,115,684
GUATAPE,2021,2,ANTIOQUIA,127,1469,1924,257,21,24,3822,15,470,54,112,651
GUATAPE,2021,3,ANTIOQUIA,128,1476,1929,264,20,24,3841,15,471,54,112,652
GUATAPE,2021,4,ANTIOQUIA,128,1476,1930,261,20,24,3839,15,481,54,112,662
GUATAPE,2021,5,ANTIOQUIA,128,1481,1934,262,20,24,3849,18,484,54,112,668
GUATAPE,2021,6,ANTIOQUIA,128,1482,1952,259,20,24,3865,17,486,54,112,669
GUATAPE,2021,7,ANTIOQUIA,128,1481,1952,262,22,24,3869,17,486,54,114,671
GUATAPE,2021,8,ANTIOQUIA,128,1483,1965,264,22,24,3886,18,485,54,115,672
GUATAPE,2021,9,ANTIOQUIA,128,1485,1969,266,21,24,3893,21,486,54,115,676
GUATAPE,2022,1,ANTIOQUIA,128,1493,1991,275,21,24,3932,29,488,55,113,685
GUATAPE,2022,10,ANTIOQUIA,128,1581,2081,286,20,24,4120,37,501,54,113,705
GUATAPE,2022,11,ANTIOQUIA,128,1586,2087,290,20,24,4135,34,503,54,113,704
GUATAPE,2022,12,ANTIOQUIA,128,1588,2090,298,20,24,4148,36,504,53,113,706
GUATAPE,2022,2,ANTIOQUIA,128,1495,1996,276,21,24,3940,29,489,55,113,686
GUATAPE,2022,3,ANTIOQUIA,128,1501,2002,278,21,24,3954,32,491,55,113,691
GUATAPE,2022,4,ANTIOQUIA,129,1506,2023,277,21,24,3980,32,489,55,113,689
GUATAPE,2022,5,ANTIOQUIA,129,1516,2031,275,20,24,3995,35,493,55,113,696
GUATAPE,2022,6,ANTIOQUIA,129,1522,2040,281,20,24,4016,35,497,55,113,700
GUATAPE,2022,7,ANTIOQUIA,127,1521,2052,284,20,24,4028,36,500,54,113,703
GUATAPE,2022,8,ANTIOQUIA,128,1576,2071,287,20,24,4106,37,498,54,113,702
GUATAPE,2022,9,ANTIOQUIA,128,1578,2078,285,20,24,4113,38,500,54,113,705
GUATAPE,2023,1,ANTIOQUIA,128,1589,2093,300,20,24,4154,34,506,53,113,706
GUATAPE,2023,2,ANTIOQUIA,128,1596,2092,299,20,24,4159,32,505,53,113,703
GUATAPE,2023,3,ANTIOQUIA,128,1602,2115,307,20,24,4196,35,506,53,113,707
GUATAPE,2023,4,ANTIOQUIA,131,1612,2120,304,20,24,4211,35,508,53,113,709
GUATAPE,2023,5,ANTIOQUIA,131,1620,2133,310,20,24,4238,38,510,53,113,714
GUATAPE,2023,6,ANTIOQUIA,131,1631,2144,306,20,24,4256,38,511,53,113,715
GUATAPE,2023,7,ANTIOQUIA,131,1640,2148,307,21,24,4271,38,511,53,113,715
GUATAPE,2023,8,ANTIOQUIA,131,1648,2168,308,21,24,4300,36,511,53,113,713
GUATAPE,2023,9,ANTIOQUIA,131,1649,2177,313,21,24,4315,38,514,53,113,718
HELICONIA,2018,1,ANTIOQUIA,712,1660,193,21,6,2,2594,24,106,44,5,179
HELICONIA,2018,10,ANTIOQUIA,716,1685,195,21,6,1,2624,26,109,44,6,185
HELICONIA,2018,11,ANTIOQUIA,715,1685,195,21,6,1,2623,26,109,44,5,184
HELICONIA,2018,12,ANTIOQUIA,717,1687,194,21,6,1,2626,26,109,44,5,184
HELICONIA,2018,2,ANTIOQUIA,712,1666,194,21,6,2,2601,24,106,44,5,179
HELICONIA,2018,3,ANTIOQUIA,710,1667,194,21,6,2,2600,24,106,44,5,179
HELICONIA,2018,4,ANTIOQUIA,711,1671,194,21,6,2,2605,24,106,44,5,179
HELICONIA,2018,5,ANTIOQUIA,708,1671,194,21,6,1,2601,25,107,44,5,181
HELICONIA,2018,6,ANTIOQUIA,709,1676,194,21,6,1,2607,25,107,44,5,181
HELICONIA,2018,7,ANTIOQUIA,711,1678,194,21,6,1,2611,26,107,44,5,182
HELICONIA,2018,8,ANTIOQUIA,714,1678,194,21,6,1,2614,26,107,44,5,182
HELICONIA,2018,9,ANTIOQUIA,715,1680,194,21,6,1,2617,26,107,44,5,182
HELICONIA,2019,1,ANTIOQUIA,718,1691,194,21,6,1,2631,26,109,44,5,184
HELICONIA,2019,10,ANTIOQUIA,732,1710,191,22,6,1,2662,33,107,46,5,191
HELICONIA,2019,11,ANTIOQUIA,734,1710,190,21,6,1,2662,33,107,46,5,191
HELICONIA,2019,12,ANTIOQUIA,736,1717,190,22,6,1,2672,33,107,46,5,191
HELICONIA,2019,2,ANTIOQUIA,717,1694,194,22,6,1,2634,26,109,45,5,185
HELICONIA,2019,3,ANTIOQUIA,719,1697,194,22,6,1,2639,27,109,44,5,185
HELICONIA,2019,4,ANTIOQUIA,723,1702,194,22,6,1,2648,27,109,44,5,185
HELICONIA,2019,5,ANTIOQUIA,725,1702,194,22,6,1,2650,27,109,44,5,185
HELICONIA,2019,6,ANTIOQUIA,728,1701,192,22,6,1,2650,31,108,44,5,188
HELICONIA,2019,7,ANTIOQUIA,729,1704,191,22,6,1,2653,32,108,45,5,190
HELICONIA,2019,8,ANTIOQUIA,731,1703,190,22,6,1,2653,33,108,45,5,191
HELICONIA,2019,9,ANTIOQUIA,733,1705,189,22,6,1,2656,33,107,46,5,191
HELICONIA,2020,1,ANTIOQUIA,736,1714,189,24,6,1,2670,33,107,46,5,191
HELICONIA,2020,10,ANTIOQUIA,741,1729,188,22,5,1,2686,35,112,46,52,245
HELICONIA,2020,11,ANTIOQUIA,745,1731,188,22,5,1,2692,34,114,46,52,246
HELICONIA,2020,12,ANTIOQUIA,748,1732,188,22,5,1,2696,34,115,46,52,247
HELICONIA,2020,2,ANTIOQUIA,737,1714,189,25,6,1,2672,34,107,48,52,241
HELICONIA,2020,3,ANTIOQUIA,737,1715,189,25,6,1,2673,34,107,48,52,241
HELICONIA,2020,4,ANTIOQUIA,737,1715,189,24,6,1,2672,34,109,46,52,241
HELICONIA,2020,5,ANTIOQUIA,739,1715,189,24,6,1,2674,34,109,46,52,241
HELICONIA,2020,6,ANTIOQUIA,742,1719,189,23,6,1,2680,34,109,46,52,241
HELICONIA,2020,7,ANTIOQUIA,741,1720,189,23,6,1,2680,34,109,46,52,241
HELICONIA,2020,8,ANTIOQUIA,743,1724,189,23,5,1,2685,34,109,46,52,241
HELICONIA,2020,9,ANTIOQUIA,741,1724,189,22,5,1,2682,34,109,47,52,242
HELICONIA,2021,1,ANTIOQUIA,746,1735,186,22,5,1,2695,34,115,46,52,247
HELICONIA,2021,10,ANTIOQUIA,750,1756,188,23,5,1,2723,34,120,46,52,252
HELICONIA,2021,11,ANTIOQUIA,751,1762,187,23,5,1,2729,33,120,46,52,251
HELICONIA,2021,12,ANTIOQUIA,755,1763,187,23,5,1,2734,33,122,46,52,253
HELICONIA,2021,2,ANTIOQUIA,744,1742,186,22,5,1,2700,34,116,46,52,248
HELICONIA,2021,3,ANTIOQUIA,745,1743,186,22,5,1,2702,34,119,46,52,251
HELICONIA,2021,4,ANTIOQUIA,746,1747,186,22,5,1,2707,34,119,46,52,251
HELICONIA,2021,5,ANTIOQUIA,745,1748,186,22,5,1,2707,34,119,46,52,251
HELICONIA,2021,6,ANTIOQUIA,746,1747,186,22,5,1,2707,34,119,46,52,251
HELICONIA,2021,7,ANTIOQUIA,746,1749,186,22,5,1,2709,34,118,46,52,250
HELICONIA,2021,8,ANTIOQUIA,748,1752,187,22,5,1,2715,34,118,46,52,250
HELICONIA,2021,9,ANTIOQUIA,750,1754,187,23,5,1,2720,34,118,46,52,250
HELICONIA,2022,1,ANTIOQUIA,756,1768,186,23,5,1,2739,33,122,46,52,253
HELICONIA,2022,10,ANTIOQUIA,762,1783,183,27,5,1,2761,32,124,47,52,255
HELICONIA,2022,11,ANTIOQUIA,761,1786,183,27,5,1,2763,32,124,47,52,255
HELICONIA,2022,12,ANTIOQUIA,763,1785,183,27,5,1,2764,32,124,47,53,256
HELICONIA,2022,2,ANTIOQUIA,757,1771,186,23,5,1,2743,33,123,46,52,254
HELICONIA,2022,3,ANTIOQUIA,762,1771,186,24,5,1,2749,33,124,47,51,255
HELICONIA,2022,4,ANTIOQUIA,759,1777,186,24,5,1,2752,33,124,47,51,255
HELICONIA,2022,5,ANTIOQUIA,759,1776,186,24,5,1,2751,33,124,47,51,255
HELICONIA,2022,6,ANTIOQUIA,762,1780,186,25,5,1,2759,33,124,47,52,256
HELICONIA,2022,7,ANTIOQUIA,763,1783,186,25,5,1,2763,33,124,47,52,256
HELICONIA,2022,8,ANTIOQUIA,759,1780,183,25,5,1,2753,33,124,47,52,256
HELICONIA,2022,9,ANTIOQUIA,761,1780,183,26,5,1,2756,32,124,47,52,255
HELICONIA,2023,1,ANTIOQUIA,763,1787,183,27,5,1,2766,32,124,47,53,256
HELICONIA,2023,2,ANTIOQUIA,760,1789,183,29,5,1,2767,32,124,47,54,257
HELICONIA,2023,3,ANTIOQUIA,768,1791,183,29,5,1,2777,32,124,47,54,257
HELICONIA,2023,4,ANTIOQUIA,770,1796,184,29,5,1,2785,32,124,47,54,257
HELICONIA,2023,5,ANTIOQUIA,769,1798,184,29,5,1,2786,32,123,47,54,256
HELICONIA,2023,6,ANTIOQUIA,771,1798,183,29,5,1,2787,32,125,47,54,258
HELICONIA,2023,7,ANTIOQUIA,771,1808,184,30,5,1,2799,32,125,47,54,258
HELICONIA,2023,8,ANTIOQUIA,764,1805,183,30,5,1,2788,31,125,47,54,257
HELICONIA,2023,9,ANTIOQUIA,770,1805,183,29,5,1,2793,32,125,47,54,258
HISPANIA,2018,1,ANTIOQUIA,291,1246,392,19,1,0,1949,41,164,38,4,247
HISPANIA,2018,10,ANTIOQUIA,295,1263,410,17,1,0,1986,44,166,38,4,252
HISPANIA,2018,11,ANTIOQUIA,294,1265,410,19,1,0,1989,45,166,38,4,253
HISPANIA,2018,12,ANTIOQUIA,297,1270,406,19,1,0,1993,45,166,38,4,253
HISPANIA,2018,2,ANTIOQUIA,291,1246,394,20,1,0,1952,41,164,38,4,247
HISPANIA,2018,3,ANTIOQUIA,291,1247,395,20,1,0,1954,43,165,38,4,250
HISPANIA,2018,4,ANTIOQUIA,291,1249,395,20,1,0,1956,44,165,38,4,251
HISPANIA,2018,5,ANTIOQUIA,293,1251,396,20,1,0,1961,44,165,38,4,251
HISPANIA,2018,6,ANTIOQUIA,293,1251,396,20,1,0,1961,44,167,38,4,253
HISPANIA,2018,7,ANTIOQUIA,293,1254,399,20,1,0,1967,45,168,38,4,255
HISPANIA,2018,8,ANTIOQUIA,293,1258,403,19,1,0,1974,45,167,38,4,254
HISPANIA,2018,9,ANTIOQUIA,293,1260,408,18,1,0,1980,44,167,38,4,253
HISPANIA,2019,1,ANTIOQUIA,298,1271,407,19,1,0,1996,45,166,38,4,253
HISPANIA,2019,10,ANTIOQUIA,300,1282,418,16,1,0,2017,43,171,38,4,256
HISPANIA,2019,11,ANTIOQUIA,300,1283,418,16,1,0,2018,43,170,38,4,255
HISPANIA,2019,12,ANTIOQUIA,302,1286,421,16,1,0,2026,43,171,38,4,256
HISPANIA,2019,2,ANTIOQUIA,298,1271,408,19,1,0,1997,45,166,38,4,253
HISPANIA,2019,3,ANTIOQUIA,298,1273,409,19,1,0,2000,44,167,38,4,253
HISPANIA,2019,4,ANTIOQUIA,299,1275,412,16,1,0,2003,44,167,38,4,253
HISPANIA,2019,5,ANTIOQUIA,299,1276,416,17,1,0,2009,44,167,38,4,253
HISPANIA,2019,6,ANTIOQUIA,299,1276,415,16,1,0,2007,44,168,38,4,254
HISPANIA,2019,7,ANTIOQUIA,299,1278,416,16,1,0,2010,44,167,38,4,253
HISPANIA,2019,8,ANTIOQUIA,299,1280,416,16,1,0,2012,43,171,38,4,256
HISPANIA,2019,9,ANTIOQUIA,299,1281,417,16,1,0,2014,43,171,38,4,256
HISPANIA,2020,1,ANTIOQUIA,301,1285,421,17,1,0,2025,43,171,38,4,256
HISPANIA,2020,10,ANTIOQUIA,294,1267,437,17,1,0,2016,34,173,38,29,274
HISPANIA,2020,11,ANTIOQUIA,294,1270,437,17,1,0,2019,34,173,38,29,274
HISPANIA,2020,12,ANTIOQUIA,295,1268,437,17,1,0,2018,34,173,38,29,274
HISPANIA,2020,2,ANTIOQUIA,301,1285,421,20,1,0,2028,45,172,39,28,284
HISPANIA,2020,3,ANTIOQUIA,301,1285,422,20,1,0,2029,46,172,39,28,285
HISPANIA,2020,4,ANTIOQUIA,304,1286,423,16,1,0,2030,46,173,38,28,285
HISPANIA,2020,5,ANTIOQUIA,305,1286,423,16,1,0,2031,46,173,38,28,285
HISPANIA,2020,6,ANTIOQUIA,305,1285,423,16,1,0,2030,46,173,39,28,286
HISPANIA,2020,7,ANTIOQUIA,305,1285,424,16,1,0,2031,46,174,39,28,287
HISPANIA,2020,8,ANTIOQUIA,305,1294,430,16,1,0,2046,46,172,39,28,285
HISPANIA,2020,9,ANTIOQUIA,297,1266,437,17,1,0,2018,35,173,38,29,275
HISPANIA,2021,1,ANTIOQUIA,295,1268,436,16,1,0,2016,35,173,38,29,275
HISPANIA,2021,10,ANTIOQUIA,301,1274,444,17,1,0,2037,34,173,38,29,274
HISPANIA,2021,11,ANTIOQUIA,301,1278,444,17,1,0,2041,34,174,38,29,275
HISPANIA,2021,12,ANTIOQUIA,301,1284,444,37,1,0,2067,34,177,38,29,278
HISPANIA,2021,2,ANTIOQUIA,296,1268,437,16,1,0,2018,34,174,38,29,275
HISPANIA,2021,3,ANTIOQUIA,296,1269,437,17,1,0,2020,33,174,38,29,274
HISPANIA,2021,4,ANTIOQUIA,296,1269,436,17,1,0,2019,33,174,38,29,274
HISPANIA,2021,5,ANTIOQUIA,301,1269,436,17,1,0,2024,33,175,38,29,275
HISPANIA,2021,6,ANTIOQUIA,301,1270,436,17,1,0,2025,33,175,38,29,275
HISPANIA,2021,7,ANTIOQUIA,301,1272,440,17,1,0,2031,33,175,38,29,275
HISPANIA,2021,8,ANTIOQUIA,301,1272,442,17,1,0,2033,34,173,38,29,274
HISPANIA,2021,9,ANTIOQUIA,301,1272,442,17,1,0,2033,34,174,38,29,275
HISPANIA,2022,1,ANTIOQUIA,301,1285,448,38,1,0,2073,34,177,38,29,278
HISPANIA,2022,10,ANTIOQUIA,302,1292,456,36,1,0,2087,33,182,38,27,280
HISPANIA,2022,11,ANTIOQUIA,302,1293,456,36,1,0,2088,32,182,38,27,279
HISPANIA,2022,12,ANTIOQUIA,302,1294,458,35,1,0,2090,32,182,38,27,279
HISPANIA,2022,2,ANTIOQUIA,301,1286,448,38,1,0,2074,33,177,38,29,277
HISPANIA,2022,3,ANTIOQUIA,301,1295,450,38,1,0,2085,32,180,39,28,279
HISPANIA,2022,4,ANTIOQUIA,301,1296,451,37,1,0,2086,32,181,39,28,280
HISPANIA,2022,5,ANTIOQUIA,301,1300,452,37,1,0,2091,32,181,39,28,280
HISPANIA,2022,6,ANTIOQUIA,304,1301,453,37,1,0,2096,32,183,39,28,282
HISPANIA,2022,7,ANTIOQUIA,305,1300,454,36,1,0,2096,32,183,38,28,281
HISPANIA,2022,8,ANTIOQUIA,302,1291,453,36,1,0,2083,32,182,38,28,280
HISPANIA,2022,9,ANTIOQUIA,302,1291,453,36,1,0,2083,32,182,38,28,280
HISPANIA,2023,1,ANTIOQUIA,302,1304,459,35,1,0,2101,32,182,38,27,279
HISPANIA,2023,2,ANTIOQUIA,303,1306,459,35,1,0,2104,32,182,38,27,279
HISPANIA,2023,3,ANTIOQUIA,303,1309,459,35,1,0,2107,32,182,38,27,279
HISPANIA,2023,4,ANTIOQUIA,303,1315,477,16,1,0,2112,32,183,38,27,280
HISPANIA,2023,5,ANTIOQUIA,303,1324,478,16,1,0,2122,31,183,39,27,280
HISPANIA,2023,6,ANTIOQUIA,303,1329,480,16,1,0,2129,31,185,39,27,282
HISPANIA,2023,7,ANTIOQUIA,303,1329,480,16,1,0,2129,30,185,39,27,281
HISPANIA,2023,8,ANTIOQUIA,304,1331,480,16,1,0,2132,31,185,39,27,282
HISPANIA,2023,9,ANTIOQUIA,303,1337,480,17,1,0,2138,33,184,39,27,283
ITAGUI,2018,1,ANTIOQUIA,6497,31926,42826,4303,0,0,85552,1757,7673,165,115,9710
ITAGUI,2018,10,ANTIOQUIA,6639,32551,43407,4947,0,3,87547,1781,7914,168,123,9986
ITAGUI,2018,11,ANTIOQUIA,6650,32564,43499,4946,0,2,87661,1778,7958,168,123,10027
ITAGUI,2018,12,ANTIOQUIA,6660,32619,43416,4949,0,0,87644,1772,7910,169,123,9974
ITAGUI,2018,2,ANTIOQUIA,6505,31961,42847,4393,0,0,85706,1746,7708,165,119,9738
ITAGUI,2018,3,ANTIOQUIA,6530,31996,42942,4389,0,0,85857,1744,7730,166,120,9760
ITAGUI,2018,4,ANTIOQUIA,6555,32064,43043,4397,0,0,86059,1758,7842,167,123,9890
ITAGUI,2018,5,ANTIOQUIA,6563,32014,43129,4523,0,0,86229,1759,7830,166,124,9879
ITAGUI,2018,6,ANTIOQUIA,6573,32076,43183,4651,0,0,86483,1756,7837,169,123,9885
ITAGUI,2018,7,ANTIOQUIA,6584,32206,43218,4727,0,0,86735,1764,7850,170,124,9908
ITAGUI,2018,8,ANTIOQUIA,6603,32286,43303,4816,0,3,87011,1771,7910,171,123,9975
ITAGUI,2018,9,ANTIOQUIA,6623,32465,43303,4816,0,3,87210,1777,7902,168,124,9971
ITAGUI,2019,1,ANTIOQUIA,6680,32663,43629,4968,0,0,87940,1765,7962,167,122,10016
ITAGUI,2019,10,ANTIOQUIA,6879,33609,45509,5476,0,0,91473,1870,8231,164,128,10393
ITAGUI,2019,11,ANTIOQUIA,6892,33653,45576,5477,0,0,91598,1873,8245,164,127,10409
ITAGUI,2019,12,ANTIOQUIA,6924,33795,45721,5488,0,0,91928,1879,8255,164,127,10425
ITAGUI,2019,2,ANTIOQUIA,6707,32719,44154,4956,0,0,88536,1765,7958,165,123,10011
ITAGUI,2019,3,ANTIOQUIA,6716,32765,44312,5023,0,0,88816,1773,7971,165,123,10032
ITAGUI,2019,4,ANTIOQUIA,6751,32920,44376,5024,0,0,89071,1778,8142,164,124,10208
ITAGUI,2019,5,ANTIOQUIA,6769,33275,44442,5088,0,0,89574,1857,8190,164,131,10342
ITAGUI,2019,6,ANTIOQUIA,6799,33319,44626,5089,0,0,89833,1862,8183,164,130,10339
ITAGUI,2019,7,ANTIOQUIA,6815,33392,44703,5237,0,0,90147,1854,8184,164,129,10331
ITAGUI,2019,8,ANTIOQUIA,6823,33480,44924,5342,0,0,90569,1862,8227,164,129,10382
ITAGUI,2019,9,ANTIOQUIA,6839,33538,45298,5342,0,0,91017,1869,8225,165,128,10387
ITAGUI,2020,1,ANTIOQUIA,6946,33566,46207,5640,0,0,92359,1872,8260,163,129,10424
ITAGUI,2020,10,ANTIOQUIA,7090,33596,48699,5625,160,0,95170,1948,8413,173,1582,12116
ITAGUI,2020,11,ANTIOQUIA,7097,33631,48747,5622,160,0,95257,1925,8448,175,1590,12138
ITAGUI,2020,12,ANTIOQUIA,7122,33718,48807,5634,160,0,95441,1942,8460,177,1590,12169
ITAGUI,2020,2,ANTIOQUIA,6967,33609,46102,5746,160,1,92585,1887,8310,225,1589,12011
ITAGUI,2020,3,ANTIOQUIA,6988,33655,46126,5749,160,1,92679,1880,8337,225,1589,12031
ITAGUI,2020,4,ANTIOQUIA,7004,33148,47304,5428,160,1,93045,1925,8366,165,1589,12045
ITAGUI,2020,5,ANTIOQUIA,7009,33181,47932,5431,77,1,93631,1784,8468,172,1582,12006
ITAGUI,2020,6,ANTIOQUIA,7019,33201,47812,5426,160,1,93619,1946,8385,169,1585,12085
ITAGUI,2020,7,ANTIOQUIA,7031,33315,48096,5429,160,1,94032,1953,8395,173,1585,12106
ITAGUI,2020,8,ANTIOQUIA,7055,33347,48291,5602,160,1,94456,1942,8389,173,1580,12084
ITAGUI,2020,9,ANTIOQUIA,7064,33370,48649,5491,160,0,94734,1944,8396,173,1577,12090
ITAGUI,2021,1,ANTIOQUIA,7123,33764,48832,5710,160,0,95589,1945,8462,177,1591,12175
ITAGUI,2021,10,ANTIOQUIA,7204,34231,49602,5817,160,0,97014,1933,8546,185,1590,12254
ITAGUI,2021,11,ANTIOQUIA,7214,34272,49694,5814,160,0,97154,1934,8555,185,1591,12265
ITAGUI,2021,12,ANTIOQUIA,7228,34351,49740,5816,160,0,97295,1936,8554,185,1591,12266
ITAGUI,2021,2,ANTIOQUIA,7133,33806,48882,5705,160,0,95686,1941,8483,182,1589,12195
ITAGUI,2021,3,ANTIOQUIA,7135,33858,48936,5705,160,0,95794,1942,8487,183,1588,12200
ITAGUI,2021,4,ANTIOQUIA,7138,33894,48995,5703,160,0,95890,1945,8504,185,1587,12221
ITAGUI,2021,5,ANTIOQUIA,7145,33940,49124,5807,160,0,96176,1946,8509,185,1588,12228
ITAGUI,2021,6,ANTIOQUIA,7150,33969,49147,5806,160,0,96232,1937,8516,184,1590,12227
ITAGUI,2021,7,ANTIOQUIA,7164,34030,49389,5805,160,0,96548,1934,8530,184,1588,12236
ITAGUI,2021,8,ANTIOQUIA,7177,34095,49445,5810,160,0,96687,1938,8537,184,1587,12246
ITAGUI,2021,9,ANTIOQUIA,7191,34171,49526,5815,160,0,96863,1935,8541,184,1588,12248
ITAGUI,2022,1,ANTIOQUIA,7233,34410,49835,5817,160,0,97455,1936,8561,186,1590,12273
ITAGUI,2022,10,ANTIOQUIA,7259,35001,50807,6730,160,0,99957,1968,8627,203,1593,12391
ITAGUI,2022,11,ANTIOQUIA,7281,35081,50842,6857,160,0,100221,1970,8632,206,1592,12400
ITAGUI,2022,12,ANTIOQUIA,7316,35156,50865,6864,160,0,100361,1971,8645,207,1591,12414
ITAGUI,2022,2,ANTIOQUIA,7246,34488,50117,5829,160,0,97840,1938,8570,189,1590,12287
ITAGUI,2022,3,ANTIOQUIA,7257,34553,50118,6168,160,0,98256,1944,8573,191,1589,12297
ITAGUI,2022,4,ANTIOQUIA,7183,34667,50178,6166,160,0,98354,1950,8580,192,1589,12311
ITAGUI,2022,5,ANTIOQUIA,7136,34775,50420,6170,160,0,98661,1957,8586,194,1588,12325
ITAGUI,2022,6,ANTIOQUIA,7148,34663,50642,6356,160,0,98969,1957,8598,195,1588,12338
ITAGUI,2022,7,ANTIOQUIA,7213,34677,50552,6729,160,0,99331,1952,8603,195,1588,12338
ITAGUI,2022,8,ANTIOQUIA,7226,34776,50647,6729,160,0,99538,1955,8598,201,1588,12342
ITAGUI,2022,9,ANTIOQUIA,7245,34925,50754,6729,160,0,99813,1965,8620,203,1590,12378
ITAGUI,2023,1,ANTIOQUIA,7361,35236,50902,6865,160,0,100524,1975,8654,207,1591,12427
ITAGUI,2023,2,ANTIOQUIA,7401,35340,50995,6866,160,0,100762,1974,8665,205,1594,12438
ITAGUI,2023,3,ANTIOQUIA,7434,35500,51055,6865,160,0,101014,1969,8678,205,1593,12445
ITAGUI,2023,4,ANTIOQUIA,7462,35598,51120,6864,160,0,101204,1989,8694,206,1593,12482
ITAGUI,2023,5,ANTIOQUIA,7548,35692,51321,6965,160,0,101686,1991,8684,208,1592,12475
ITAGUI,2023,6,ANTIOQUIA,7603,35885,51374,6971,160,0,101993,1980,8701,206,1594,12481
ITAGUI,2023,7,ANTIOQUIA,7633,35960,51420,6968,160,0,102141,1993,8708,205,1598,12504
ITAGUI,2023,8,ANTIOQUIA,7659,36056,51488,7109,160,0,102472,1993,8732,207,1598,12530
ITAGUI,2023,9,ANTIOQUIA,7701,36178,51550,7114,0,0,102543,1939,8942,215,1598,12694
ITUANGO,2018,1,ANTIOQUIA,3708,2576,501,26,5,0,6816,52,402,106,12,572
ITUANGO,2018,10,ANTIOQUIA,3741,2660,494,26,4,0,6925,51,410,108,12,581
ITUANGO,2018,11,ANTIOQUIA,3726,2644,495,28,4,0,6897,52,408,109,12,581
ITUANGO,2018,12,ANTIOQUIA,3756,2655,496,30,4,0,6941,51,409,110,12,582
ITUANGO,2018,2,ANTIOQUIA,3695,2578,502,26,4,0,6805,51,404,106,12,573
ITUANGO,2018,3,ANTIOQUIA,3694,2585,502,25,4,0,6810,51,406,106,12,575
ITUANGO,2018,4,ANTIOQUIA,3735,2589,502,25,4,0,6855,51,406,107,12,576
ITUANGO,2018,5,ANTIOQUIA,3714,2590,500,25,4,0,6833,50,406,106,12,574
ITUANGO,2018,6,ANTIOQUIA,3725,2593,500,27,4,0,6849,51,407,107,12,577
ITUANGO,2018,7,ANTIOQUIA,3737,2617,500,28,4,0,6886,51,408,107,12,578
ITUANGO,2018,8,ANTIOQUIA,3743,2625,497,28,4,0,6897,51,408,107,12,578
ITUANGO,2018,9,ANTIOQUIA,3717,2634,494,26,4,0,6875,51,408,105,12,576
ITUANGO,2019,1,ANTIOQUIA,3744,2668,494,30,4,0,6940,50,410,110,12,582
ITUANGO,2019,10,ANTIOQUIA,3961,2725,486,38,4,0,7214,46,455,109,13,623
ITUANGO,2019,11,ANTIOQUIA,3966,2728,486,36,4,0,7220,46,453,110,12,621
ITUANGO,2019,12,ANTIOQUIA,4023,2745,486,36,4,0,7294,46,455,110,12,623
ITUANGO,2019,2,ANTIOQUIA,3763,2672,495,29,4,0,6963,46,411,110,12,579
ITUANGO,2019,3,ANTIOQUIA,3754,2673,495,36,4,0,6962,46,411,110,12,579
ITUANGO,2019,4,ANTIOQUIA,3763,2685,495,36,4,0,6983,45,448,110,12,615
ITUANGO,2019,5,ANTIOQUIA,3785,2697,490,36,4,0,7012,48,449,109,12,618
ITUANGO,2019,6,ANTIOQUIA,3772,2696,490,37,4,0,6999,44,455,109,12,620
ITUANGO,2019,7,ANTIOQUIA,3869,2706,487,38,4,0,7104,46,457,110,12,625
ITUANGO,2019,8,ANTIOQUIA,3922,2709,488,38,4,0,7161,46,454,109,12,621
ITUANGO,2019,9,ANTIOQUIA,3954,2717,488,38,4,0,7201,46,455,109,12,622
ITUANGO,2020,1,ANTIOQUIA,3979,2734,484,37,4,0,7238,46,453,110,12,621
ITUANGO,2020,10,ANTIOQUIA,4079,2825,480,46,5,0,7435,48,467,109,104,728
ITUANGO,2020,11,ANTIOQUIA,4082,2827,483,47,5,0,7444,46,467,109,104,726
ITUANGO,2020,12,ANTIOQUIA,4085,2836,484,48,5,0,7458,47,471,110,104,732
ITUANGO,2020,2,ANTIOQUIA,3979,2739,483,38,4,0,7243,48,453,118,104,723
ITUANGO,2020,3,ANTIOQUIA,3985,2742,483,38,4,0,7252,48,453,119,104,724
ITUANGO,2020,4,ANTIOQUIA,3982,2774,480,38,4,0,7278,48,463,110,104,725
ITUANGO,2020,5,ANTIOQUIA,4064,2786,482,44,6,0,7382,46,467,110,104,727
ITUANGO,2020,6,ANTIOQUIA,4065,2793,482,44,5,0,7389,48,467,110,104,729
ITUANGO,2020,7,ANTIOQUIA,4069,2795,481,44,5,0,7394,50,467,110,104,731
ITUANGO,2020,8,ANTIOQUIA,4075,2799,481,44,5,0,7404,47,467,110,104,728
ITUANGO,2020,9,ANTIOQUIA,4080,2803,482,45,5,0,7415,47,466,110,104,727
ITUANGO,2021,1,ANTIOQUIA,4090,2838,481,49,5,0,7463,45,470,110,104,729
ITUANGO,2021,10,ANTIOQUIA,4117,2890,481,46,4,0,7538,47,475,121,104,747
ITUANGO,2021,11,ANTIOQUIA,4114,2895,482,45,4,0,7540,48,475,122,104,749
ITUANGO,2021,12,ANTIOQUIA,4132,2915,481,48,4,0,7580,47,476,122,104,749
ITUANGO,2021,2,ANTIOQUIA,4091,2852,481,49,5,0,7478,47,471,110,104,732
ITUANGO,2021,3,ANTIOQUIA,4099,2857,485,48,5,0,7494,45,471,111,104,731
ITUANGO,2021,4,ANTIOQUIA,4100,2865,484,48,5,0,7502,44,472,111,104,731
ITUANGO,2021,5,ANTIOQUIA,4110,2871,483,48,5,0,7517,46,470,110,104,730
ITUANGO,2021,6,ANTIOQUIA,4110,2876,485,45,5,0,7521,44,471,111,104,730
ITUANGO,2021,7,ANTIOQUIA,4111,2881,485,49,5,0,7531,44,472,111,104,731
ITUANGO,2021,8,ANTIOQUIA,4117,2879,484,48,5,0,7533,44,476,121,104,745
ITUANGO,2021,9,ANTIOQUIA,4120,2882,484,48,5,0,7539,46,475,121,104,746
ITUANGO,2022,1,ANTIOQUIA,4130,2921,481,48,4,0,7584,48,474,122,104,748
ITUANGO,2022,10,ANTIOQUIA,4151,2952,477,38,4,0,7622,48,476,134,103,761
ITUANGO,2022,11,ANTIOQUIA,4153,2956,474,39,4,0,7626,48,477,134,103,762
ITUANGO,2022,12,ANTIOQUIA,4158,2961,472,39,4,0,7634,48,477,134,103,762
ITUANGO,2022,2,ANTIOQUIA,4135,2924,484,44,4,0,7591,48,474,122,104,748
ITUANGO,2022,3,ANTIOQUIA,4146,2932,485,43,4,0,7610,47,472,124,103,746
ITUANGO,2022,4,ANTIOQUIA,4133,2953,485,42,4,0,7617,47,474,124,103,748
ITUANGO,2022,5,ANTIOQUIA,4138,2953,486,40,4,0,7621,47,473,124,103,747
ITUANGO,2022,6,ANTIOQUIA,4145,2953,484,40,4,0,7626,47,473,124,103,747
ITUANGO,2022,7,ANTIOQUIA,4138,2947,482,39,4,0,7610,48,474,123,103,748
ITUANGO,2022,8,ANTIOQUIA,4145,2948,481,38,4,0,7616,48,475,123,103,749
ITUANGO,2022,9,ANTIOQUIA,4145,2950,479,38,4,0,7616,48,475,128,103,754
ITUANGO,2023,1,ANTIOQUIA,4163,2964,471,39,4,0,7641,49,478,134,103,764
ITUANGO,2023,2,ANTIOQUIA,4169,2976,471,40,4,0,7660,50,480,134,103,767
ITUANGO,2023,3,ANTIOQUIA,4174,2985,470,41,4,0,7674,50,480,134,103,767
ITUANGO,2023,4,ANTIOQUIA,4182,2985,471,41,4,0,7683,50,480,134,103,767
ITUANGO,2023,5,ANTIOQUIA,4197,2988,470,58,4,0,7717,48,481,136,103,768
ITUANGO,2023,6,ANTIOQUIA,4218,3012,470,94,3,0,7797,49,482,137,103,771
ITUANGO,2023,7,ANTIOQUIA,4230,3006,469,98,3,0,7806,48,481,137,103,769
ITUANGO,2023,8,ANTIOQUIA,4255,3021,468,100,3,0,7847,47,483,138,103,771
ITUANGO,2023,9,ANTIOQUIA,4235,3016,466,99,3,0,7819,47,483,139,103,772
JARDIN,2018,1,ANTIOQUIA,946,3332,1388,61,0,0,5727,65,395,69,8,537
JARDIN,2018,10,ANTIOQUIA,986,3450,1403,61,0,0,5900,68,410,69,9,556
JARDIN,2018,11,ANTIOQUIA,988,3454,1397,59,0,0,5898,70,409,69,9,557
JARDIN,2018,12,ANTIOQUIA,993,3457,1394,59,0,0,5903,71,409,69,9,558
JARDIN,2018,2,ANTIOQUIA,948,3340,1389,60,0,0,5737,67,395,69,8,539
JARDIN,2018,3,ANTIOQUIA,947,3354,1391,61,0,0,5753,69,394,69,8,540
JARDIN,2018,4,ANTIOQUIA,948,3359,1391,61,0,0,5759,69,395,69,8,541
JARDIN,2018,5,ANTIOQUIA,951,3366,1393,61,0,0,5771,68,395,69,8,540
JARDIN,2018,6,ANTIOQUIA,954,3368,1391,60,0,0,5773,68,409,69,8,554
JARDIN,2018,7,ANTIOQUIA,968,3419,1393,59,0,0,5839,68,409,69,9,555
JARDIN,2018,8,ANTIOQUIA,975,3435,1395,59,0,0,5864,68,409,69,9,555
JARDIN,2018,9,ANTIOQUIA,976,3440,1395,60,0,0,5871,68,409,69,9,555
JARDIN,2019,1,ANTIOQUIA,994,3463,1394,60,0,0,5911,70,410,69,9,558
JARDIN,2019,10,ANTIOQUIA,1027,3565,1420,63,0,0,6075,77,432,70,9,588
JARDIN,2019,11,ANTIOQUIA,1033,3574,1421,63,0,0,6091,76,438,70,9,593
JARDIN,2019,12,ANTIOQUIA,1038,3582,1428,65,0,0,6113,80,439,70,9,598
JARDIN,2019,2,ANTIOQUIA,996,3468,1401,62,0,0,5927,70,411,69,9,559
JARDIN,2019,3,ANTIOQUIA,997,3476,1405,60,0,0,5938,70,412,69,9,560
JARDIN,2019,4,ANTIOQUIA,999,3487,1403,60,0,0,5949,70,412,69,9,560
JARDIN,2019,5,ANTIOQUIA,1002,3491,1401,59,0,0,5953,72,425,69,9,575
JARDIN,2019,6,ANTIOQUIA,1002,3491,1406,60,0,0,5959,72,427,69,9,577
JARDIN,2019,7,ANTIOQUIA,1015,3503,1409,62,0,0,5989,73,430,69,9,581
JARDIN,2019,8,ANTIOQUIA,1024,3511,1416,62,0,0,6013,74,429,69,9,581
JARDIN,2019,9,ANTIOQUIA,1024,3519,1417,63,0,0,6023,76,429,69,9,583
JARDIN,2020,1,ANTIOQUIA,1041,3585,1428,70,0,0,6124,80,439,72,9,600
JARDIN,2020,10,ANTIOQUIA,1083,3710,1450,68,0,0,6311,84,464,71,77,696
JARDIN,2020,11,ANTIOQUIA,1088,3723,1435,72,0,0,6318,85,462,71,77,695
JARDIN,2020,12,ANTIOQUIA,999,3678,1342,295,13,0,6327,83,470,71,77,701
JARDIN,2020,2,ANTIOQUIA,1046,3596,1427,78,0,0,6147,82,441,77,77,677
JARDIN,2020,3,ANTIOQUIA,1047,3605,1435,78,0,0,6165,82,442,77,77,678
JARDIN,2020,4,ANTIOQUIA,1056,3616,1434,66,0,0,6172,84,453,72,77,686
JARDIN,2020,5,ANTIOQUIA,1062,3622,1435,67,0,0,6186,84,456,72,77,689
JARDIN,2020,6,ANTIOQUIA,1061,3623,1435,67,0,0,6186,82,462,71,77,692
JARDIN,2020,7,ANTIOQUIA,1062,3625,1436,67,0,0,6190,82,461,70,77,690
JARDIN,2020,8,ANTIOQUIA,1063,3634,1436,67,0,0,6200,83,460,70,77,690
JARDIN,2020,9,ANTIOQUIA,1075,3709,1445,67,0,0,6296,83,464,71,77,695
JARDIN,2021,1,ANTIOQUIA,1004,3688,1350,296,13,0,6351,82,470,71,77,700
JARDIN,2021,10,ANTIOQUIA,1018,3737,1357,311,9,0,6432,95,475,72,77,719
JARDIN,2021,11,ANTIOQUIA,1017,3745,1356,320,9,0,6447,94,477,72,77,720
JARDIN,2021,12,ANTIOQUIA,1020,3753,1358,319,9,0,6459,94,478,72,77,721
JARDIN,2021,2,ANTIOQUIA,1005,3693,1349,300,11,0,6358,84,469,71,77,701
JARDIN,2021,3,ANTIOQUIA,1008,3701,1348,296,10,0,6363,84,470,71,77,702
JARDIN,2021,4,ANTIOQUIA,1010,3711,1350,297,14,0,6382,84,471,71,77,703
JARDIN,2021,5,ANTIOQUIA,1009,3720,1351,300,12,0,6392,84,471,71,77,703
JARDIN,2021,6,ANTIOQUIA,1010,3722,1352,303,10,0,6397,84,471,71,77,703
JARDIN,2021,7,ANTIOQUIA,1014,3724,1354,307,9,0,6408,87,472,72,77,708
JARDIN,2021,8,ANTIOQUIA,1015,3729,1358,309,9,0,6420,90,472,72,77,711
JARDIN,2021,9,ANTIOQUIA,1014,3740,1357,311,9,0,6431,92,474,72,77,715
JARDIN,2022,1,ANTIOQUIA,1024,3761,1361,315,9,0,6470,95,477,72,77,721
JARDIN,2022,10,ANTIOQUIA,1073,3826,1370,323,9,0,6601,95,479,74,76,724
JARDIN,2022,11,ANTIOQUIA,1075,3830,1371,325,9,0,6610,94,480,74,75,723
JARDIN,2022,12,ANTIOQUIA,1075,3843,1371,325,9,0,6623,95,482,74,75,726
JARDIN,2022,2,ANTIOQUIA,1026,3766,1363,316,9,0,6480,96,477,72,77,722
JARDIN,2022,3,ANTIOQUIA,1040,3779,1362,318,9,0,6508,95,478,74,76,723
JARDIN,2022,4,ANTIOQUIA,1051,3789,1364,318,9,0,6531,94,478,74,76,722
JARDIN,2022,5,ANTIOQUIA,1043,3809,1370,319,9,0,6550,95,479,74,76,724
JARDIN,2022,6,ANTIOQUIA,1046,3815,1375,317,9,0,6562,96,481,74,76,727
JARDIN,2022,7,ANTIOQUIA,1063,3825,1379,321,9,0,6597,99,481,74,76,730
JARDIN,2022,8,ANTIOQUIA,1060,3813,1370,321,9,0,6573,96,479,74,76,725
JARDIN,2022,9,ANTIOQUIA,1062,3818,1370,322,9,0,6581,94,479,74,76,723
JARDIN,2023,1,ANTIOQUIA,1077,3851,1370,325,9,0,6632,96,482,74,75,727
JARDIN,2023,2,ANTIOQUIA,1079,3859,1370,328,9,0,6645,95,482,74,75,726
JARDIN,2023,3,ANTIOQUIA,1079,3875,1374,329,9,0,6666,96,483,74,75,728
JARDIN,2023,4,ANTIOQUIA,1082,3889,1375,329,9,0,6684,96,483,74,75,728
JARDIN,2023,5,ANTIOQUIA,1086,3896,1376,329,9,0,6696,98,484,75,75,732
JARDIN,2023,6,ANTIOQUIA,1078,3902,1372,328,9,0,6689,97,484,75,75,731
JARDIN,2023,7,ANTIOQUIA,1085,3919,1373,329,9,0,6715,96,484,75,75,730
JARDIN,2023,8,ANTIOQUIA,1090,3928,1373,328,9,0,6728,98,485,75,75,733
JARDIN,2023,9,ANTIOQUIA,1087,3948,1375,333,9,0,6752,100,484,75,76,735
JERICO,2018,1,ANTIOQUIA,874,2354,1350,154,3,2,4737,41,434,65,8,548
JERICO,2018,10,ANTIOQUIA,879,2422,1360,160,4,2,4827,39,457,64,8,568
JERICO,2018,11,ANTIOQUIA,879,2424,1366,159,4,2,4834,39,458,64,8,569
JERICO,2018,12,ANTIOQUIA,879,2427,1366,159,4,2,4837,39,458,64,8,569
JERICO,2018,2,ANTIOQUIA,876,2372,1350,157,3,2,4760,41,435,65,8,549
JERICO,2018,3,ANTIOQUIA,876,2375,1356,159,3,2,4771,41,435,65,8,549
JERICO,2018,4,ANTIOQUIA,877,2378,1356,159,3,2,4775,41,437,65,8,551
JERICO,2018,5,ANTIOQUIA,877,2384,1357,160,4,2,4784,40,441,64,8,553
JERICO,2018,6,ANTIOQUIA,877,2391,1357,160,4,2,4791,39,445,64,8,556
JERICO,2018,7,ANTIOQUIA,879,2399,1355,158,4,2,4797,40,450,64,8,562
JERICO,2018,8,ANTIOQUIA,879,2412,1355,159,4,2,4811,39,453,64,8,564
JERICO,2018,9,ANTIOQUIA,879,2413,1359,160,4,2,4817,39,457,64,8,568
JERICO,2019,1,ANTIOQUIA,891,2434,1364,157,4,2,4852,39,457,64,8,568
JERICO,2019,10,ANTIOQUIA,1247,2247,1263,160,5,3,4925,38,457,65,8,568
JERICO,2019,11,ANTIOQUIA,1251,2254,1254,160,5,3,4927,38,457,65,8,568
JERICO,2019,12,ANTIOQUIA,1252,2255,1255,162,5,3,4932,39,457,65,8,569
JERICO,2019,2,ANTIOQUIA,1153,2254,1284,162,4,2,4859,38,456,64,8,566
JERICO,2019,3,ANTIOQUIA,1157,2258,1286,162,4,2,4869,38,454,64,8,564
JERICO,2019,4,ANTIOQUIA,1175,2283,1248,160,4,2,4872,38,454,64,8,564
JERICO,2019,5,ANTIOQUIA,1195,2287,1232,159,4,2,4879,38,456,64,8,566
JERICO,2019,6,ANTIOQUIA,1234,2266,1225,160,4,2,4891,38,456,64,8,566
JERICO,2019,7,ANTIOQUIA,1238,2269,1227,160,4,2,4900,38,458,64,8,568
JERICO,2019,8,ANTIOQUIA,1242,2282,1226,159,4,2,4915,39,458,64,8,569
JERICO,2019,9,ANTIOQUIA,1243,2284,1226,160,4,3,4920,38,458,65,8,569
JERICO,2020,1,ANTIOQUIA,1255,2258,1250,164,5,3,4935,40,458,65,8,571
JERICO,2020,10,ANTIOQUIA,1273,2356,1175,165,6,3,4978,34,471,65,157,727
JERICO,2020,11,ANTIOQUIA,1273,2365,1176,165,6,3,4988,34,472,65,158,729
JERICO,2020,12,ANTIOQUIA,1280,2369,1176,165,6,3,4999,34,473,65,158,730
JERICO,2020,2,ANTIOQUIA,1253,2317,1197,168,5,3,4943,38,463,70,158,729
JERICO,2020,3,ANTIOQUIA,1258,2325,1198,168,5,3,4957,38,464,70,158,730
JERICO,2020,4,ANTIOQUIA,1263,2332,1192,163,5,3,4958,38,462,65,158,723
JERICO,2020,5,ANTIOQUIA,1262,2335,1187,163,6,3,4956,38,470,66,158,732
JERICO,2020,6,ANTIOQUIA,1263,2336,1187,163,5,3,4957,37,471,65,158,731
JERICO,2020,7,ANTIOQUIA,1264,2337,1187,163,5,3,4959,38,471,65,158,732
JERICO,2020,8,ANTIOQUIA,1267,2340,1186,163,5,3,4964,37,469,65,158,729
JERICO,2020,9,ANTIOQUIA,1267,2349,1180,165,5,3,4969,35,469,65,158,727
JERICO,2021,1,ANTIOQUIA,1325,2253,1216,187,11,8,5000,34,473,65,158,730
JERICO,2021,10,ANTIOQUIA,1402,2140,1256,114,30,119,5061,41,482,65,158,746
JERICO,2021,11,ANTIOQUIA,1396,2141,1252,113,30,120,5052,41,484,65,158,748
JERICO,2021,12,ANTIOQUIA,1398,2145,1254,113,30,121,5061,43,484,65,158,750
JERICO,2021,2,ANTIOQUIA,1375,2093,1270,120,32,119,5009,36,474,65,158,733
JERICO,2021,3,ANTIOQUIA,1376,2095,1270,119,32,119,5011,36,474,65,158,733
JERICO,2021,4,ANTIOQUIA,1376,2098,1262,117,32,118,5003,41,483,65,158,747
JERICO,2021,5,ANTIOQUIA,1379,2102,1261,118,32,118,5010,42,484,65,158,749
JERICO,2021,6,ANTIOQUIA,1384,2108,1258,117,32,117,5016,42,483,65,158,748
JERICO,2021,7,ANTIOQUIA,1391,2116,1250,116,30,117,5020,41,481,65,158,745
JERICO,2021,8,ANTIOQUIA,1396,2125,1249,113,30,117,5030,42,483,65,158,748
JERICO,2021,9,ANTIOQUIA,1397,2132,1247,113,30,118,5037,42,484,65,158,749
JERICO,2022,1,ANTIOQUIA,1398,2149,1255,112,30,120,5064,43,485,65,158,751
JERICO,2022,10,ANTIOQUIA,1409,2190,1255,112,30,120,5116,48,497,65,156,766
JERICO,2022,11,ANTIOQUIA,1411,2198,1257,113,30,120,5129,47,497,65,156,765
JERICO,2022,12,ANTIOQUIA,1414,2202,1256,114,30,120,5136,48,497,65,156,766
JERICO,2022,2,ANTIOQUIA,1399,2161,1254,112,30,121,5077,44,485,65,158,752
JERICO,2022,3,ANTIOQUIA,1406,2164,1257,113,30,121,5091,44,489,65,156,754
JERICO,2022,4,ANTIOQUIA,1409,2164,1256,112,30,121,5092,44,495,65,156,760
JERICO,2022,5,ANTIOQUIA,1411,2166,1256,112,30,121,5096,43,495,65,156,759
JERICO,2022,6,ANTIOQUIA,1413,2171,1257,113,30,121,5105,45,496,65,156,762
JERICO,2022,7,ANTIOQUIA,1413,2174,1257,112,30,121,5107,45,500,65,156,766
JERICO,2022,8,ANTIOQUIA,1405,2177,1255,113,30,120,5100,45,500,65,156,766
JERICO,2022,9,ANTIOQUIA,1406,2181,1256,114,30,120,5107,48,500,65,156,769
JERICO,2023,1,ANTIOQUIA,1415,2209,1255,112,30,120,5141,48,497,65,156,766
JERICO,2023,2,ANTIOQUIA,1417,2216,1256,112,30,119,5150,47,500,65,156,768
JERICO,2023,3,ANTIOQUIA,1418,2228,1256,112,30,122,5166,47,500,66,156,769
JERICO,2023,4,ANTIOQUIA,1419,2233,1256,112,30,122,5172,46,496,66,156,764
JERICO,2023,5,ANTIOQUIA,1422,2250,1257,113,30,122,5194,46,500,66,156,768
JERICO,2023,6,ANTIOQUIA,1429,2259,1257,111,27,122,5205,47,494,66,156,763
JERICO,2023,7,ANTIOQUIA,1431,2272,1256,111,27,122,5219,49,495,66,157,767
JERICO,2023,8,ANTIOQUIA,1432,2278,1257,110,27,122,5226,48,493,66,157,764
JERICO,2023,9,ANTIOQUIA,1435,2286,1257,110,27,123,5238,50,495,66,157,768
LA CEJA,2018,1,ANTIOQUIA,476,3978,11903,2507,858,18,19740,236,2100,124,46,2506
LA CEJA,2018,10,ANTIOQUIA,547,4052,12451,2642,903,29,20624,240,2302,125,52,2719
LA CEJA,2018,11,ANTIOQUIA,545,4041,12464,2645,901,30,20626,241,2331,125,50,2747
LA CEJA,2018,12,ANTIOQUIA,545,4043,12501,2709,903,31,20732,242,2336,123,50,2751
LA CEJA,2018,2,ANTIOQUIA,474,3984,12077,2526,873,18,19952,238,2138,125,46,2547
LA CEJA,2018,3,ANTIOQUIA,476,3990,12137,2536,892,18,20049,244,2168,125,48,2585
LA CEJA,2018,4,ANTIOQUIA,478,3991,12144,2548,893,18,20072,245,2176,125,49,2595
LA CEJA,2018,5,ANTIOQUIA,498,3993,12278,2555,890,18,20232,244,2175,124,49,2592
LA CEJA,2018,6,ANTIOQUIA,501,4007,12318,2564,889,18,20297,239,2237,125,50,2651
LA CEJA,2018,7,ANTIOQUIA,513,4016,12334,2593,891,18,20365,247,2245,125,50,2667
LA CEJA,2018,8,ANTIOQUIA,543,4020,12384,2617,893,28,20485,246,2298,125,50,2719
LA CEJA,2018,9,ANTIOQUIA,547,4028,12392,2633,897,29,20526,242,2300,125,50,2717
LA CEJA,2019,1,ANTIOQUIA,545,4042,12589,2779,905,31,20891,235,2348,123,51,2757
LA CEJA,2019,10,ANTIOQUIA,563,4150,12964,3164,938,33,21812,239,2394,125,52,2810
LA CEJA,2019,11,ANTIOQUIA,562,4173,13008,3223,940,33,21939,240,2409,126,52,2827
LA CEJA,2019,12,ANTIOQUIA,564,4187,13039,3235,941,33,21999,241,2419,126,52,2838
LA CEJA,2019,2,ANTIOQUIA,546,4047,12607,2810,907,31,20948,234,2347,123,51,2755
LA CEJA,2019,3,ANTIOQUIA,546,4056,12667,2828,913,32,21042,228,2359,124,51,2762
LA CEJA,2019,4,ANTIOQUIA,546,4059,12677,2850,914,32,21078,224,2354,124,51,2753
LA CEJA,2019,5,ANTIOQUIA,548,4060,12797,2871,916,32,21224,228,2364,124,51,2767
LA CEJA,2019,6,ANTIOQUIA,548,4063,12810,2878,916,33,21248,231,2364,124,51,2770
LA CEJA,2019,7,ANTIOQUIA,552,4083,12836,3046,931,33,21481,233,2384,124,51,2792
LA CEJA,2019,8,ANTIOQUIA,556,4095,12859,3075,933,33,21551,232,2385,124,52,2793
LA CEJA,2019,9,ANTIOQUIA,563,4099,12922,3142,936,33,21695,237,2392,126,51,2806
LA CEJA,2020,1,ANTIOQUIA,569,4184,13065,3265,943,33,22059,241,2428,126,52,2847
LA CEJA,2020,10,ANTIOQUIA,592,4356,13484,3373,958,33,22796,255,2554,131,757,3697
LA CEJA,2020,11,ANTIOQUIA,593,4363,13539,3378,958,34,22865,255,2575,133,756,3719
LA CEJA,2020,12,ANTIOQUIA,602,4374,13713,3347,960,34,23030,252,2578,133,756,3719
LA CEJA,2020,2,ANTIOQUIA,568,4191,13072,3305,945,33,22114,247,2447,161,757,3612
LA CEJA,2020,3,ANTIOQUIA,568,4222,13237,3369,945,33,22374,252,2478,162,755,3647
LA CEJA,2020,4,ANTIOQUIA,569,4251,13314,3296,949,33,22412,249,2510,128,757,3644
LA CEJA,2020,5,ANTIOQUIA,575,4262,13355,3305,956,33,22486,247,2517,128,757,3649
LA CEJA,2020,6,ANTIOQUIA,577,4272,13396,3303,950,33,22531,247,2519,129,757,3652
LA CEJA,2020,7,ANTIOQUIA,578,4310,13409,3312,952,33,22594,247,2519,131,757,3654
LA CEJA,2020,8,ANTIOQUIA,581,4316,13424,3324,952,33,22630,251,2521,129,758,3659
LA CEJA,2020,9,ANTIOQUIA,583,4350,13475,3365,956,33,22762,253,2526,131,758,3668
LA CEJA,2021,1,ANTIOQUIA,604,4383,13736,3351,962,34,23070,253,2577,133,756,3719
LA CEJA,2021,10,ANTIOQUIA,612,4450,14099,3476,988,36,23661,279,2644,135,756,3814
LA CEJA,2021,11,ANTIOQUIA,613,4461,14124,3485,996,36,23715,285,2649,135,755,3824
LA CEJA,2021,12,ANTIOQUIA,613,4471,14127,3496,1001,38,23746,285,2647,135,755,3822
LA CEJA,2021,2,ANTIOQUIA,608,4399,13804,3353,966,34,23164,256,2592,133,757,3738
LA CEJA,2021,3,ANTIOQUIA,609,4409,13857,3366,965,34,23240,262,2594,132,757,3745
LA CEJA,2021,4,ANTIOQUIA,608,4417,13946,3373,966,34,23344,264,2596,132,757,3749
LA CEJA,2021,5,ANTIOQUIA,610,4419,13975,3381,968,34,23387,268,2597,133,756,3754
LA CEJA,2021,6,ANTIOQUIA,610,4422,13978,3386,969,35,23400,265,2606,132,757,3760
LA CEJA,2021,7,ANTIOQUIA,612,4431,13999,3393,970,34,23439,269,2618,132,757,3776
LA CEJA,2021,8,ANTIOQUIA,612,4435,14041,3446,978,34,23546,270,2633,133,758,3794
LA CEJA,2021,9,ANTIOQUIA,612,4439,14072,3451,983,36,23593,273,2641,133,758,3805
LA CEJA,2022,1,ANTIOQUIA,614,4480,14135,3509,1008,39,23785,287,2649,136,755,3827
LA CEJA,2022,10,ANTIOQUIA,600,4568,14520,3628,1066,41,24423,302,2681,140,753,3876
LA CEJA,2022,11,ANTIOQUIA,603,4592,14556,3670,1126,42,24589,308,2691,140,753,3892
LA CEJA,2022,12,ANTIOQUIA,602,4601,14576,3689,1129,42,24639,307,2692,140,753,3892
LA CEJA,2022,2,ANTIOQUIA,615,4485,14144,3525,1012,39,23820,291,2652,137,755,3835
LA CEJA,2022,3,ANTIOQUIA,616,4490,14255,3549,1023,39,23972,292,2654,138,754,3838
LA CEJA,2022,4,ANTIOQUIA,579,4508,14306,3568,1030,38,24029,295,2657,140,754,3846
LA CEJA,2022,5,ANTIOQUIA,581,4514,14345,3578,1035,39,24092,298,2659,140,754,3851
LA CEJA,2022,6,ANTIOQUIA,554,4536,14433,3560,1037,39,24159,297,2659,140,754,3850
LA CEJA,2022,7,ANTIOQUIA,592,4544,14439,3574,1044,39,24232,295,2668,139,753,3855
LA CEJA,2022,8,ANTIOQUIA,599,4552,14471,3589,1047,40,24298,301,2668,140,752,3861
LA CEJA,2022,9,ANTIOQUIA,600,4558,14495,3612,1059,40,24364,302,2679,140,753,3874
LA CEJA,2023,1,ANTIOQUIA,599,4665,14612,3704,1129,41,24750,309,2690,140,753,3892
LA CEJA,2023,2,ANTIOQUIA,599,4677,14804,3789,1089,40,24998,313,2694,141,753,3901
LA CEJA,2023,3,ANTIOQUIA,599,4688,14861,3787,1091,40,25066,315,2692,141,753,3901
LA CEJA,2023,4,ANTIOQUIA,601,4700,14929,3824,1092,39,25185,317,2696,142,753,3908
LA CEJA,2023,5,ANTIOQUIA,602,4710,15018,3872,1095,39,25336,316,2704,141,753,3914
LA CEJA,2023,6,ANTIOQUIA,608,4717,15031,3882,1100,40,25378,314,2705,142,753,3914
LA CEJA,2023,7,ANTIOQUIA,611,4756,15057,3887,1101,40,25452,313,2705,142,753,3913
LA CEJA,2023,8,ANTIOQUIA,612,4756,15124,3914,1126,41,25573,316,2708,143,752,3919
LA CEJA,2023,9,ANTIOQUIA,613,4767,15252,3911,1127,41,25711,317,2707,144,751,3919
LA ESTRELLA,2018,1,ANTIOQUIA,2141,10186,6852,2820,216,40,22255,587,1153,50,56,1846
LA ESTRELLA,2018,10,ANTIOQUIA,2187,10595,7441,2953,215,40,23431,594,1184,50,53,1881
LA ESTRELLA,2018,11,ANTIOQUIA,2192,10700,7439,3083,215,40,23669,602,1185,50,53,1890
LA ESTRELLA,2018,12,ANTIOQUIA,2197,10725,7440,3086,214,40,23702,606,1186,50,54,1896
LA ESTRELLA,2018,2,ANTIOQUIA,2142,10203,6843,2964,216,40,22408,588,1150,50,53,1841
LA ESTRELLA,2018,3,ANTIOQUIA,2171,10218,6853,2956,216,40,22454,589,1150,50,53,1842
LA ESTRELLA,2018,4,ANTIOQUIA,2191,10266,6903,2928,217,40,22545,588,1153,50,53,1844
LA ESTRELLA,2018,5,ANTIOQUIA,2172,10283,7042,2943,216,40,22696,587,1156,50,53,1846
LA ESTRELLA,2018,6,ANTIOQUIA,2178,10302,7058,2946,215,40,22739,584,1156,50,53,1843
LA ESTRELLA,2018,7,ANTIOQUIA,2181,10325,7290,2946,215,40,22997,590,1156,50,53,1849
LA ESTRELLA,2018,8,ANTIOQUIA,2184,10518,7429,2951,215,40,23337,593,1174,50,53,1870
LA ESTRELLA,2018,9,ANTIOQUIA,2187,10548,7433,2951,215,40,23374,593,1185,50,53,1881
LA ESTRELLA,2019,1,ANTIOQUIA,2220,10738,7440,3258,214,40,23910,605,1186,50,55,1896
LA ESTRELLA,2019,10,ANTIOQUIA,2242,10789,7961,3797,215,41,25045,609,1255,53,56,1973
LA ESTRELLA,2019,11,ANTIOQUIA,2247,10780,7977,3798,215,41,25058,607,1273,54,56,1990
LA ESTRELLA,2019,12,ANTIOQUIA,2264,10796,8022,3802,215,41,25140,610,1289,54,56,2009
LA ESTRELLA,2019,2,ANTIOQUIA,2220,10778,7578,3248,214,40,24078,607,1183,50,54,1894
LA ESTRELLA,2019,3,ANTIOQUIA,2219,10804,7860,2974,214,40,24111,607,1185,50,54,1896
LA ESTRELLA,2019,4,ANTIOQUIA,2223,11056,7865,2977,214,41,24376,600,1183,50,54,1887
LA ESTRELLA,2019,5,ANTIOQUIA,2224,11076,8053,2978,214,41,24586,600,1186,50,54,1890
LA ESTRELLA,2019,6,ANTIOQUIA,2229,11064,8114,2984,214,41,24646,597,1193,50,54,1894
LA ESTRELLA,2019,7,ANTIOQUIA,2231,10867,8316,3009,215,41,24679,600,1195,51,54,1900
LA ESTRELLA,2019,8,ANTIOQUIA,2233,10625,7921,3796,215,41,24831,603,1192,53,54,1902
LA ESTRELLA,2019,9,ANTIOQUIA,2237,10654,7959,3797,215,41,24903,602,1256,54,53,1965
LA ESTRELLA,2020,1,ANTIOQUIA,2254,10792,8032,3806,215,40,25139,620,1284,54,56,2014
LA ESTRELLA,2020,10,ANTIOQUIA,2281,10814,8686,4273,217,40,26311,650,1349,56,496,2551
LA ESTRELLA,2020,11,ANTIOQUIA,2284,11010,8703,4274,217,40,26528,644,1344,55,497,2540
LA ESTRELLA,2020,12,ANTIOQUIA,2284,11037,8702,4542,217,40,26822,651,1355,56,497,2559
LA ESTRELLA,2020,2,ANTIOQUIA,2258,10817,8152,3929,215,40,25411,627,1296,97,497,2517
LA ESTRELLA,2020,3,ANTIOQUIA,2262,10831,8157,3934,215,40,25439,630,1300,97,497,2524
LA ESTRELLA,2020,4,ANTIOQUIA,2264,10849,8318,3807,215,40,25493,632,1345,54,497,2528
LA ESTRELLA,2020,5,ANTIOQUIA,2271,10845,8366,3838,221,40,25581,619,1385,54,497,2555
LA ESTRELLA,2020,6,ANTIOQUIA,2270,10670,8355,4029,218,40,25582,638,1344,55,497,2534
LA ESTRELLA,2020,7,ANTIOQUIA,2271,10649,8356,4060,216,40,25592,642,1348,55,497,2542
LA ESTRELLA,2020,8,ANTIOQUIA,2272,10767,8679,4196,217,40,26171,643,1346,55,497,2541
LA ESTRELLA,2020,9,ANTIOQUIA,2274,10784,8684,4271,217,40,26270,649,1347,55,497,2548
LA ESTRELLA,2021,1,ANTIOQUIA,2327,11019,8696,4544,218,40,26844,651,1367,56,497,2571
LA ESTRELLA,2021,10,ANTIOQUIA,2528,10869,8942,5220,220,40,27819,668,1444,56,495,2663
LA ESTRELLA,2021,11,ANTIOQUIA,2528,10885,8945,5223,220,40,27841,670,1440,55,494,2659
LA ESTRELLA,2021,12,ANTIOQUIA,2530,10914,8944,5225,220,40,27873,669,1442,56,494,2661
LA ESTRELLA,2021,2,ANTIOQUIA,2527,10593,8492,5001,218,40,26871,652,1373,56,497,2578
LA ESTRELLA,2021,3,ANTIOQUIA,2525,10619,8495,4998,218,40,26895,651,1377,56,497,2581
LA ESTRELLA,2021,4,ANTIOQUIA,2526,10635,8589,4996,219,40,27005,653,1379,56,497,2585
LA ESTRELLA,2021,5,ANTIOQUIA,2524,10665,8628,4999,219,40,27075,656,1381,56,497,2590
LA ESTRELLA,2021,6,ANTIOQUIA,2523,10671,8628,5006,219,40,27087,654,1383,55,496,2588
LA ESTRELLA,2021,7,ANTIOQUIA,2525,10714,8754,5117,219,40,27369,651,1403,55,496,2605
LA ESTRELLA,2021,8,ANTIOQUIA,2526,10802,8934,5117,220,40,27639,651,1403,55,496,2605
LA ESTRELLA,2021,9,ANTIOQUIA,2526,10843,8940,5217,220,40,27786,661,1435,55,495,2646
LA ESTRELLA,2022,1,ANTIOQUIA,2522,10935,8956,5225,221,40,27899,670,1444,55,494,2663
LA ESTRELLA,2022,10,ANTIOQUIA,2350,11216,8743,6287,224,39,28859,692,1454,56,493,2695
LA ESTRELLA,2022,11,ANTIOQUIA,2292,11150,9013,6164,224,44,28887,690,1454,56,493,2693
LA ESTRELLA,2022,12,ANTIOQUIA,2099,10490,10512,5409,277,115,28902,690,1454,56,493,2693
LA ESTRELLA,2022,2,ANTIOQUIA,2360,10961,9120,5226,221,40,27928,668,1440,55,495,2658
LA ESTRELLA,2022,3,ANTIOQUIA,2363,10995,9123,5224,222,40,27967,668,1445,56,493,2662
LA ESTRELLA,2022,4,ANTIOQUIA,2367,11022,9022,5422,222,40,28095,673,1450,56,493,2672
LA ESTRELLA,2022,5,ANTIOQUIA,2338,11081,9032,5574,223,40,28288,675,1447,56,493,2671
LA ESTRELLA,2022,6,ANTIOQUIA,2340,11123,9035,5576,224,39,28337,680,1450,55,494,2679
LA ESTRELLA,2022,7,ANTIOQUIA,2346,11154,9199,5579,224,39,28541,677,1450,54,494,2675
LA ESTRELLA,2022,8,ANTIOQUIA,2345,11170,9183,5596,224,39,28557,683,1451,55,494,2683
LA ESTRELLA,2022,9,ANTIOQUIA,2345,11196,8737,6279,224,39,28820,684,1455,55,493,2687
LA ESTRELLA,2023,1,ANTIOQUIA,2084,10544,10602,5304,278,115,28927,694,1450,56,493,2693
LA ESTRELLA,2023,2,ANTIOQUIA,2232,11102,10017,5369,273,113,29106,693,1451,57,493,2694
LA ESTRELLA,2023,3,ANTIOQUIA,2235,11157,9997,5382,269,113,29153,694,1471,57,493,2715
LA ESTRELLA,2023,4,ANTIOQUIA,2235,11200,10193,5219,269,113,29229,696,1472,57,493,2718
LA ESTRELLA,2023,5,ANTIOQUIA,2237,11223,10305,5220,269,113,29367,693,1471,58,493,2715
LA ESTRELLA,2023,6,ANTIOQUIA,2233,11258,10330,5283,270,113,29487,695,1464,58,493,2710
LA ESTRELLA,2023,7,ANTIOQUIA,2233,11264,10334,5284,271,115,29501,702,1458,58,494,2712
LA ESTRELLA,2023,8,ANTIOQUIA,2238,11289,10392,5229,271,115,29534,700,1460,58,495,2713
LA ESTRELLA,2023,9,ANTIOQUIA,2242,11307,10395,5231,271,115,29561,699,1464,59,495,2717
LA PINTADA,2018,1,ANTIOQUIA,842,1217,344,334,73,27,2837,27,354,28,4,413
LA PINTADA,2018,10,ANTIOQUIA,834,1226,353,337,73,27,2850,28,349,28,4,409
LA PINTADA,2018,11,ANTIOQUIA,835,1230,354,337,73,27,2856,28,349,28,4,409
LA PINTADA,2018,12,ANTIOQUIA,835,1231,354,337,73,27,2857,28,349,28,4,409
LA PINTADA,2018,2,ANTIOQUIA,840,1220,344,334,73,27,2838,27,355,28,4,414
LA PINTADA,2018,3,ANTIOQUIA,832,1220,344,334,73,27,2830,27,355,28,4,414
LA PINTADA,2018,4,ANTIOQUIA,841,1224,348,335,73,27,2848,27,358,28,4,417
LA PINTADA,2018,5,ANTIOQUIA,832,1223,350,334,73,27,2839,27,349,28,4,408
LA PINTADA,2018,6,ANTIOQUIA,835,1223,350,335,73,27,2843,27,351,28,4,410
LA PINTADA,2018,7,ANTIOQUIA,835,1223,350,336,73,27,2844,27,350,28,4,409
LA PINTADA,2018,8,ANTIOQUIA,835,1223,350,336,73,27,2844,27,350,28,4,409
LA PINTADA,2018,9,ANTIOQUIA,833,1224,350,336,73,27,2843,28,348,28,4,408
LA PINTADA,2019,1,ANTIOQUIA,837,1235,355,337,73,27,2864,28,349,28,4,409
LA PINTADA,2019,10,ANTIOQUIA,839,1244,374,345,73,27,2902,28,353,29,5,415
LA PINTADA,2019,11,ANTIOQUIA,845,1246,375,345,73,27,2911,28,351,29,5,413
LA PINTADA,2019,12,ANTIOQUIA,844,1245,375,345,73,27,2909,28,354,29,5,416
LA PINTADA,2019,2,ANTIOQUIA,838,1235,358,337,73,27,2868,28,349,28,4,409
LA PINTADA,2019,3,ANTIOQUIA,838,1237,359,339,72,27,2872,28,347,28,4,407
LA PINTADA,2019,4,ANTIOQUIA,838,1237,359,340,72,27,2873,28,347,28,4,407
LA PINTADA,2019,5,ANTIOQUIA,839,1238,360,340,73,27,2877,29,347,28,4,408
LA PINTADA,2019,6,ANTIOQUIA,840,1238,361,341,73,27,2880,29,346,28,4,407
LA PINTADA,2019,7,ANTIOQUIA,840,1241,366,341,73,27,2888,29,351,28,5,413
LA PINTADA,2019,8,ANTIOQUIA,840,1242,370,341,73,27,2893,29,351,29,5,414
LA PINTADA,2019,9,ANTIOQUIA,840,1244,372,342,73,27,2898,29,351,29,5,414
LA PINTADA,2020,1,ANTIOQUIA,840,1244,374,349,73,27,2907,28,356,29,5,418
LA PINTADA,2020,10,ANTIOQUIA,838,1232,392,354,73,27,2916,30,374,29,103,536
LA PINTADA,2020,11,ANTIOQUIA,839,1235,393,356,73,27,2923,31,373,29,103,536
LA PINTADA,2020,12,ANTIOQUIA,837,1235,394,354,73,27,2920,31,380,29,103,543
LA PINTADA,2020,2,ANTIOQUIA,839,1240,377,350,73,27,2906,28,358,31,103,520
LA PINTADA,2020,3,ANTIOQUIA,839,1242,377,359,73,27,2917,29,360,31,103,523
LA PINTADA,2020,4,ANTIOQUIA,840,1239,381,354,73,27,2914,29,370,29,103,531
LA PINTADA,2020,5,ANTIOQUIA,840,1238,381,355,74,28,2916,30,373,32,103,538
LA PINTADA,2020,6,ANTIOQUIA,839,1237,381,352,73,27,2909,29,375,31,103,538
LA PINTADA,2020,7,ANTIOQUIA,841,1236,380,352,73,27,2909,29,373,30,103,535
LA PINTADA,2020,8,ANTIOQUIA,842,1237,382,352,73,27,2913,29,373,29,103,534
LA PINTADA,2020,9,ANTIOQUIA,841,1234,393,352,73,28,2921,30,372,29,103,534
LA PINTADA,2021,1,ANTIOQUIA,838,1239,396,349,73,27,2922,30,380,30,103,543
LA PINTADA,2021,10,ANTIOQUIA,834,1247,399,341,73,27,2921,30,391,30,103,554
LA PINTADA,2021,11,ANTIOQUIA,829,1246,399,339,73,27,2913,30,393,31,103,557
LA PINTADA,2021,12,ANTIOQUIA,829,1248,399,339,73,27,2915,30,393,31,103,557
LA PINTADA,2021,2,ANTIOQUIA,839,1244,396,345,73,27,2924,31,380,30,103,544
LA PINTADA,2021,3,ANTIOQUIA,840,1243,397,343,73,27,2923,32,381,30,103,546
LA PINTADA,2021,4,ANTIOQUIA,838,1241,395,342,73,27,2916,32,386,30,103,551
LA PINTADA,2021,5,ANTIOQUIA,838,1241,395,342,73,27,2916,30,388,30,103,551
LA PINTADA,2021,6,ANTIOQUIA,837,1243,395,342,73,27,2917,30,388,30,103,551
LA PINTADA,2021,7,ANTIOQUIA,837,1243,395,342,73,27,2917,30,390,30,103,553
LA PINTADA,2021,8,ANTIOQUIA,836,1242,395,342,73,27,2915,30,391,30,103,554
LA PINTADA,2021,9,ANTIOQUIA,833,1246,396,342,73,27,2917,30,392,30,103,555
LA PINTADA,2022,1,ANTIOQUIA,829,1248,399,339,73,27,2915,31,393,31,103,558
LA PINTADA,2022,10,ANTIOQUIA,828,1248,408,342,72,27,2925,34,399,31,103,567
LA PINTADA,2022,11,ANTIOQUIA,828,1245,408,342,72,27,2922,34,398,32,102,566
LA PINTADA,2022,12,ANTIOQUIA,827,1248,408,346,72,27,2928,34,398,32,101,565
LA PINTADA,2022,2,ANTIOQUIA,829,1248,399,341,73,27,2917,31,393,31,103,558
LA PINTADA,2022,3,ANTIOQUIA,829,1248,401,339,73,27,2917,31,393,31,103,558
LA PINTADA,2022,4,ANTIOQUIA,829,1247,401,338,73,27,2915,31,395,31,103,560
LA PINTADA,2022,5,ANTIOQUIA,829,1249,401,338,73,27,2917,31,396,31,103,561
LA PINTADA,2022,6,ANTIOQUIA,829,1250,405,338,73,27,2922,33,397,31,103,564
LA PINTADA,2022,7,ANTIOQUIA,830,1249,405,339,73,27,2923,33,399,31,102,565
LA PINTADA,2022,8,ANTIOQUIA,829,1249,404,342,72,27,2923,33,398,31,103,565
LA PINTADA,2022,9,ANTIOQUIA,829,1250,406,342,72,27,2926,34,399,31,103,567
LA PINTADA,2023,1,ANTIOQUIA,822,1235,408,346,72,27,2910,34,395,32,101,562
LA PINTADA,2023,2,ANTIOQUIA,823,1238,408,346,72,27,2914,34,394,32,101,561
LA PINTADA,2023,3,ANTIOQUIA,820,1234,408,346,72,27,2907,34,393,32,101,560
LA PINTADA,2023,4,ANTIOQUIA,821,1228,407,347,72,27,2902,34,393,32,99,558
LA PINTADA,2023,5,ANTIOQUIA,821,1225,410,347,72,27,2902,35,393,32,99,559
LA PINTADA,2023,6,ANTIOQUIA,816,1221,411,350,73,27,2898,34,391,32,99,556
LA PINTADA,2023,7,ANTIOQUIA,821,1209,410,350,73,27,2890,35,390,32,98,555
LA PINTADA,2023,8,ANTIOQUIA,824,1208,410,350,73,27,2892,37,392,32,98,559
LA PINTADA,2023,9,ANTIOQUIA,825,1210,410,350,73,27,2895,34,393,32,98,557
LA UNION,2018,1,ANTIOQUIA,732,4787,1996,40,9,0,7564,95,902,68,9,1074
LA UNION,2018,10,ANTIOQUIA,766,4805,2006,41,8,0,7626,97,909,72,8,1086
LA UNION,2018,11,ANTIOQUIA,769,4812,2007,42,8,0,7638,99,907,72,8,1086
LA UNION,2018,12,ANTIOQUIA,769,4827,2006,45,8,0,7655,101,909,72,8,1090
LA UNION,2018,2,ANTIOQUIA,726,4706,1976,40,9,0,7457,96,894,67,8,1065
LA UNION,2018,3,ANTIOQUIA,729,4716,1979,40,9,0,7473,95,895,67,8,1065
LA UNION,2018,4,ANTIOQUIA,731,4722,1987,40,9,0,7489,96,895,67,8,1066
LA UNION,2018,5,ANTIOQUIA,752,4831,2009,40,9,0,7641,95,906,66,9,1076
LA UNION,2018,6,ANTIOQUIA,741,4748,1991,40,9,0,7529,94,898,66,8,1066
LA UNION,2018,7,ANTIOQUIA,745,4772,1995,40,9,0,7561,97,898,66,8,1069
LA UNION,2018,8,ANTIOQUIA,758,4782,2005,41,9,0,7595,99,898,66,8,1071
LA UNION,2018,9,ANTIOQUIA,763,4795,2001,41,8,0,7608,99,907,72,8,1086
LA UNION,2019,1,ANTIOQUIA,744,4639,1920,45,8,0,7356,100,891,70,8,1069
LA UNION,2019,10,ANTIOQUIA,686,4542,1850,47,8,0,7133,100,886,71,8,1065
LA UNION,2019,11,ANTIOQUIA,703,4672,1859,47,8,0,7289,106,890,71,8,1075
LA UNION,2019,12,ANTIOQUIA,987,4320,1965,117,27,24,7440,104,906,73,8,1091
LA UNION,2019,2,ANTIOQUIA,753,4627,1930,46,8,0,7364,96,896,72,8,1072
LA UNION,2019,3,ANTIOQUIA,741,4637,1915,47,8,0,7348,98,891,70,8,1067
LA UNION,2019,4,ANTIOQUIA,762,4646,1927,46,8,0,7389,95,897,72,8,1072
LA UNION,2019,5,ANTIOQUIA,762,4672,1915,49,8,0,7406,100,899,70,8,1077
LA UNION,2019,6,ANTIOQUIA,767,4674,1925,46,8,0,7420,98,905,72,8,1083
LA UNION,2019,7,ANTIOQUIA,758,4692,1913,47,8,0,7418,103,899,70,8,1080
LA UNION,2019,8,ANTIOQUIA,766,4701,1927,46,8,0,7448,102,908,72,8,1090
LA UNION,2019,9,ANTIOQUIA,757,4731,1916,50,8,0,7462,105,900,71,8,1084
LA UNION,2020,1,ANTIOQUIA,1044,3883,1803,240,105,94,7169,102,885,71,8,1066
LA UNION,2020,10,ANTIOQUIA,1065,4049,1845,223,95,92,7369,106,902,71,144,1223
LA UNION,2020,11,ANTIOQUIA,1069,4061,1843,224,94,88,7379,104,901,71,144,1220
LA UNION,2020,12,ANTIOQUIA,1070,4078,1845,221,93,89,7396,104,899,71,144,1218
LA UNION,2020,2,ANTIOQUIA,1156,4329,1980,251,106,93,7915,111,926,78,143,1258
LA UNION,2020,3,ANTIOQUIA,1157,4341,1983,252,106,93,7932,111,926,78,144,1259
LA UNION,2020,4,ANTIOQUIA,1162,4356,1990,231,101,93,7933,116,930,73,144,1263
LA UNION,2020,5,ANTIOQUIA,1149,4267,1923,230,103,93,7765,111,922,73,144,1250
LA UNION,2020,6,ANTIOQUIA,1125,4147,1920,228,101,92,7613,110,918,73,144,1245
LA UNION,2020,7,ANTIOQUIA,1060,3952,1839,229,99,92,7271,106,898,71,144,1219
LA UNION,2020,8,ANTIOQUIA,1061,3993,1842,229,100,92,7317,106,898,71,144,1219
LA UNION,2020,9,ANTIOQUIA,1061,4019,1843,230,96,91,7340,106,897,71,144,1218
LA UNION,2021,1,ANTIOQUIA,1075,4085,1845,220,92,88,7405,106,901,71,144,1222
LA UNION,2021,10,ANTIOQUIA,1099,4178,1876,214,89,88,7544,113,919,73,144,1249
LA UNION,2021,11,ANTIOQUIA,1100,4186,1879,214,88,88,7555,115,917,73,144,1249
LA UNION,2021,12,ANTIOQUIA,1099,4197,1885,214,88,88,7571,117,918,74,144,1253
LA UNION,2021,2,ANTIOQUIA,1078,4101,1854,218,91,89,7431,108,903,71,144,1226
LA UNION,2021,3,ANTIOQUIA,1082,4109,1853,218,90,89,7441,107,905,71,144,1227
LA UNION,2021,4,ANTIOQUIA,1083,4120,1853,217,90,89,7452,110,904,71,144,1229
LA UNION,2021,5,ANTIOQUIA,1087,4130,1851,219,90,89,7466,110,909,71,144,1234
LA UNION,2021,6,ANTIOQUIA,1094,4137,1856,218,90,89,7484,111,909,71,144,1235
LA UNION,2021,7,ANTIOQUIA,1096,4145,1861,217,89,89,7497,111,912,71,144,1238
LA UNION,2021,8,ANTIOQUIA,1097,4147,1864,217,89,88,7502,111,911,72,143,1237
LA UNION,2021,9,ANTIOQUIA,1098,4156,1862,215,89,88,7508,112,917,73,143,1245
LA UNION,2022,1,ANTIOQUIA,1100,4218,1892,216,88,88,7602,118,922,74,144,1258
LA UNION,2022,10,ANTIOQUIA,1107,4331,1980,217,82,86,7803,124,949,73,144,1290
LA UNION,2022,11,ANTIOQUIA,1108,4349,1985,217,82,86,7827,121,951,75,144,1291
LA UNION,2022,12,ANTIOQUIA,1109,4356,1989,221,82,86,7843,124,950,76,144,1294
LA UNION,2022,2,ANTIOQUIA,1102,4233,1896,217,88,88,7624,117,933,74,144,1268
LA UNION,2022,3,ANTIOQUIA,1104,4249,1909,218,87,88,7655,113,939,76,144,1272
LA UNION,2022,4,ANTIOQUIA,1103,4257,1917,217,87,88,7669,114,939,76,144,1273
LA UNION,2022,5,ANTIOQUIA,1100,4275,1931,217,84,88,7695,114,941,76,144,1275
LA UNION,2022,6,ANTIOQUIA,1100,4284,1939,218,83,88,7712,114,941,76,144,1275
LA UNION,2022,7,ANTIOQUIA,1099,4287,1932,218,83,86,7705,115,940,73,144,1272
LA UNION,2022,8,ANTIOQUIA,1103,4301,1941,218,83,86,7732,117,946,73,144,1280
LA UNION,2022,9,ANTIOQUIA,1105,4313,1954,219,82,86,7759,119,946,73,144,1282
LA UNION,2023,1,ANTIOQUIA,1113,4368,1992,221,83,86,7863,124,950,76,144,1294
LA UNION,2023,2,ANTIOQUIA,1117,4377,1997,221,83,86,7881,126,950,76,144,1296
LA UNION,2023,3,ANTIOQUIA,1125,4394,2011,220,83,86,7919,125,954,76,144,1299
LA UNION,2023,4,ANTIOQUIA,1128,4414,2017,220,83,86,7948,126,956,76,144,1302
LA UNION,2023,5,ANTIOQUIA,1137,4436,2020,220,83,86,7982,126,956,77,144,1303
LA UNION,2023,6,ANTIOQUIA,1141,4461,2023,223,84,86,8018,126,960,77,144,1307
LA UNION,2023,7,ANTIOQUIA,1146,4489,2023,221,84,86,8049,125,962,77,144,1308
LA UNION,2023,8,ANTIOQUIA,1152,4492,2031,260,84,86,8105,125,960,77,144,1306
LA UNION,2023,9,ANTIOQUIA,1156,4526,2035,259,82,86,8144,127,965,78,144,1314
LIBORINA,2018,1,ANTIOQUIA,1901,1759,441,3,0,0,4104,11,205,66,9,291
LIBORINA,2018,10,ANTIOQUIA,2182,1610,363,13,1,0,4169,12,209,66,9,296
LIBORINA,2018,11,ANTIOQUIA,2195,1608,355,13,1,0,4172,12,209,67,9,297
LIBORINA,2018,12,ANTIOQUIA,2204,1613,347,14,1,0,4179,12,209,67,9,297
LIBORINA,2018,2,ANTIOQUIA,1903,1762,441,3,0,0,4109,11,205,66,9,291
LIBORINA,2018,3,ANTIOQUIA,1904,1764,441,3,0,0,4112,11,210,66,9,296
LIBORINA,2018,4,ANTIOQUIA,1915,1768,438,3,0,0,4124,11,210,66,9,296
LIBORINA,2018,5,ANTIOQUIA,1917,1766,438,3,0,0,4124,11,210,66,9,296
LIBORINA,2018,6,ANTIOQUIA,1987,1710,431,3,0,0,4131,11,210,66,9,296
LIBORINA,2018,7,ANTIOQUIA,2130,1605,388,13,1,0,4137,12,210,66,9,297
LIBORINA,2018,8,ANTIOQUIA,2133,1607,386,13,1,0,4140,12,210,66,9,297
LIBORINA,2018,9,ANTIOQUIA,2156,1601,372,13,1,0,4143,12,210,66,9,297
LIBORINA,2019,1,ANTIOQUIA,2215,1631,346,15,1,0,4208,12,209,67,10,298
LIBORINA,2019,10,ANTIOQUIA,2261,1684,327,11,0,0,4283,12,215,67,9,303
LIBORINA,2019,11,ANTIOQUIA,2262,1667,327,11,0,0,4267,12,216,67,9,304
LIBORINA,2019,12,ANTIOQUIA,2266,1687,326,11,0,0,4290,12,216,67,9,304
LIBORINA,2019,2,ANTIOQUIA,2219,1624,344,14,0,0,4201,12,211,67,9,299
LIBORINA,2019,3,ANTIOQUIA,2226,1647,343,14,0,0,4230,12,211,67,9,299
LIBORINA,2019,4,ANTIOQUIA,2229,1659,338,15,0,0,4241,12,212,67,9,300
LIBORINA,2019,5,ANTIOQUIA,2236,1651,336,15,0,0,4238,12,212,67,9,300
LIBORINA,2019,6,ANTIOQUIA,2241,1670,334,15,0,0,4260,12,212,67,9,300
LIBORINA,2019,7,ANTIOQUIA,2246,1671,336,11,0,0,4264,12,212,67,9,300
LIBORINA,2019,8,ANTIOQUIA,2250,1661,329,11,0,0,4251,12,215,67,9,303
LIBORINA,2019,9,ANTIOQUIA,2256,1679,329,11,0,0,4275,12,215,67,9,303
LIBORINA,2020,1,ANTIOQUIA,2267,1687,323,15,0,0,4292,12,216,67,9,304
LIBORINA,2020,10,ANTIOQUIA,2301,1705,324,13,0,0,4343,11,224,67,60,362
LIBORINA,2020,11,ANTIOQUIA,2302,1706,328,13,0,0,4349,11,223,67,60,361
LIBORINA,2020,12,ANTIOQUIA,2302,1705,327,13,0,0,4347,11,224,67,60,362
LIBORINA,2020,2,ANTIOQUIA,2271,1688,323,18,0,0,4300,12,216,74,60,362
LIBORINA,2020,3,ANTIOQUIA,2273,1691,323,18,0,0,4305,12,216,74,60,362
LIBORINA,2020,4,ANTIOQUIA,2279,1692,322,11,0,0,4304,12,223,67,60,362
LIBORINA,2020,5,ANTIOQUIA,2285,1696,322,12,0,0,4315,12,223,67,60,362
LIBORINA,2020,6,ANTIOQUIA,2286,1696,322,12,0,0,4316,12,224,67,60,363
LIBORINA,2020,7,ANTIOQUIA,2288,1697,322,13,0,0,4320,12,224,67,60,363
LIBORINA,2020,8,ANTIOQUIA,2294,1700,322,13,0,0,4329,12,224,67,60,363
LIBORINA,2020,9,ANTIOQUIA,2299,1701,324,13,0,0,4337,12,223,67,60,362
LIBORINA,2021,1,ANTIOQUIA,2307,1710,333,13,0,0,4363,11,224,67,60,362
LIBORINA,2021,10,ANTIOQUIA,2348,1734,328,13,0,0,4423,11,227,67,60,365
LIBORINA,2021,11,ANTIOQUIA,2349,1743,328,13,0,0,4433,11,227,67,60,365
LIBORINA,2021,12,ANTIOQUIA,2351,1746,329,13,0,0,4439,11,226,67,60,364
LIBORINA,2021,2,ANTIOQUIA,2316,1710,333,12,0,0,4371,11,224,67,60,362
LIBORINA,2021,3,ANTIOQUIA,2318,1710,332,12,0,0,4372,11,224,67,60,362
LIBORINA,2021,4,ANTIOQUIA,2329,1720,326,12,0,0,4387,11,224,67,60,362
LIBORINA,2021,5,ANTIOQUIA,2333,1724,324,12,0,0,4393,11,225,67,60,363
LIBORINA,2021,6,ANTIOQUIA,2336,1724,324,12,0,0,4396,11,226,67,60,364
LIBORINA,2021,7,ANTIOQUIA,2337,1726,326,13,0,0,4402,11,226,67,60,364
LIBORINA,2021,8,ANTIOQUIA,2342,1727,327,13,0,0,4409,11,225,67,60,363
LIBORINA,2021,9,ANTIOQUIA,2345,1734,328,13,0,0,4420,11,226,67,60,364
LIBORINA,2022,1,ANTIOQUIA,2352,1748,328,13,0,0,4441,11,226,67,60,364
LIBORINA,2022,10,ANTIOQUIA,2384,1783,330,14,0,0,4511,10,231,67,59,367
LIBORINA,2022,11,ANTIOQUIA,2399,1788,330,14,0,0,4531,10,231,67,59,367
LIBORINA,2022,12,ANTIOQUIA,2400,1793,329,14,0,0,4536,10,230,67,59,366
LIBORINA,2022,2,ANTIOQUIA,2357,1751,328,13,0,0,4449,10,226,67,60,363
LIBORINA,2022,3,ANTIOQUIA,2362,1761,328,14,0,0,4465,10,229,67,59,365
LIBORINA,2022,4,ANTIOQUIA,2367,1764,330,14,0,0,4475,10,230,67,59,366
LIBORINA,2022,5,ANTIOQUIA,2363,1773,331,14,0,0,4481,10,230,67,59,366
LIBORINA,2022,6,ANTIOQUIA,2371,1774,330,13,0,0,4488,10,230,67,59,366
LIBORINA,2022,7,ANTIOQUIA,2361,1761,328,14,0,0,4464,10,230,67,59,366
LIBORINA,2022,8,ANTIOQUIA,2376,1766,329,14,0,0,4485,10,230,67,59,366
LIBORINA,2022,9,ANTIOQUIA,2377,1774,331,14,0,0,4496,10,230,67,59,366
LIBORINA,2023,1,ANTIOQUIA,2405,1796,332,14,0,0,4547,10,230,67,59,366
LIBORINA,2023,2,ANTIOQUIA,2406,1798,331,14,0,0,4549,10,230,67,59,366
LIBORINA,2023,3,ANTIOQUIA,2421,1810,332,14,0,0,4577,10,230,67,59,366
LIBORINA,2023,4,ANTIOQUIA,2431,1814,333,14,0,0,4592,10,230,67,59,366
LIBORINA,2023,5,ANTIOQUIA,2438,1825,335,14,0,0,4612,10,230,67,59,366
LIBORINA,2023,6,ANTIOQUIA,2448,1830,335,13,0,0,4626,11,230,68,59,368
LIBORINA,2023,7,ANTIOQUIA,2453,1836,334,13,0,0,4636,11,231,68,59,369
LIBORINA,2023,8,ANTIOQUIA,2463,1840,334,13,0,0,4650,11,231,68,59,369
LIBORINA,2023,9,ANTIOQUIA,2471,1841,335,13,0,0,4660,11,233,68,59,371
MACEO,2018,1,ANTIOQUIA,1092,2168,264,12,6,0,3542,28,268,61,5,362
MACEO,2018,10,ANTIOQUIA,1099,2169,261,14,6,0,3549,24,264,62,5,355
MACEO,2018,11,ANTIOQUIA,1099,2162,261,13,6,0,3541,24,264,62,5,355
MACEO,2018,12,ANTIOQUIA,1100,2161,261,14,6,0,3542,24,263,62,5,354
MACEO,2018,2,ANTIOQUIA,1090,2168,264,12,6,0,3540,27,266,61,5,359
MACEO,2018,3,ANTIOQUIA,1095,2169,264,12,6,0,3546,27,266,61,5,359
MACEO,2018,4,ANTIOQUIA,1097,2171,264,12,6,0,3550,27,266,61,5,359
MACEO,2018,5,ANTIOQUIA,1092,2168,262,13,6,0,3541,26,264,62,5,357
MACEO,2018,6,ANTIOQUIA,1099,2171,261,13,6,0,3550,26,265,62,5,358
MACEO,2018,7,ANTIOQUIA,1103,2175,261,13,6,0,3558,26,264,62,5,357
MACEO,2018,8,ANTIOQUIA,1105,2173,262,14,6,0,3560,26,264,62,5,357
MACEO,2018,9,ANTIOQUIA,1095,2164,261,14,6,0,3540,24,264,62,5,355
MACEO,2019,1,ANTIOQUIA,1101,2167,261,17,6,0,3552,24,262,62,5,353
MACEO,2019,10,ANTIOQUIA,1137,1911,397,66,31,54,3596,22,267,61,5,355
MACEO,2019,11,ANTIOQUIA,1156,1927,399,56,31,35,3604,22,266,61,5,354
MACEO,2019,12,ANTIOQUIA,1159,1939,404,49,31,32,3614,23,267,61,5,356
MACEO,2019,2,ANTIOQUIA,1104,2167,260,16,6,0,3553,23,262,62,5,352
MACEO,2019,3,ANTIOQUIA,1152,2025,302,35,17,27,3558,23,263,62,5,353
MACEO,2019,4,ANTIOQUIA,1065,1996,363,58,27,46,3555,22,267,62,5,356
MACEO,2019,5,ANTIOQUIA,1109,1912,404,66,32,54,3577,22,268,62,5,357
MACEO,2019,6,ANTIOQUIA,1103,1903,402,65,32,54,3559,22,266,62,5,355
MACEO,2019,7,ANTIOQUIA,1104,1903,403,65,31,54,3560,22,266,62,5,355
MACEO,2019,8,ANTIOQUIA,1111,1902,402,65,31,54,3565,22,266,61,5,354
MACEO,2019,9,ANTIOQUIA,1123,1907,400,66,31,54,3581,22,267,61,5,355
MACEO,2020,1,ANTIOQUIA,1167,1933,400,53,31,34,3618,22,267,61,5,355
MACEO,2020,10,ANTIOQUIA,1184,1967,403,48,31,32,3665,26,271,61,49,407
MACEO,2020,11,ANTIOQUIA,1184,1972,403,48,31,32,3670,26,271,61,49,407
MACEO,2020,12,ANTIOQUIA,1189,1987,404,51,33,32,3696,26,271,62,49,408
MACEO,2020,2,ANTIOQUIA,1165,1936,400,52,31,32,3616,24,268,63,49,404
MACEO,2020,3,ANTIOQUIA,1166,1935,400,53,31,32,3617,26,268,63,49,406
MACEO,2020,4,ANTIOQUIA,1170,1942,399,48,31,32,3622,26,270,61,49,406
MACEO,2020,5,ANTIOQUIA,1173,1952,399,48,31,36,3639,26,270,61,49,406
MACEO,2020,6,ANTIOQUIA,1173,1957,402,48,31,33,3644,26,271,61,49,407
MACEO,2020,7,ANTIOQUIA,1176,1956,401,48,31,33,3645,26,271,61,49,407
MACEO,2020,8,ANTIOQUIA,1178,1958,400,48,31,33,3648,26,271,61,49,407
MACEO,2020,9,ANTIOQUIA,1179,1965,402,48,31,33,3658,26,271,61,49,407
MACEO,2021,1,ANTIOQUIA,1190,1991,404,50,33,32,3700,25,271,62,49,407
MACEO,2021,10,ANTIOQUIA,1217,2036,405,49,33,30,3770,25,272,63,49,409
MACEO,2021,11,ANTIOQUIA,1216,2036,406,48,33,29,3768,26,272,63,49,410
MACEO,2021,12,ANTIOQUIA,1218,2044,405,48,33,31,3779,27,273,63,49,412
MACEO,2021,2,ANTIOQUIA,1200,1999,406,50,33,32,3720,25,271,62,49,407
MACEO,2021,3,ANTIOQUIA,1202,2008,405,49,33,32,3729,25,271,62,49,407
MACEO,2021,4,ANTIOQUIA,1204,2008,404,50,33,32,3731,25,272,62,49,408
MACEO,2021,5,ANTIOQUIA,1203,2010,404,50,33,32,3732,25,272,62,48,407
MACEO,2021,6,ANTIOQUIA,1205,2010,404,50,33,32,3734,25,272,62,49,408
MACEO,2021,7,ANTIOQUIA,1208,2015,404,50,33,32,3742,25,272,62,49,408
MACEO,2021,8,ANTIOQUIA,1213,2023,404,49,33,31,3753,25,270,62,49,406
MACEO,2021,9,ANTIOQUIA,1212,2029,405,49,33,31,3759,25,271,62,49,407
MACEO,2022,1,ANTIOQUIA,1215,2050,407,48,33,30,3783,27,273,63,51,414
MACEO,2022,10,ANTIOQUIA,1241,2146,416,46,30,30,3909,24,279,64,52,419
MACEO,2022,11,ANTIOQUIA,1241,2151,414,46,30,30,3912,24,280,64,53,421
MACEO,2022,12,ANTIOQUIA,1242,2158,414,44,30,30,3918,24,280,64,53,421
MACEO,2022,2,ANTIOQUIA,1219,2057,406,48,33,30,3793,27,273,63,51,414
MACEO,2022,3,ANTIOQUIA,1221,2082,412,51,33,30,3829,26,274,64,50,414
MACEO,2022,4,ANTIOQUIA,1229,2089,413,52,33,30,3846,26,274,64,50,414
MACEO,2022,5,ANTIOQUIA,1225,2096,415,51,33,30,3850,25,275,64,50,414
MACEO,2022,6,ANTIOQUIA,1232,2099,415,51,32,30,3859,25,275,64,50,414
MACEO,2022,7,ANTIOQUIA,1227,2105,415,46,32,30,3855,25,275,64,50,414
MACEO,2022,8,ANTIOQUIA,1228,2111,416,46,32,30,3863,24,277,64,51,416
MACEO,2022,9,ANTIOQUIA,1225,2123,416,45,31,30,3870,24,277,64,51,416
MACEO,2023,1,ANTIOQUIA,1232,2177,414,44,31,30,3928,24,279,64,53,420
MACEO,2023,2,ANTIOQUIA,1242,2184,415,44,31,30,3946,24,283,64,53,424
MACEO,2023,3,ANTIOQUIA,1246,2196,414,45,31,30,3962,25,283,64,53,425
MACEO,2023,4,ANTIOQUIA,1239,2195,413,44,31,30,3952,25,282,64,53,424
MACEO,2023,5,ANTIOQUIA,1244,2202,412,44,30,30,3962,25,283,64,53,425
MACEO,2023,6,ANTIOQUIA,1242,2198,412,44,30,30,3956,25,286,63,53,427
MACEO,2023,7,ANTIOQUIA,1247,2207,411,44,28,30,3967,25,286,63,54,428
MACEO,2023,8,ANTIOQUIA,1249,2216,411,42,29,29,3976,25,287,63,54,429
MACEO,2023,9,ANTIOQUIA,1258,2230,412,43,29,28,4000,26,287,63,54,430
MARINILLA,2018,1,ANTIOQUIA,1702,5297,11784,862,163,7,19815,129,1447,86,29,1691
MARINILLA,2018,10,ANTIOQUIA,2186,5124,12170,901,147,6,20534,131,1492,86,31,1740
MARINILLA,2018,11,ANTIOQUIA,2190,5197,12161,896,144,5,20593,130,1498,86,30,1744
MARINILLA,2018,12,ANTIOQUIA,2196,5216,12196,905,143,4,20660,129,1499,86,25,1739
MARINILLA,2018,2,ANTIOQUIA,2096,4923,11879,893,176,7,19974,128,1437,85,29,1679
MARINILLA,2018,3,ANTIOQUIA,2104,4953,11892,894,175,6,20024,127,1444,85,29,1685
MARINILLA,2018,4,ANTIOQUIA,2105,4984,11941,887,159,6,20082,129,1448,86,29,1692
MARINILLA,2018,5,ANTIOQUIA,2105,5025,11965,890,156,6,20147,129,1465,86,29,1709
MARINILLA,2018,6,ANTIOQUIA,2141,5050,11989,889,150,6,20225,128,1464,86,29,1707
MARINILLA,2018,7,ANTIOQUIA,2150,5062,12011,895,146,6,20270,129,1474,86,29,1718
MARINILLA,2018,8,ANTIOQUIA,2173,5072,12098,897,144,6,20390,130,1483,86,24,1723
MARINILLA,2018,9,ANTIOQUIA,2177,5084,12116,897,146,6,20426,130,1484,86,29,1729
MARINILLA,2019,1,ANTIOQUIA,2196,5240,12228,902,141,4,20711,131,1501,86,30,1748
MARINILLA,2019,10,ANTIOQUIA,2277,5426,12579,926,141,4,21353,137,1532,88,30,1787
MARINILLA,2019,11,ANTIOQUIA,2283,5443,12592,946,141,4,21409,136,1538,88,30,1792
MARINILLA,2019,12,ANTIOQUIA,2292,5475,12625,948,141,4,21485,136,1543,88,30,1797
MARINILLA,2019,2,ANTIOQUIA,2204,5293,12309,905,141,4,20856,128,1503,86,30,1747
MARINILLA,2019,3,ANTIOQUIA,2214,5301,12311,905,141,4,20876,132,1512,86,30,1760
MARINILLA,2019,4,ANTIOQUIA,2220,5306,12363,906,142,4,20941,134,1513,86,30,1763
MARINILLA,2019,5,ANTIOQUIA,2226,5324,12396,920,141,4,21011,138,1514,86,30,1768
MARINILLA,2019,6,ANTIOQUIA,2240,5339,12412,921,141,4,21057,138,1524,86,30,1778
MARINILLA,2019,7,ANTIOQUIA,2252,5357,12453,950,141,4,21157,139,1523,86,30,1778
MARINILLA,2019,8,ANTIOQUIA,2259,5383,12494,943,141,4,21224,136,1526,87,30,1779
MARINILLA,2019,9,ANTIOQUIA,2270,5406,12516,945,141,4,21282,134,1528,88,30,1780
MARINILLA,2020,1,ANTIOQUIA,2300,5471,12662,980,141,4,21558,136,1539,88,30,1793
MARINILLA,2020,10,ANTIOQUIA,2391,5647,12947,1033,224,4,22246,143,1605,92,528,2368
MARINILLA,2020,11,ANTIOQUIA,2399,5683,13005,1035,224,4,22350,143,1606,92,528,2369
MARINILLA,2020,12,ANTIOQUIA,2409,5697,13021,1116,148,4,22395,145,1621,92,527,2385
MARINILLA,2020,2,ANTIOQUIA,2307,5488,12670,1021,140,4,21630,144,1561,103,528,2336
MARINILLA,2020,3,ANTIOQUIA,2313,5496,12698,1027,140,4,21678,144,1564,103,528,2339
MARINILLA,2020,4,ANTIOQUIA,2334,5540,12728,956,142,4,21704,140,1573,88,528,2329
MARINILLA,2020,5,ANTIOQUIA,2347,5556,12740,963,154,4,21764,133,1587,88,528,2336
MARINILLA,2020,6,ANTIOQUIA,2351,5575,12768,961,145,4,21804,142,1575,90,528,2335
MARINILLA,2020,7,ANTIOQUIA,2354,5589,12788,1019,146,4,21900,142,1593,90,528,2353
MARINILLA,2020,8,ANTIOQUIA,2364,5612,12847,1018,145,4,21990,142,1607,91,528,2368
MARINILLA,2020,9,ANTIOQUIA,2370,5626,12911,1022,225,4,22158,141,1603,92,528,2364
MARINILLA,2021,1,ANTIOQUIA,2420,5717,13037,1120,145,4,22443,146,1623,92,527,2388
MARINILLA,2021,10,ANTIOQUIA,2497,6108,13465,1192,137,4,23403,144,1667,93,527,2431
MARINILLA,2021,11,ANTIOQUIA,2502,6144,13509,1189,136,4,23484,146,1672,93,527,2438
MARINILLA,2021,12,ANTIOQUIA,2514,6176,13535,1186,136,4,23551,149,1692,93,527,2461
MARINILLA,2021,2,ANTIOQUIA,2429,5742,13054,1117,145,4,22491,145,1628,93,527,2393
MARINILLA,2021,3,ANTIOQUIA,2442,5840,13096,1149,147,4,22678,146,1628,93,527,2394
MARINILLA,2021,4,ANTIOQUIA,2451,5887,13135,1140,144,4,22761,146,1629,93,526,2394
MARINILLA,2021,5,ANTIOQUIA,2462,5972,13203,1142,144,4,22927,147,1649,93,526,2415
MARINILLA,2021,6,ANTIOQUIA,2457,6000,13265,1163,143,4,23032,147,1660,93,527,2427
MARINILLA,2021,7,ANTIOQUIA,2465,6033,13294,1194,142,4,23132,147,1662,93,527,2429
MARINILLA,2021,8,ANTIOQUIA,2473,6060,13395,1192,142,4,23266,147,1663,93,527,2430
MARINILLA,2021,9,ANTIOQUIA,2483,6080,13428,1192,141,4,23328,146,1666,93,527,2432
MARINILLA,2022,1,ANTIOQUIA,2522,6204,13669,1188,137,4,23724,150,1690,93,527,2460
MARINILLA,2022,10,ANTIOQUIA,2553,6561,14303,1187,135,4,24743,160,1762,100,539,2561
MARINILLA,2022,11,ANTIOQUIA,2575,6578,14364,1180,135,4,24836,158,1771,103,543,2575
MARINILLA,2022,12,ANTIOQUIA,2585,6593,14389,1180,134,4,24885,160,1773,102,546,2581
MARINILLA,2022,2,ANTIOQUIA,2527,6226,13817,1186,138,4,23898,152,1701,93,527,2473
MARINILLA,2022,3,ANTIOQUIA,2537,6289,13998,1189,138,4,24155,147,1700,100,526,2473
MARINILLA,2022,4,ANTIOQUIA,2525,6316,14021,1188,140,4,24194,149,1702,101,526,2478
MARINILLA,2022,5,ANTIOQUIA,2533,6352,14039,1193,140,4,24261,149,1715,101,529,2494
MARINILLA,2022,6,ANTIOQUIA,2541,6413,14062,1193,139,4,24352,149,1730,101,530,2510
MARINILLA,2022,7,ANTIOQUIA,2536,6444,14177,1194,137,4,24492,154,1747,100,531,2532
MARINILLA,2022,8,ANTIOQUIA,2536,6488,14205,1193,136,4,24562,155,1750,100,534,2539
MARINILLA,2022,9,ANTIOQUIA,2547,6522,14254,1194,135,4,24656,158,1755,100,538,2551
MARINILLA,2023,1,ANTIOQUIA,2597,6607,14486,1182,135,4,25011,160,1776,102,546,2584
MARINILLA,2023,2,ANTIOQUIA,2607,6632,14513,1180,135,4,25071,161,1778,102,546,2587
MARINILLA,2023,3,ANTIOQUIA,2632,6684,14558,1185,137,5,25201,162,1782,101,546,2591
MARINILLA,2023,4,ANTIOQUIA,2645,6723,14593,1187,137,5,25290,167,1788,101,546,2602
MARINILLA,2023,5,ANTIOQUIA,2657,6756,14642,1184,135,5,25379,164,1795,101,546,2606
MARINILLA,2023,6,ANTIOQUIA,2678,6791,14742,1189,135,5,25540,169,1805,101,546,2621
MARINILLA,2023,7,ANTIOQUIA,2703,6817,14806,1187,135,5,25653,170,1814,101,547,2632
MARINILLA,2023,8,ANTIOQUIA,2714,6833,14879,1185,135,5,25751,175,1817,101,547,2640
MARINILLA,2023,9,ANTIOQUIA,2740,6861,14941,1189,133,5,25869,177,1817,101,547,2642
MEDELLÃN,2018,1,ANTIOQUIA,109392,278806,243868,94734,70725,38180,835705,6460,72642,1709,1743,82554
MEDELLÃN,2018,10,ANTIOQUIA,113674,284180,247446,97587,71314,38452,852653,6831,73460,1733,1774,83798
MEDELLÃN,2018,11,ANTIOQUIA,113765,283753,247480,97809,71364,38443,852614,6859,73902,1730,1788,84279
MEDELLÃN,2018,12,ANTIOQUIA,114035,284217,248116,97393,71005,37359,852125,6893,72887,1733,1791,83304
MEDELLÃN,2018,2,ANTIOQUIA,110123,279220,244181,94925,71141,38086,837676,6440,72597,1709,1743,82489
MEDELLÃN,2018,3,ANTIOQUIA,110605,279510,244455,95236,71142,38154,839102,6462,72599,1714,1750,82525
MEDELLÃN,2018,4,ANTIOQUIA,111202,280030,244821,95853,70997,38152,841055,6492,72823,1720,1757,82792
MEDELLÃN,2018,5,ANTIOQUIA,111354,280331,244822,96108,71023,38200,841838,6532,72678,1711,1762,82683
MEDELLÃN,2018,6,ANTIOQUIA,111751,280917,245478,96459,71078,38270,843953,6671,72732,1724,1765,82892
MEDELLÃN,2018,7,ANTIOQUIA,112067,281754,245986,96838,71208,38313,846166,6699,72852,1728,1775,83054
MEDELLÃN,2018,8,ANTIOQUIA,112602,282327,246510,97161,71291,38391,848282,6749,73218,1730,1774,83471
MEDELLÃN,2018,9,ANTIOQUIA,113147,282770,246685,97270,71242,38384,849498,6769,73308,1729,1772,83578
MEDELLÃN,2019,1,ANTIOQUIA,114150,284662,248682,97916,71628,38395,855433,6911,73948,1727,1784,84370
MEDELLÃN,2019,10,ANTIOQUIA,118090,289759,251736,99362,72798,39053,870798,7140,74462,1731,1806,85139
MEDELLÃN,2019,11,ANTIOQUIA,118595,290567,251855,99561,72640,39063,872281,7150,74709,1743,1806,85408
MEDELLÃN,2019,12,ANTIOQUIA,119316,291561,251972,99704,72629,39222,874404,7200,75241,1756,1810,86007
MEDELLÃN,2019,2,ANTIOQUIA,114431,285117,248924,98693,71591,38546,857302,6954,73894,1726,1785,84359
MEDELLÃN,2019,3,ANTIOQUIA,114827,285595,249106,98822,71685,38579,858614,6985,73965,1727,1788,84465
MEDELLÃN,2019,4,ANTIOQUIA,115357,285931,249688,98464,71767,38584,859791,7003,74216,1720,1786,84725
MEDELLÃN,2019,5,ANTIOQUIA,115862,286894,250034,98594,71822,38583,861789,7060,74328,1723,1792,84903
MEDELLÃN,2019,6,ANTIOQUIA,116267,287430,250196,98868,71915,38585,863261,7088,74126,1723,1795,84732
MEDELLÃN,2019,7,ANTIOQUIA,116817,288112,250625,98978,71985,38588,865105,7073,74141,1727,1797,84738
MEDELLÃN,2019,8,ANTIOQUIA,117262,288384,251116,98762,72302,38913,866739,7115,74359,1730,1798,85002
MEDELLÃN,2019,9,ANTIOQUIA,117705,288796,251551,99201,72447,39005,868705,7131,74343,1737,1799,85010
MEDELLÃN,2020,1,ANTIOQUIA,119193,291971,251943,99994,72880,39221,875202,7192,75337,1754,1812,86095
MEDELLÃN,2020,10,ANTIOQUIA,122482,296943,254311,100349,73725,38528,886338,7270,78471,1820,15798,103359
MEDELLÃN,2020,11,ANTIOQUIA,122879,297741,254494,100830,73471,38529,887944,7253,78556,1782,15802,103393
MEDELLÃN,2020,12,ANTIOQUIA,124196,298447,254096,100896,73516,38787,889938,7296,78625,1825,15805,103551
MEDELLÃN,2020,2,ANTIOQUIA,119704,292810,252267,99907,73913,38192,876793,7291,76684,2969,15817,102761
MEDELLÃN,2020,3,ANTIOQUIA,120066,293282,252466,100051,73960,38192,878017,7283,76795,2969,15805,102852
MEDELLÃN,2020,4,ANTIOQUIA,120548,293840,252867,99705,73987,38193,879140,7232,78070,1769,15816,102887
MEDELLÃN,2020,5,ANTIOQUIA,120945,294444,253262,99966,74319,38176,881112,7556,79301,2083,15816,104756
MEDELLÃN,2020,6,ANTIOQUIA,121133,294781,253188,100038,73948,38331,881419,7267,78244,1783,15813,103107
MEDELLÃN,2020,7,ANTIOQUIA,121451,295294,253555,100196,73705,38346,882547,7308,78334,1830,15813,103285
MEDELLÃN,2020,8,ANTIOQUIA,121696,295795,253738,100153,73690,38334,883406,7255,78334,1812,15818,103219
MEDELLÃN,2020,9,ANTIOQUIA,122034,296292,254064,100173,73633,38511,884707,7272,78434,1816,15819,103341
MEDELLÃN,2021,1,ANTIOQUIA,124499,298980,254422,100916,73513,38874,891204,7287,78715,1824,15804,103630
MEDELLÃN,2021,10,ANTIOQUIA,128447,305932,257713,101922,74403,39356,907773,7383,79947,1836,15795,104961
MEDELLÃN,2021,11,ANTIOQUIA,128907,306669,257706,102408,74517,39302,909509,7397,80027,1846,15794,105064
MEDELLÃN,2021,12,ANTIOQUIA,129315,307598,258603,102852,74573,39319,912260,7406,80069,1862,15790,105127
MEDELLÃN,2021,2,ANTIOQUIA,124867,299617,254668,100887,73684,38873,892596,7315,78826,1829,15805,103775
MEDELLÃN,2021,3,ANTIOQUIA,125297,300284,255056,100928,73734,38882,894181,7327,78989,1831,15805,103952
MEDELLÃN,2021,4,ANTIOQUIA,125706,300873,255198,101053,73819,38896,895545,7351,79053,1842,15805,104051
MEDELLÃN,2021,5,ANTIOQUIA,126057,301447,255575,101256,73987,38925,897247,7359,79108,1849,15797,104113
MEDELLÃN,2021,6,ANTIOQUIA,126254,301817,255730,101259,74066,38944,898070,7345,79147,1811,15802,104105
MEDELLÃN,2021,7,ANTIOQUIA,126812,302793,256352,101414,74136,38949,900456,7349,79518,1810,15802,104479
MEDELLÃN,2021,8,ANTIOQUIA,127410,303899,257102,101655,74281,39043,903390,7366,79666,1822,15793,104647
MEDELLÃN,2021,9,ANTIOQUIA,127966,304746,257418,101872,74376,39069,905447,7369,79911,1827,15801,104908
MEDELLÃN,2022,1,ANTIOQUIA,129638,308275,258828,102923,74604,39326,913594,7435,80218,1866,15789,105308
MEDELLÃN,2022,10,ANTIOQUIA,132213,313363,262690,105046,77127,40251,930690,7636,80766,1997,15781,106180
MEDELLÃN,2022,11,ANTIOQUIA,132771,314752,263145,104539,76967,40487,932661,7652,80791,1996,15780,106219
MEDELLÃN,2022,12,ANTIOQUIA,133114,315362,263457,104608,77054,40694,934289,7658,80906,2000,15779,106343
MEDELLÃN,2022,2,ANTIOQUIA,130050,308931,259639,102835,74668,39345,915468,7445,80255,1883,15788,105371
MEDELLÃN,2022,3,ANTIOQUIA,130579,309733,259701,103290,74791,39334,917428,7465,80268,1898,15774,105405
MEDELLÃN,2022,4,ANTIOQUIA,129934,311047,260679,103234,74838,39423,919155,7489,80337,1931,15775,105532
MEDELLÃN,2022,5,ANTIOQUIA,129158,311051,262669,103858,74723,40044,921503,7503,80378,1947,15776,105604
MEDELLÃN,2022,6,ANTIOQUIA,129898,310759,261543,105121,75734,40303,923358,7527,80467,1964,15775,105733
MEDELLÃN,2022,7,ANTIOQUIA,130880,311171,261828,104627,76729,40195,925430,7559,80504,1972,15772,105807
MEDELLÃN,2022,8,ANTIOQUIA,131372,311932,262073,104830,76804,40286,927297,7584,80606,1980,15772,105942
MEDELLÃN,2022,9,ANTIOQUIA,131879,312684,262340,104947,76804,40367,929021,7618,80707,1987,15782,106094
MEDELLÃN,2023,1,ANTIOQUIA,133394,315880,263758,104651,77279,40740,935702,7665,80946,2003,15779,106393
MEDELLÃN,2023,2,ANTIOQUIA,133841,316686,264292,104855,77463,40734,937871,7687,81020,2003,15781,106491
MEDELLÃN,2023,3,ANTIOQUIA,134281,317415,264588,105218,77549,40737,939788,7710,81058,2008,15784,106560
MEDELLÃN,2023,4,ANTIOQUIA,134702,318081,265109,105294,77598,40736,941520,7774,81105,2022,15786,106687
MEDELLÃN,2023,5,ANTIOQUIA,135031,318539,265637,105436,77708,40739,943090,7773,81029,2050,15784,106636
MEDELLÃN,2023,6,ANTIOQUIA,135226,318956,265739,105495,77677,40712,943805,7766,80805,2083,15785,106439
MEDELLÃN,2023,7,ANTIOQUIA,135586,319471,266371,105569,77740,40831,945568,7795,80695,2104,15780,106374
MEDELLÃN,2023,8,ANTIOQUIA,135968,320132,266715,105790,77812,41026,947443,7836,80963,2106,15781,106686
MEDELLÃN,2023,9,ANTIOQUIA,136438,321071,266820,105961,76527,40983,947800,7804,82193,2105,15790,107892
MONTEBELLO,2018,1,ANTIOQUIA,1650,963,393,6,2,2,3016,11,121,60,2,194
MONTEBELLO,2018,10,ANTIOQUIA,1674,986,397,6,2,2,3067,11,122,59,2,194
MONTEBELLO,2018,11,ANTIOQUIA,1690,995,399,7,2,2,3095,11,122,59,2,194
MONTEBELLO,2018,12,ANTIOQUIA,1691,996,399,9,2,2,3099,11,122,59,2,194
MONTEBELLO,2018,2,ANTIOQUIA,1655,968,392,6,2,2,3025,11,121,60,2,194
MONTEBELLO,2018,3,ANTIOQUIA,1656,970,392,6,2,2,3028,11,121,60,2,194
MONTEBELLO,2018,4,ANTIOQUIA,1657,972,393,6,2,2,3032,11,121,60,2,194
MONTEBELLO,2018,5,ANTIOQUIA,1654,975,395,6,2,2,3034,11,122,59,2,194
MONTEBELLO,2018,6,ANTIOQUIA,1657,976,397,6,2,2,3040,11,121,59,2,193
MONTEBELLO,2018,7,ANTIOQUIA,1662,977,397,6,2,2,3046,11,122,59,2,194
MONTEBELLO,2018,8,ANTIOQUIA,1666,978,398,6,2,2,3052,11,122,59,2,194
MONTEBELLO,2018,9,ANTIOQUIA,1667,980,397,6,2,2,3054,11,122,59,2,194
MONTEBELLO,2019,1,ANTIOQUIA,1691,997,399,9,2,2,3100,11,122,59,2,194
MONTEBELLO,2019,10,ANTIOQUIA,1729,1011,399,11,2,2,3154,11,133,59,2,205
MONTEBELLO,2019,11,ANTIOQUIA,1754,1016,400,11,2,2,3185,12,133,59,2,206
MONTEBELLO,2019,12,ANTIOQUIA,1759,1028,401,11,2,2,3203,12,133,59,2,206
MONTEBELLO,2019,2,ANTIOQUIA,1697,997,401,9,2,2,3108,11,122,59,2,194
MONTEBELLO,2019,3,ANTIOQUIA,1699,999,403,9,2,2,3114,11,123,59,2,195
MONTEBELLO,2019,4,ANTIOQUIA,1701,997,397,9,2,2,3108,11,130,59,2,202
MONTEBELLO,2019,5,ANTIOQUIA,1705,1000,398,9,2,2,3116,11,133,59,2,205
MONTEBELLO,2019,6,ANTIOQUIA,1707,999,398,9,2,2,3117,11,133,59,2,205
MONTEBELLO,2019,7,ANTIOQUIA,1707,1000,398,9,2,2,3118,11,133,59,2,205
MONTEBELLO,2019,8,ANTIOQUIA,1710,1003,397,9,2,2,3123,11,133,59,2,205
MONTEBELLO,2019,9,ANTIOQUIA,1712,1006,397,10,2,2,3129,11,133,59,2,205
MONTEBELLO,2020,1,ANTIOQUIA,1760,1024,400,11,2,2,3199,12,133,59,2,206
MONTEBELLO,2020,10,ANTIOQUIA,1805,1037,404,11,2,2,3261,12,140,60,49,261
MONTEBELLO,2020,11,ANTIOQUIA,1808,1039,405,11,2,2,3267,12,140,60,49,261
MONTEBELLO,2020,12,ANTIOQUIA,1811,1040,406,12,2,2,3273,12,140,59,49,260
MONTEBELLO,2020,2,ANTIOQUIA,1760,1025,402,12,2,2,3203,12,133,60,49,254
MONTEBELLO,2020,3,ANTIOQUIA,1764,1025,404,12,2,2,3209,12,133,60,49,254
MONTEBELLO,2020,4,ANTIOQUIA,1770,1022,402,11,2,2,3209,12,135,59,49,255
MONTEBELLO,2020,5,ANTIOQUIA,1774,1026,402,11,2,2,3217,12,135,59,49,255
MONTEBELLO,2020,6,ANTIOQUIA,1773,1024,402,11,2,2,3214,12,135,60,49,256
MONTEBELLO,2020,7,ANTIOQUIA,1773,1025,402,11,2,2,3215,12,135,60,49,256
MONTEBELLO,2020,8,ANTIOQUIA,1783,1030,402,11,2,2,3230,12,135,60,49,256
MONTEBELLO,2020,9,ANTIOQUIA,1802,1037,403,11,2,2,3257,12,135,60,49,256
MONTEBELLO,2021,1,ANTIOQUIA,1816,1041,405,12,2,2,3278,12,140,59,49,260
MONTEBELLO,2021,10,ANTIOQUIA,1846,1060,403,10,1,2,3322,13,145,59,49,266
MONTEBELLO,2021,11,ANTIOQUIA,1845,1061,403,10,1,2,3322,13,146,59,49,267
MONTEBELLO,2021,12,ANTIOQUIA,1852,1062,403,10,1,2,3330,13,146,59,49,267
MONTEBELLO,2021,2,ANTIOQUIA,1824,1043,405,12,2,2,3288,12,140,59,49,260
MONTEBELLO,2021,3,ANTIOQUIA,1834,1047,406,12,1,2,3302,12,140,59,49,260
MONTEBELLO,2021,4,ANTIOQUIA,1835,1051,403,12,1,2,3304,13,142,59,49,263
MONTEBELLO,2021,5,ANTIOQUIA,1836,1053,403,12,1,2,3307,13,143,59,49,264
MONTEBELLO,2021,6,ANTIOQUIA,1840,1053,403,12,1,2,3311,12,142,59,49,262
MONTEBELLO,2021,7,ANTIOQUIA,1842,1054,403,10,1,2,3312,13,143,59,49,264
MONTEBELLO,2021,8,ANTIOQUIA,1843,1054,404,10,1,2,3314,13,144,59,49,265
MONTEBELLO,2021,9,ANTIOQUIA,1844,1057,404,10,1,2,3318,13,144,59,49,265
MONTEBELLO,2022,1,ANTIOQUIA,1856,1066,403,10,1,2,3338,13,146,59,49,267
MONTEBELLO,2022,10,ANTIOQUIA,1848,1081,405,9,1,2,3346,12,145,59,50,266
MONTEBELLO,2022,11,ANTIOQUIA,1853,1082,406,8,1,2,3352,12,145,59,50,266
MONTEBELLO,2022,12,ANTIOQUIA,1853,1085,409,8,1,2,3358,12,146,59,50,267
MONTEBELLO,2022,2,ANTIOQUIA,1858,1067,403,10,1,2,3341,13,145,59,49,266
MONTEBELLO,2022,3,ANTIOQUIA,1864,1078,403,11,1,2,3359,13,145,59,49,266
MONTEBELLO,2022,4,ANTIOQUIA,1871,1077,404,11,1,2,3366,13,146,59,49,267
MONTEBELLO,2022,5,ANTIOQUIA,1872,1079,405,11,1,2,3370,12,146,59,49,266
MONTEBELLO,2022,6,ANTIOQUIA,1875,1080,405,11,1,2,3374,12,145,59,49,265
MONTEBELLO,2022,7,ANTIOQUIA,1880,1084,405,9,1,2,3381,12,145,59,49,265
MONTEBELLO,2022,8,ANTIOQUIA,1834,1070,404,8,1,2,3319,12,144,59,50,265
MONTEBELLO,2022,9,ANTIOQUIA,1842,1078,405,9,1,2,3337,12,145,59,50,266
MONTEBELLO,2023,1,ANTIOQUIA,1854,1092,409,8,1,2,3366,12,146,59,50,267
MONTEBELLO,2023,2,ANTIOQUIA,1857,1096,409,9,1,2,3374,12,146,59,50,267
MONTEBELLO,2023,3,ANTIOQUIA,1875,1102,409,8,1,2,3397,12,146,59,50,267
MONTEBELLO,2023,4,ANTIOQUIA,1878,1105,409,8,1,2,3403,12,147,59,50,268
MONTEBELLO,2023,5,ANTIOQUIA,1893,1114,409,8,1,2,3427,12,147,59,50,268
MONTEBELLO,2023,6,ANTIOQUIA,1904,1119,407,8,1,2,3441,12,147,59,50,268
MONTEBELLO,2023,7,ANTIOQUIA,1899,1119,407,8,1,2,3436,12,148,59,50,269
MONTEBELLO,2023,8,ANTIOQUIA,1924,1125,408,9,1,2,3469,12,148,59,50,269
MONTEBELLO,2023,9,ANTIOQUIA,1927,1130,405,10,1,2,3475,12,149,60,50,271
MUTATA,2018,1,ANTIOQUIA,5086,1302,74,19,0,0,6481,17,417,81,13,528
MUTATA,2018,10,ANTIOQUIA,5343,1356,74,19,0,0,6792,20,434,78,13,545
MUTATA,2018,11,ANTIOQUIA,5375,1347,74,22,0,1,6819,20,436,78,13,547
MUTATA,2018,12,ANTIOQUIA,5501,1356,73,20,0,1,6951,21,438,78,13,550
MUTATA,2018,2,ANTIOQUIA,5120,1310,74,20,0,0,6524,17,415,81,13,526
MUTATA,2018,3,ANTIOQUIA,5120,1308,74,21,0,0,6523,18,413,80,13,524
MUTATA,2018,4,ANTIOQUIA,5211,1324,74,19,0,0,6628,19,422,81,13,535
MUTATA,2018,5,ANTIOQUIA,5148,1315,74,19,0,0,6556,19,410,79,13,521
MUTATA,2018,6,ANTIOQUIA,5199,1328,75,19,0,0,6621,19,417,80,13,529
MUTATA,2018,7,ANTIOQUIA,5242,1334,75,19,0,0,6670,19,421,80,13,533
MUTATA,2018,8,ANTIOQUIA,5291,1346,75,18,0,0,6730,19,426,80,13,538
MUTATA,2018,9,ANTIOQUIA,5288,1350,74,19,0,0,6731,20,423,79,13,535
MUTATA,2019,1,ANTIOQUIA,5473,1359,72,22,0,1,6927,20,439,78,13,550
MUTATA,2019,10,ANTIOQUIA,5970,1423,72,27,0,0,7492,20,474,77,13,584
MUTATA,2019,11,ANTIOQUIA,5987,1431,72,27,0,0,7517,20,479,77,13,589
MUTATA,2019,12,ANTIOQUIA,6059,1440,77,27,0,0,7603,20,496,77,13,606
MUTATA,2019,2,ANTIOQUIA,5521,1383,72,21,0,1,6998,20,439,77,13,549
MUTATA,2019,3,ANTIOQUIA,5689,1387,71,22,0,1,7170,20,457,78,13,568
MUTATA,2019,4,ANTIOQUIA,5794,1389,71,21,0,1,7276,20,457,78,13,568
MUTATA,2019,5,ANTIOQUIA,5866,1402,73,21,0,1,7363,21,465,78,13,577
MUTATA,2019,6,ANTIOQUIA,5887,1405,72,21,0,0,7385,20,468,77,13,578
MUTATA,2019,7,ANTIOQUIA,5944,1417,72,25,0,0,7458,19,471,77,13,580
MUTATA,2019,8,ANTIOQUIA,5967,1407,72,26,0,1,7473,21,474,77,13,585
MUTATA,2019,9,ANTIOQUIA,5948,1416,72,27,0,0,7463,20,475,77,13,585
MUTATA,2020,1,ANTIOQUIA,6034,1442,73,37,0,0,7586,20,485,77,13,595
MUTATA,2020,10,ANTIOQUIA,6364,1489,72,39,0,0,7964,24,512,75,132,743
MUTATA,2020,11,ANTIOQUIA,6405,1488,71,38,0,0,8002,25,524,75,132,756
MUTATA,2020,12,ANTIOQUIA,6423,1493,71,38,0,0,8025,26,527,75,132,760
MUTATA,2020,2,ANTIOQUIA,6058,1444,71,33,0,0,7606,23,491,82,132,728
MUTATA,2020,3,ANTIOQUIA,6106,1446,71,34,0,0,7657,23,493,82,132,730
MUTATA,2020,4,ANTIOQUIA,6165,1453,71,30,0,0,7719,22,508,74,132,736
MUTATA,2020,5,ANTIOQUIA,6203,1456,71,33,0,0,7763,23,506,74,132,735
MUTATA,2020,6,ANTIOQUIA,6219,1458,71,35,0,0,7783,23,505,74,132,734
MUTATA,2020,7,ANTIOQUIA,6246,1462,71,37,0,0,7816,23,510,74,132,739
MUTATA,2020,8,ANTIOQUIA,6298,1477,71,39,0,0,7885,22,507,74,132,735
MUTATA,2020,9,ANTIOQUIA,6321,1480,71,39,0,0,7911,22,512,74,132,740
MUTATA,2021,1,ANTIOQUIA,6453,1497,71,39,0,0,8060,26,528,75,132,761
MUTATA,2021,10,ANTIOQUIA,3611,1129,61,29,0,0,4830,23,273,54,131,481
MUTATA,2021,11,ANTIOQUIA,3622,1134,61,30,0,0,4847,24,276,54,131,485
MUTATA,2021,12,ANTIOQUIA,3646,1158,62,44,0,0,4910,24,279,55,131,489
MUTATA,2021,2,ANTIOQUIA,6555,1502,71,40,0,0,8168,27,535,74,132,768
MUTATA,2021,3,ANTIOQUIA,6603,1517,73,41,0,0,8234,26,543,74,132,775
MUTATA,2021,4,ANTIOQUIA,6671,1524,71,47,0,0,8313,27,549,74,132,782
MUTATA,2021,5,ANTIOQUIA,3714,1126,59,32,0,0,4931,24,264,54,132,474
MUTATA,2021,6,ANTIOQUIA,3505,1112,59,32,0,0,4708,24,259,54,131,468
MUTATA,2021,7,ANTIOQUIA,3539,1122,59,32,0,0,4752,24,259,54,131,468
MUTATA,2021,8,ANTIOQUIA,3564,1125,61,33,0,0,4783,23,258,54,131,466
MUTATA,2021,9,ANTIOQUIA,3585,1125,61,32,0,0,4803,23,264,54,131,472
MUTATA,2022,1,ANTIOQUIA,3644,1173,62,122,0,0,5001,24,271,55,131,481
MUTATA,2022,10,ANTIOQUIA,4168,1193,68,31,0,0,5460,22,290,56,132,500
MUTATA,2022,11,ANTIOQUIA,4216,1198,67,31,0,0,5512,22,292,56,132,502
MUTATA,2022,12,ANTIOQUIA,4319,1200,67,40,0,0,5626,21,295,56,132,504
MUTATA,2022,2,ANTIOQUIA,3676,1187,63,147,0,0,5073,24,273,55,131,483
MUTATA,2022,3,ANTIOQUIA,3734,1212,64,198,0,0,5208,22,277,57,131,487
MUTATA,2022,4,ANTIOQUIA,3808,1212,64,205,0,0,5289,22,279,58,131,490
MUTATA,2022,5,ANTIOQUIA,3825,1222,65,181,0,0,5293,22,275,56,131,484
MUTATA,2022,6,ANTIOQUIA,3874,1225,65,168,0,0,5332,22,286,56,132,496
MUTATA,2022,7,ANTIOQUIA,3930,1229,66,143,0,0,5368,22,287,57,132,498
MUTATA,2022,8,ANTIOQUIA,4121,1188,67,33,0,0,5409,22,284,57,132,495
MUTATA,2022,9,ANTIOQUIA,4146,1191,68,31,0,0,5436,22,286,57,132,497
MUTATA,2023,1,ANTIOQUIA,4349,1204,67,35,0,0,5655,21,298,56,132,507
MUTATA,2023,2,ANTIOQUIA,4424,1191,67,23,0,0,5705,21,303,56,133,513
MUTATA,2023,3,ANTIOQUIA,4451,1191,67,25,0,0,5734,21,310,56,133,520
MUTATA,2023,4,ANTIOQUIA,4494,1194,67,27,0,0,5782,21,312,56,133,522
MUTATA,2023,5,ANTIOQUIA,4533,1198,69,27,0,0,5827,20,314,57,133,524
MUTATA,2023,6,ANTIOQUIA,4575,1202,69,27,0,0,5873,21,318,57,134,530
MUTATA,2023,7,ANTIOQUIA,4631,1208,68,27,0,0,5934,20,320,57,134,531
MUTATA,2023,8,ANTIOQUIA,4670,1210,68,24,0,0,5972,19,325,57,134,535
MUTATA,2023,9,ANTIOQUIA,4657,1206,73,22,0,0,5958,19,321,57,134,531
NARINO,2018,1,ANTIOQUIA,860,2678,194,0,0,0,3732,2,222,74,13,311
NARINO,2018,10,ANTIOQUIA,875,2724,175,0,0,0,3774,3,219,71,13,306
NARINO,2018,11,ANTIOQUIA,878,2725,172,0,0,0,3775,3,220,71,13,307
NARINO,2018,12,ANTIOQUIA,880,2731,172,1,0,0,3784,4,219,71,13,307
NARINO,2018,2,ANTIOQUIA,862,2687,188,0,0,0,3737,2,222,74,13,311
NARINO,2018,3,ANTIOQUIA,864,2697,186,0,0,0,3747,2,221,73,13,309
NARINO,2018,4,ANTIOQUIA,866,2703,184,0,0,0,3753,2,222,75,13,312
NARINO,2018,5,ANTIOQUIA,863,2698,184,0,0,0,3745,2,221,71,13,307
NARINO,2018,6,ANTIOQUIA,864,2706,183,0,0,0,3753,2,221,71,13,307
NARINO,2018,7,ANTIOQUIA,869,2705,181,0,0,0,3755,2,221,71,13,307
NARINO,2018,8,ANTIOQUIA,872,2713,176,0,0,0,3761,3,220,71,13,307
NARINO,2018,9,ANTIOQUIA,875,2717,175,0,0,0,3767,3,219,71,13,306
NARINO,2019,1,ANTIOQUIA,883,2735,172,1,0,0,3791,4,219,71,13,307
NARINO,2019,10,ANTIOQUIA,898,2765,164,0,0,0,3827,5,218,73,12,308
NARINO,2019,11,ANTIOQUIA,897,2770,164,0,0,0,3831,5,218,73,12,308
NARINO,2019,12,ANTIOQUIA,903,2780,163,0,0,0,3846,5,218,74,12,309
NARINO,2019,2,ANTIOQUIA,884,2744,170,1,0,0,3799,4,220,71,13,308
NARINO,2019,3,ANTIOQUIA,887,2739,170,1,0,0,3797,4,220,71,13,308
NARINO,2019,4,ANTIOQUIA,886,2752,169,1,0,0,3808,4,220,71,14,309
NARINO,2019,5,ANTIOQUIA,893,2760,172,1,0,0,3826,4,220,71,13,308
NARINO,2019,6,ANTIOQUIA,892,2762,166,0,0,0,3820,4,220,71,13,308
NARINO,2019,7,ANTIOQUIA,895,2760,165,0,0,0,3820,4,219,72,13,308
NARINO,2019,8,ANTIOQUIA,898,2761,163,0,0,0,3822,4,219,73,12,308
NARINO,2019,9,ANTIOQUIA,894,2763,162,0,0,0,3819,4,219,73,15,311
NARINO,2020,1,ANTIOQUIA,898,2771,163,0,0,0,3832,5,218,74,11,308
NARINO,2020,10,ANTIOQUIA,908,2796,164,0,0,0,3868,5,220,81,44,350
NARINO,2020,11,ANTIOQUIA,909,2799,164,0,0,0,3872,5,221,81,44,351
NARINO,2020,12,ANTIOQUIA,911,2804,164,0,0,0,3879,5,222,81,44,352
NARINO,2020,2,ANTIOQUIA,896,2759,163,0,0,0,3818,5,218,76,44,343
NARINO,2020,3,ANTIOQUIA,898,2759,164,0,0,0,3821,5,218,76,44,343
NARINO,2020,4,ANTIOQUIA,896,2760,163,0,0,0,3819,5,220,74,44,343
NARINO,2020,5,ANTIOQUIA,899,2786,164,0,0,0,3849,5,220,81,34,340
NARINO,2020,6,ANTIOQUIA,899,2782,164,0,0,0,3845,5,220,81,44,350
NARINO,2020,7,ANTIOQUIA,899,2785,165,0,0,0,3849,5,222,81,44,352
NARINO,2020,8,ANTIOQUIA,905,2786,164,0,0,0,3855,5,220,81,44,350
NARINO,2020,9,ANTIOQUIA,906,2793,164,0,0,0,3863,5,221,81,44,351
NARINO,2021,1,ANTIOQUIA,911,2807,164,0,0,0,3882,5,222,81,44,352
NARINO,2021,10,ANTIOQUIA,921,2841,163,4,0,0,3929,5,221,81,43,350
NARINO,2021,11,ANTIOQUIA,923,2847,162,1,0,0,3933,5,221,81,44,351
NARINO,2021,12,ANTIOQUIA,923,2851,163,1,0,0,3938,5,220,81,44,350
NARINO,2021,2,ANTIOQUIA,912,2810,165,0,0,0,3887,5,221,81,44,351
NARINO,2021,3,ANTIOQUIA,912,2820,163,0,0,0,3895,5,221,81,44,351
NARINO,2021,4,ANTIOQUIA,913,2819,165,0,0,0,3897,5,221,81,44,351
NARINO,2021,5,ANTIOQUIA,916,2818,164,0,0,0,3898,5,220,81,44,350
NARINO,2021,6,ANTIOQUIA,918,2827,163,0,0,0,3908,5,220,81,44,350
NARINO,2021,7,ANTIOQUIA,920,2831,163,4,0,0,3918,5,220,81,44,350
NARINO,2021,8,ANTIOQUIA,920,2836,163,4,0,0,3923,5,220,81,44,350
NARINO,2021,9,ANTIOQUIA,920,2839,163,4,0,0,3926,5,220,81,44,350
NARINO,2022,1,ANTIOQUIA,923,2856,162,1,0,0,3942,5,220,81,44,350
NARINO,2022,10,ANTIOQUIA,923,2871,166,1,0,0,3961,5,224,80,44,353
NARINO,2022,11,ANTIOQUIA,924,2873,166,0,0,0,3963,5,224,80,44,353
NARINO,2022,12,ANTIOQUIA,923,2877,166,0,0,0,3966,5,224,80,44,353
NARINO,2022,2,ANTIOQUIA,923,2858,162,1,0,0,3944,5,220,81,44,350
NARINO,2022,3,ANTIOQUIA,925,2862,163,1,0,0,3951,5,220,81,44,350
NARINO,2022,4,ANTIOQUIA,923,2858,163,1,0,0,3945,5,220,81,44,350
NARINO,2022,5,ANTIOQUIA,923,2864,164,1,0,0,3952,5,220,81,44,350
NARINO,2022,6,ANTIOQUIA,923,2864,164,1,0,0,3952,5,220,81,44,350
NARINO,2022,7,ANTIOQUIA,920,2856,162,1,0,0,3939,5,221,80,44,350
NARINO,2022,8,ANTIOQUIA,920,2859,162,1,0,0,3942,5,221,80,44,350
NARINO,2022,9,ANTIOQUIA,922,2865,166,0,0,0,3953,5,225,80,44,354
NARINO,2023,1,ANTIOQUIA,924,2880,165,0,0,0,3969,5,224,80,44,353
NARINO,2023,2,ANTIOQUIA,924,2882,164,0,0,0,3970,5,224,80,44,353
NARINO,2023,3,ANTIOQUIA,925,2884,163,0,0,0,3972,5,224,80,44,353
NARINO,2023,4,ANTIOQUIA,926,2895,163,0,0,0,3984,5,224,80,44,353
NARINO,2023,5,ANTIOQUIA,927,2901,164,0,0,0,3992,5,224,80,44,353
NARINO,2023,6,ANTIOQUIA,933,2912,166,0,0,0,4011,5,224,80,44,353
NARINO,2023,7,ANTIOQUIA,936,2919,166,0,0,0,4021,5,224,80,44,353
NARINO,2023,8,ANTIOQUIA,939,2924,163,0,0,0,4026,5,225,80,44,354
NARINO,2023,9,ANTIOQUIA,945,2930,162,0,0,0,4037,5,225,80,44,354
NECHI,2018,1,ANTIOQUIA,5477,786,77,35,11,1,6387,9,364,55,11,439
NECHI,2018,10,ANTIOQUIA,5554,798,73,36,11,1,6473,9,388,56,11,464
NECHI,2018,11,ANTIOQUIA,5550,796,73,35,11,1,6466,9,386,56,11,462
NECHI,2018,12,ANTIOQUIA,5576,799,73,34,11,1,6494,9,388,56,11,464
NECHI,2018,2,ANTIOQUIA,5520,790,77,36,11,1,6435,9,356,56,11,432
NECHI,2018,3,ANTIOQUIA,5565,816,77,36,11,1,6506,9,359,55,11,434
NECHI,2018,4,ANTIOQUIA,5634,837,76,40,11,1,6599,9,359,56,11,435
NECHI,2018,5,ANTIOQUIA,5510,809,76,36,11,1,6443,9,358,56,11,434
NECHI,2018,6,ANTIOQUIA,5520,808,76,35,11,1,6451,9,356,57,11,433
NECHI,2018,7,ANTIOQUIA,5523,804,72,37,11,1,6448,9,389,56,11,465
NECHI,2018,8,ANTIOQUIA,5575,806,73,38,11,1,6504,9,390,56,11,466
NECHI,2018,9,ANTIOQUIA,5508,795,73,36,11,1,6424,9,388,55,11,463
NECHI,2019,1,ANTIOQUIA,5608,816,73,33,11,1,6542,9,392,56,11,468
NECHI,2019,10,ANTIOQUIA,5764,813,73,35,11,1,6697,9,400,66,11,486
NECHI,2019,11,ANTIOQUIA,5784,811,73,35,11,1,6715,9,401,66,11,487
NECHI,2019,12,ANTIOQUIA,5863,815,73,35,11,1,6798,9,409,66,11,495
NECHI,2019,2,ANTIOQUIA,5634,812,73,33,11,1,6564,9,388,56,11,464
NECHI,2019,3,ANTIOQUIA,5659,809,73,33,11,1,6586,9,388,55,11,463
NECHI,2019,4,ANTIOQUIA,5667,810,73,34,11,1,6596,9,388,55,11,463
NECHI,2019,5,ANTIOQUIA,5695,817,73,35,11,1,6632,9,390,66,11,476
NECHI,2019,6,ANTIOQUIA,5698,815,72,35,11,1,6632,9,394,65,11,479
NECHI,2019,7,ANTIOQUIA,5723,814,73,35,11,1,6657,9,391,65,11,476
NECHI,2019,8,ANTIOQUIA,5735,813,73,35,11,1,6668,9,399,66,11,485
NECHI,2019,9,ANTIOQUIA,5750,814,73,35,11,1,6684,9,400,66,11,486
NECHI,2020,1,ANTIOQUIA,5844,812,76,36,11,1,6780,9,405,66,11,491
NECHI,2020,10,ANTIOQUIA,6338,872,74,34,11,1,7330,10,427,64,71,572
NECHI,2020,11,ANTIOQUIA,6356,870,73,35,11,1,7346,10,429,64,71,574
NECHI,2020,12,ANTIOQUIA,6377,869,72,35,11,1,7365,10,428,64,71,573
NECHI,2020,2,ANTIOQUIA,5852,816,73,35,11,1,6788,9,404,74,71,558
NECHI,2020,3,ANTIOQUIA,5862,817,75,35,11,1,6801,9,407,74,71,561
NECHI,2020,4,ANTIOQUIA,5889,816,74,34,11,1,6825,9,416,64,71,560
NECHI,2020,5,ANTIOQUIA,6189,844,74,34,11,1,7153,9,426,65,71,571
NECHI,2020,6,ANTIOQUIA,6211,845,73,34,11,1,7175,9,422,65,70,566
NECHI,2020,7,ANTIOQUIA,6238,847,73,34,11,1,7204,9,424,64,71,568
NECHI,2020,8,ANTIOQUIA,6280,860,73,34,11,1,7259,10,424,64,71,569
NECHI,2020,9,ANTIOQUIA,6302,870,73,34,11,1,7291,10,428,64,71,573
NECHI,2021,1,ANTIOQUIA,6400,868,72,35,11,1,7387,10,430,61,71,572
NECHI,2021,10,ANTIOQUIA,6619,826,71,38,11,1,7566,10,434,48,73,565
NECHI,2021,11,ANTIOQUIA,6642,822,71,38,11,1,7585,10,444,48,73,575
NECHI,2021,12,ANTIOQUIA,6711,825,71,39,11,1,7658,10,446,49,73,578
NECHI,2021,2,ANTIOQUIA,6415,872,73,35,11,1,7407,10,435,56,71,572
NECHI,2021,3,ANTIOQUIA,6467,873,72,35,11,1,7459,10,428,52,71,561
NECHI,2021,4,ANTIOQUIA,6504,878,72,36,11,1,7502,10,432,52,71,565
NECHI,2021,5,ANTIOQUIA,6509,880,72,36,11,1,7509,10,430,52,72,564
NECHI,2021,6,ANTIOQUIA,6535,855,71,38,11,1,7511,10,429,52,73,564
NECHI,2021,7,ANTIOQUIA,6566,848,71,39,11,1,7536,10,430,49,73,562
NECHI,2021,8,ANTIOQUIA,6570,849,71,37,11,1,7539,10,432,48,73,563
NECHI,2021,9,ANTIOQUIA,6581,840,71,37,11,1,7541,10,434,48,73,565
NECHI,2022,1,ANTIOQUIA,6727,829,71,39,11,1,7678,10,450,49,73,582
NECHI,2022,10,ANTIOQUIA,7040,824,70,37,11,1,7983,11,474,54,73,612
NECHI,2022,11,ANTIOQUIA,7052,832,69,39,11,1,8004,11,474,54,73,612
NECHI,2022,12,ANTIOQUIA,7064,832,70,37,11,1,8015,11,473,54,73,611
NECHI,2022,2,ANTIOQUIA,6744,820,71,39,11,1,7686,11,448,49,73,581
NECHI,2022,3,ANTIOQUIA,6812,823,71,39,11,1,7757,10,455,49,73,587
NECHI,2022,4,ANTIOQUIA,6822,826,71,37,11,1,7768,10,452,49,73,584
NECHI,2022,5,ANTIOQUIA,6857,828,70,35,11,1,7802,10,455,53,73,591
NECHI,2022,6,ANTIOQUIA,6897,829,70,35,11,1,7843,10,457,54,73,594
NECHI,2022,7,ANTIOQUIA,6930,827,70,36,11,1,7875,10,459,53,73,595
NECHI,2022,8,ANTIOQUIA,6947,828,70,36,11,1,7893,10,461,54,73,598
NECHI,2022,9,ANTIOQUIA,7017,824,70,37,11,1,7960,10,467,54,73,604
NECHI,2023,1,ANTIOQUIA,7092,834,70,37,11,1,8045,11,474,54,73,612
NECHI,2023,2,ANTIOQUIA,7098,825,70,36,11,1,8041,11,475,54,73,613
NECHI,2023,3,ANTIOQUIA,7130,838,69,36,11,1,8085,11,475,54,73,613
NECHI,2023,4,ANTIOQUIA,7173,830,69,39,11,1,8123,11,475,55,73,614
NECHI,2023,5,ANTIOQUIA,6969,820,69,40,11,1,7910,11,469,56,73,609
NECHI,2023,6,ANTIOQUIA,6983,820,69,40,11,1,7924,11,465,57,73,606
NECHI,2023,7,ANTIOQUIA,6928,813,69,40,11,1,7862,12,464,57,73,606
NECHI,2023,8,ANTIOQUIA,6979,813,68,39,11,1,7911,12,476,57,74,619
NECHI,2023,9,ANTIOQUIA,6972,814,68,38,11,1,7904,12,478,57,73,620
NECOCLI,2018,1,ANTIOQUIA,10626,2120,412,43,1,1,13203,26,705,134,29,894
NECOCLI,2018,10,ANTIOQUIA,10948,2186,404,55,1,1,13595,26,688,134,27,875
NECOCLI,2018,11,ANTIOQUIA,10834,2177,406,56,1,1,13475,26,686,132,27,871
NECOCLI,2018,12,ANTIOQUIA,10980,2177,406,56,1,1,13621,27,682,131,27,867
NECOCLI,2018,2,ANTIOQUIA,10650,2124,404,47,1,1,13227,25,687,134,28,874
NECOCLI,2018,3,ANTIOQUIA,10711,2131,405,49,1,1,13298,26,696,134,29,885
NECOCLI,2018,4,ANTIOQUIA,10827,2137,408,52,1,1,13426,25,699,133,29,886
NECOCLI,2018,5,ANTIOQUIA,10632,2132,406,50,1,1,13222,25,692,134,29,880
NECOCLI,2018,6,ANTIOQUIA,10829,2149,407,50,1,1,13437,25,686,134,27,872
NECOCLI,2018,7,ANTIOQUIA,10900,2159,410,52,1,1,13523,25,686,134,27,872
NECOCLI,2018,8,ANTIOQUIA,10975,2166,410,52,1,1,13605,27,686,134,27,874
NECOCLI,2018,9,ANTIOQUIA,10825,2167,404,53,1,1,13451,26,685,134,27,872
NECOCLI,2019,1,ANTIOQUIA,10942,2184,409,56,1,1,13593,28,686,131,28,873
NECOCLI,2019,10,ANTIOQUIA,12095,2276,408,61,1,1,14842,35,706,131,28,900
NECOCLI,2019,11,ANTIOQUIA,12145,2288,413,63,1,1,14911,34,714,131,28,907
NECOCLI,2019,12,ANTIOQUIA,12289,2315,413,64,1,1,15083,34,728,131,28,921
NECOCLI,2019,2,ANTIOQUIA,11032,2208,410,56,1,1,13708,28,681,131,28,868
NECOCLI,2019,3,ANTIOQUIA,11319,2226,412,58,1,1,14017,29,685,131,28,873
NECOCLI,2019,4,ANTIOQUIA,11586,2232,412,59,1,1,14291,29,684,131,28,872
NECOCLI,2019,5,ANTIOQUIA,11768,2252,415,60,1,1,14497,34,688,131,28,881
NECOCLI,2019,6,ANTIOQUIA,11760,2250,412,61,1,1,14485,35,680,130,28,873
NECOCLI,2019,7,ANTIOQUIA,11863,2257,413,61,1,1,14596,35,683,131,29,878
NECOCLI,2019,8,ANTIOQUIA,11958,2260,412,61,1,1,14693,35,688,131,28,882
NECOCLI,2019,9,ANTIOQUIA,12039,2267,408,61,1,1,14777,35,701,131,28,895
NECOCLI,2020,1,ANTIOQUIA,12219,2295,411,103,1,1,15030,34,714,130,28,906
NECOCLI,2020,10,ANTIOQUIA,12801,2333,414,74,1,1,15624,33,770,132,343,1278
NECOCLI,2020,11,ANTIOQUIA,12856,2336,412,74,1,1,15680,32,776,132,343,1283
NECOCLI,2020,12,ANTIOQUIA,12934,2344,414,74,1,1,15768,32,781,132,343,1288
NECOCLI,2020,2,ANTIOQUIA,12303,2274,410,122,1,1,15111,34,732,157,345,1268
NECOCLI,2020,3,ANTIOQUIA,12362,2283,411,130,1,1,15188,34,735,158,344,1271
NECOCLI,2020,4,ANTIOQUIA,12409,2295,410,102,1,1,15218,34,762,131,343,1270
NECOCLI,2020,5,ANTIOQUIA,12587,2304,411,103,1,1,15407,35,760,131,344,1270
NECOCLI,2020,6,ANTIOQUIA,12504,2304,412,104,1,1,15326,34,762,131,344,1271
NECOCLI,2020,7,ANTIOQUIA,12581,2312,412,87,1,1,15394,34,765,132,344,1275
NECOCLI,2020,8,ANTIOQUIA,12660,2320,412,80,1,1,15474,34,765,132,344,1275
NECOCLI,2020,9,ANTIOQUIA,12712,2328,414,81,1,1,15537,33,768,132,344,1277
NECOCLI,2021,1,ANTIOQUIA,13013,2348,415,75,1,1,15853,32,782,133,343,1290
NECOCLI,2021,10,ANTIOQUIA,13156,2427,418,70,1,1,16073,32,825,126,344,1327
NECOCLI,2021,11,ANTIOQUIA,13196,2443,418,71,1,1,16130,33,829,126,344,1332
NECOCLI,2021,12,ANTIOQUIA,13420,2459,419,68,1,1,16368,32,839,126,344,1341
NECOCLI,2021,2,ANTIOQUIA,13060,2349,415,73,1,1,15899,33,787,132,343,1295
NECOCLI,2021,3,ANTIOQUIA,13107,2365,412,72,1,1,15958,31,787,132,343,1293
NECOCLI,2021,4,ANTIOQUIA,13162,2376,412,70,1,1,16022,31,795,131,343,1300
NECOCLI,2021,5,ANTIOQUIA,13131,2380,414,69,1,1,15996,31,798,132,343,1304
NECOCLI,2021,6,ANTIOQUIA,13143,2383,416,68,1,1,16012,30,795,129,344,1298
NECOCLI,2021,7,ANTIOQUIA,13128,2391,417,69,1,1,16007,31,807,129,344,1311
NECOCLI,2021,8,ANTIOQUIA,13067,2405,417,71,1,1,15962,30,812,126,344,1312
NECOCLI,2021,9,ANTIOQUIA,13119,2414,417,71,1,1,16023,31,812,125,344,1312
NECOCLI,2022,1,ANTIOQUIA,13347,2461,419,70,1,1,16299,30,845,130,344,1349
NECOCLI,2022,10,ANTIOQUIA,14022,2559,427,103,0,1,17112,31,883,130,344,1388
NECOCLI,2022,11,ANTIOQUIA,14111,2566,428,97,0,1,17203,30,889,130,344,1393
NECOCLI,2022,12,ANTIOQUIA,14211,2588,427,86,0,1,17313,30,893,130,344,1397
NECOCLI,2022,2,ANTIOQUIA,13448,2475,420,72,1,1,16417,31,847,130,344,1352
NECOCLI,2022,3,ANTIOQUIA,13495,2484,424,70,1,1,16475,31,850,130,344,1355
NECOCLI,2022,4,ANTIOQUIA,13575,2506,424,72,1,1,16579,30,852,130,344,1356
NECOCLI,2022,5,ANTIOQUIA,13592,2507,423,73,1,1,16597,29,852,130,344,1355
NECOCLI,2022,6,ANTIOQUIA,13677,2516,424,75,0,1,16693,30,852,130,344,1356
NECOCLI,2022,7,ANTIOQUIA,13751,2528,424,74,0,1,16778,30,857,130,344,1361
NECOCLI,2022,8,ANTIOQUIA,13815,2534,423,76,0,1,16849,31,857,130,344,1362
NECOCLI,2022,9,ANTIOQUIA,13904,2545,425,80,0,1,16955,32,869,130,344,1375
NECOCLI,2023,1,ANTIOQUIA,14285,2598,427,87,0,1,17398,29,893,130,344,1396
NECOCLI,2023,2,ANTIOQUIA,14341,2616,426,85,0,1,17469,29,901,132,344,1406
NECOCLI,2023,3,ANTIOQUIA,14423,2634,426,84,0,1,17568,29,913,132,344,1418
NECOCLI,2023,4,ANTIOQUIA,14473,2640,425,89,0,1,17628,30,916,133,344,1423
NECOCLI,2023,5,ANTIOQUIA,11787,3615,1629,375,140,148,17694,28,916,133,344,1421
NECOCLI,2023,6,ANTIOQUIA,11589,3623,1763,435,146,174,17730,28,915,134,344,1421
NECOCLI,2023,7,ANTIOQUIA,11661,3637,1748,439,146,146,17777,35,923,134,344,1436
NECOCLI,2023,8,ANTIOQUIA,11693,3664,1756,439,146,119,17817,30,936,134,344,1444
NECOCLI,2023,9,ANTIOQUIA,11676,3677,1692,436,118,109,17708,29,941,134,344,1448
OLAYA,2018,1,ANTIOQUIA,510,781,101,34,184,11,1621,8,48,39,2,97
OLAYA,2018,10,ANTIOQUIA,515,787,99,34,185,11,1631,6,49,39,2,96
OLAYA,2018,11,ANTIOQUIA,516,827,132,34,185,11,1705,6,49,39,2,96
OLAYA,2018,12,ANTIOQUIA,517,832,132,34,185,11,1711,6,48,39,2,95
OLAYA,2018,2,ANTIOQUIA,510,782,101,34,184,11,1622,7,48,39,2,96
OLAYA,2018,3,ANTIOQUIA,510,780,98,33,184,11,1616,7,49,39,2,97
OLAYA,2018,4,ANTIOQUIA,511,780,98,33,184,11,1617,7,49,39,2,97
OLAYA,2018,5,ANTIOQUIA,507,782,101,35,185,11,1621,6,49,39,2,96
OLAYA,2018,6,ANTIOQUIA,507,784,102,35,185,11,1624,6,49,39,2,96
OLAYA,2018,7,ANTIOQUIA,510,783,99,33,185,11,1621,6,49,39,2,96
OLAYA,2018,8,ANTIOQUIA,511,786,98,34,185,11,1625,6,49,39,2,96
OLAYA,2018,9,ANTIOQUIA,510,787,99,34,185,11,1626,6,49,39,2,96
OLAYA,2019,1,ANTIOQUIA,519,823,132,31,185,10,1700,6,48,39,2,95
OLAYA,2019,10,ANTIOQUIA,532,836,108,24,167,8,1675,9,47,38,2,96
OLAYA,2019,11,ANTIOQUIA,538,860,117,30,182,10,1737,10,47,38,2,97
OLAYA,2019,12,ANTIOQUIA,537,840,105,24,165,8,1679,10,47,40,2,99
OLAYA,2019,2,ANTIOQUIA,515,825,117,24,166,9,1656,6,48,37,2,93
OLAYA,2019,3,ANTIOQUIA,523,827,127,30,185,10,1702,6,48,38,2,94
OLAYA,2019,4,ANTIOQUIA,512,814,113,24,168,8,1639,7,48,38,2,95
OLAYA,2019,5,ANTIOQUIA,529,851,124,30,185,10,1729,7,47,38,2,94
OLAYA,2019,6,ANTIOQUIA,518,819,110,24,168,8,1647,7,47,38,2,94
OLAYA,2019,7,ANTIOQUIA,527,839,123,30,185,10,1714,7,47,38,2,94
OLAYA,2019,8,ANTIOQUIA,523,839,109,25,168,8,1672,8,47,38,2,95
OLAYA,2019,9,ANTIOQUIA,528,833,107,24,165,8,1665,9,47,37,2,95
OLAYA,2020,1,ANTIOQUIA,533,840,105,25,165,8,1676,10,47,40,2,99
OLAYA,2020,10,ANTIOQUIA,645,907,109,25,168,9,1863,12,49,41,54,156
OLAYA,2020,11,ANTIOQUIA,645,909,109,25,167,9,1864,12,48,42,54,156
OLAYA,2020,12,ANTIOQUIA,658,916,111,25,167,10,1887,12,48,42,54,156
OLAYA,2020,2,ANTIOQUIA,535,839,104,26,165,8,1677,11,47,40,54,152
OLAYA,2020,3,ANTIOQUIA,536,840,104,26,165,8,1679,11,47,40,54,152
OLAYA,2020,4,ANTIOQUIA,538,842,104,23,165,8,1680,11,47,40,54,152
OLAYA,2020,5,ANTIOQUIA,542,846,105,23,165,8,1689,11,47,40,53,151
OLAYA,2020,6,ANTIOQUIA,542,846,105,23,166,8,1690,11,47,40,54,152
OLAYA,2020,7,ANTIOQUIA,569,866,106,23,167,8,1739,12,48,41,54,155
OLAYA,2020,8,ANTIOQUIA,626,900,108,25,168,10,1837,12,48,41,54,155
OLAYA,2020,9,ANTIOQUIA,631,905,108,25,168,10,1847,12,48,41,54,155
OLAYA,2021,1,ANTIOQUIA,659,919,110,25,167,10,1890,12,49,42,54,157
OLAYA,2021,10,ANTIOQUIA,665,934,113,22,165,10,1909,10,50,43,54,157
OLAYA,2021,11,ANTIOQUIA,664,936,114,22,165,10,1911,10,50,43,54,157
OLAYA,2021,12,ANTIOQUIA,668,938,114,23,166,10,1919,11,51,43,54,159
OLAYA,2021,2,ANTIOQUIA,661,919,110,25,167,10,1892,12,49,42,54,157
OLAYA,2021,3,ANTIOQUIA,662,924,111,22,167,10,1896,10,49,42,54,155
OLAYA,2021,4,ANTIOQUIA,664,923,111,22,167,10,1897,10,49,42,54,155
OLAYA,2021,5,ANTIOQUIA,662,925,112,22,166,10,1897,10,49,43,54,156
OLAYA,2021,6,ANTIOQUIA,663,924,112,22,166,10,1897,10,49,43,54,156
OLAYA,2021,7,ANTIOQUIA,664,927,112,22,166,10,1901,10,49,43,54,156
OLAYA,2021,8,ANTIOQUIA,664,928,113,22,165,10,1902,10,49,43,54,156
OLAYA,2021,9,ANTIOQUIA,665,933,113,22,165,10,1908,10,49,43,54,156
OLAYA,2022,1,ANTIOQUIA,667,940,114,24,166,10,1921,11,51,43,54,159
OLAYA,2022,10,ANTIOQUIA,671,968,113,23,166,10,1951,12,51,43,54,160
OLAYA,2022,11,ANTIOQUIA,671,974,112,24,166,10,1957,12,51,43,54,160
OLAYA,2022,12,ANTIOQUIA,672,975,112,24,166,10,1959,11,51,43,54,159
OLAYA,2022,2,ANTIOQUIA,669,943,113,24,166,10,1925,11,51,43,54,159
OLAYA,2022,3,ANTIOQUIA,667,950,113,24,165,10,1929,10,51,44,54,159
OLAYA,2022,4,ANTIOQUIA,669,950,114,23,165,10,1931,11,51,43,54,159
OLAYA,2022,5,ANTIOQUIA,670,954,114,23,166,10,1937,11,51,43,54,159
OLAYA,2022,6,ANTIOQUIA,671,956,115,23,166,10,1941,12,51,43,54,160
OLAYA,2022,7,ANTIOQUIA,669,952,113,23,166,10,1933,11,51,42,54,158
OLAYA,2022,8,ANTIOQUIA,670,959,113,23,166,10,1941,12,51,42,54,159
OLAYA,2022,9,ANTIOQUIA,670,966,113,23,166,10,1948,12,51,42,54,159
OLAYA,2023,1,ANTIOQUIA,674,983,112,24,166,10,1969,10,51,43,54,158
OLAYA,2023,2,ANTIOQUIA,676,986,113,24,166,10,1975,11,51,43,54,159
OLAYA,2023,3,ANTIOQUIA,678,992,113,23,166,10,1982,11,51,43,54,159
OLAYA,2023,4,ANTIOQUIA,679,995,113,23,166,10,1986,11,51,43,54,159
OLAYA,2023,5,ANTIOQUIA,682,997,114,23,166,10,1992,11,51,43,54,159
OLAYA,2023,6,ANTIOQUIA,685,1000,114,23,166,10,1998,12,52,43,54,161
OLAYA,2023,7,ANTIOQUIA,688,1005,112,23,166,10,2004,11,52,43,54,160
OLAYA,2023,8,ANTIOQUIA,691,1007,113,24,166,10,2011,10,52,43,54,159
OLAYA,2023,9,ANTIOQUIA,692,1012,111,25,166,10,2016,10,52,43,54,159
PENOL,2018,1,ANTIOQUIA,468,6704,1216,261,40,22,8711,68,703,54,8,833
PENOL,2018,10,ANTIOQUIA,475,6874,1234,258,39,21,8901,79,712,53,8,852
PENOL,2018,11,ANTIOQUIA,474,6897,1233,256,39,21,8920,82,712,53,8,855
PENOL,2018,12,ANTIOQUIA,480,6917,1234,259,39,21,8950,82,715,53,8,858
PENOL,2018,2,ANTIOQUIA,469,6705,1216,262,40,21,8713,68,701,53,8,830
PENOL,2018,3,ANTIOQUIA,469,6772,1217,262,40,21,8781,68,701,53,8,830
PENOL,2018,4,ANTIOQUIA,466,6792,1219,261,40,21,8799,70,700,53,8,831
PENOL,2018,5,ANTIOQUIA,468,6799,1221,259,40,21,8808,69,699,53,8,829
PENOL,2018,6,ANTIOQUIA,473,6816,1223,259,40,21,8832,70,709,53,8,840
PENOL,2018,7,ANTIOQUIA,469,6837,1224,258,40,21,8849,70,709,53,8,840
PENOL,2018,8,ANTIOQUIA,473,6854,1226,258,40,21,8872,72,711,53,8,844
PENOL,2018,9,ANTIOQUIA,476,6853,1228,258,39,21,8875,75,712,53,8,848
PENOL,2019,1,ANTIOQUIA,479,6933,1235,262,40,22,8971,78,716,53,8,855
PENOL,2019,10,ANTIOQUIA,508,7138,1212,266,40,22,9186,82,724,55,8,869
PENOL,2019,11,ANTIOQUIA,511,7160,1213,268,40,22,9214,83,725,55,8,871
PENOL,2019,12,ANTIOQUIA,515,7209,1216,272,40,22,9274,85,724,55,8,872
PENOL,2019,2,ANTIOQUIA,481,6946,1236,262,40,22,8987,81,719,53,8,861
PENOL,2019,3,ANTIOQUIA,493,6955,1236,263,41,22,9010,83,722,53,8,866
PENOL,2019,4,ANTIOQUIA,489,6975,1234,261,40,22,9021,83,721,54,8,866
PENOL,2019,5,ANTIOQUIA,500,7010,1235,262,40,22,9069,83,722,54,8,867
PENOL,2019,6,ANTIOQUIA,505,7018,1233,262,40,22,9080,83,723,54,8,868
PENOL,2019,7,ANTIOQUIA,503,7074,1204,264,40,22,9107,79,723,54,8,864
PENOL,2019,8,ANTIOQUIA,505,7092,1205,265,40,22,9129,81,724,54,8,867
PENOL,2019,9,ANTIOQUIA,511,7101,1207,266,40,22,9147,82,724,56,7,869
PENOL,2020,1,ANTIOQUIA,511,7217,1216,283,40,22,9289,83,726,55,8,872
PENOL,2020,10,ANTIOQUIA,525,7393,1231,309,41,25,9524,84,747,55,165,1051
PENOL,2020,11,ANTIOQUIA,528,7407,1229,316,41,25,9546,85,746,55,165,1051
PENOL,2020,12,ANTIOQUIA,532,7412,1230,323,41,25,9563,86,751,55,165,1057
PENOL,2020,2,ANTIOQUIA,513,7237,1216,282,41,22,9311,83,729,60,165,1037
PENOL,2020,3,ANTIOQUIA,513,7257,1217,282,41,24,9334,85,730,60,165,1040
PENOL,2020,4,ANTIOQUIA,512,7264,1217,277,41,24,9335,83,736,55,165,1039
PENOL,2020,5,ANTIOQUIA,513,7279,1217,278,41,26,9354,83,740,55,165,1043
PENOL,2020,6,ANTIOQUIA,516,7277,1217,282,41,25,9358,83,738,55,165,1041
PENOL,2020,7,ANTIOQUIA,515,7313,1222,288,41,25,9404,81,739,55,165,1040
PENOL,2020,8,ANTIOQUIA,522,7348,1225,295,41,25,9456,81,740,55,165,1041
PENOL,2020,9,ANTIOQUIA,525,7380,1229,301,41,25,9501,82,743,55,165,1045
PENOL,2021,1,ANTIOQUIA,531,7456,1231,315,41,25,9599,88,753,55,165,1061
PENOL,2021,10,ANTIOQUIA,549,7703,1274,354,43,23,9946,92,786,55,165,1098
PENOL,2021,11,ANTIOQUIA,549,7721,1276,355,42,22,9965,91,786,55,167,1099
PENOL,2021,12,ANTIOQUIA,551,7747,1289,359,42,22,10010,94,790,55,165,1104
PENOL,2021,2,ANTIOQUIA,532,7474,1231,327,41,25,9630,91,754,55,165,1065
PENOL,2021,3,ANTIOQUIA,538,7544,1232,333,41,25,9713,93,758,55,165,1071
PENOL,2021,4,ANTIOQUIA,537,7561,1233,338,41,24,9734,91,761,55,165,1072
PENOL,2021,5,ANTIOQUIA,538,7599,1236,344,41,23,9781,90,768,55,165,1078
PENOL,2021,6,ANTIOQUIA,542,7613,1236,341,41,24,9797,90,770,55,165,1080
PENOL,2021,7,ANTIOQUIA,545,7625,1237,343,41,23,9814,88,770,55,165,1078
PENOL,2021,8,ANTIOQUIA,545,7655,1239,343,42,23,9847,88,773,55,165,1081
PENOL,2021,9,ANTIOQUIA,547,7654,1241,343,41,24,9850,88,773,55,165,1081
PENOL,2022,1,ANTIOQUIA,550,7759,1292,360,43,23,10027,91,794,55,165,1105
PENOL,2022,10,ANTIOQUIA,598,6661,2545,419,44,21,10288,112,819,56,166,1153
PENOL,2022,11,ANTIOQUIA,603,6683,2549,417,44,21,10317,111,821,56,166,1154
PENOL,2022,12,ANTIOQUIA,607,6700,2556,430,44,21,10358,110,823,56,166,1155
PENOL,2022,2,ANTIOQUIA,550,7775,1294,359,42,22,10042,91,791,55,166,1103
PENOL,2022,3,ANTIOQUIA,554,7782,1318,350,42,22,10068,95,795,56,164,1110
PENOL,2022,4,ANTIOQUIA,552,7783,1345,354,42,22,10098,96,803,56,164,1119
PENOL,2022,5,ANTIOQUIA,594,6584,2423,454,43,22,10120,98,803,56,164,1121
PENOL,2022,6,ANTIOQUIA,600,6606,2433,454,43,22,10158,109,804,56,164,1133
PENOL,2022,7,ANTIOQUIA,595,6573,2455,456,43,21,10143,106,812,55,164,1137
PENOL,2022,8,ANTIOQUIA,598,6606,2475,454,43,21,10197,108,816,56,165,1145
PENOL,2022,9,ANTIOQUIA,600,6630,2536,429,43,21,10259,109,816,56,165,1146
PENOL,2023,1,ANTIOQUIA,605,6723,2550,441,44,21,10384,115,823,57,166,1161
PENOL,2023,2,ANTIOQUIA,606,6761,2561,441,44,21,10434,114,827,57,166,1164
PENOL,2023,3,ANTIOQUIA,615,6820,2563,442,44,21,10505,115,829,57,166,1167
PENOL,2023,4,ANTIOQUIA,615,6865,2569,439,45,21,10554,120,829,58,166,1173
PENOL,2023,5,ANTIOQUIA,618,6897,2574,451,45,21,10606,120,831,60,166,1177
PENOL,2023,6,ANTIOQUIA,624,6941,2589,453,45,21,10673,129,836,60,166,1191
PENOL,2023,7,ANTIOQUIA,630,6986,2605,439,45,21,10726,128,841,58,166,1193
PENOL,2023,8,ANTIOQUIA,626,7014,2610,436,45,21,10752,133,842,57,166,1198
PENOL,2023,9,ANTIOQUIA,631,6913,2718,484,45,21,10812,134,849,57,166,1206
PEQUE,2018,1,ANTIOQUIA,2192,736,71,4,0,0,3003,3,126,74,2,205
PEQUE,2018,10,ANTIOQUIA,2236,744,78,4,0,0,3062,3,126,74,2,205
PEQUE,2018,11,ANTIOQUIA,2238,742,77,4,0,0,3061,3,126,74,2,205
PEQUE,2018,12,ANTIOQUIA,2236,742,77,4,0,0,3059,3,126,74,2,205
PEQUE,2018,2,ANTIOQUIA,2227,736,70,4,0,0,3037,3,126,74,2,205
PEQUE,2018,3,ANTIOQUIA,2229,737,74,4,0,0,3044,3,126,74,2,205
PEQUE,2018,4,ANTIOQUIA,2230,737,74,4,0,0,3045,3,126,74,2,205
PEQUE,2018,5,ANTIOQUIA,2233,740,75,4,0,0,3052,3,127,74,2,206
PEQUE,2018,6,ANTIOQUIA,2233,741,76,4,0,0,3054,3,128,74,2,207
PEQUE,2018,7,ANTIOQUIA,2232,740,76,4,0,0,3052,3,128,74,2,207
PEQUE,2018,8,ANTIOQUIA,2240,742,77,5,0,0,3064,3,127,74,2,206
PEQUE,2018,9,ANTIOQUIA,2234,742,77,4,0,0,3057,3,127,74,2,206
PEQUE,2019,1,ANTIOQUIA,2239,742,77,4,0,0,3062,3,126,74,2,205
PEQUE,2019,10,ANTIOQUIA,2268,765,74,4,0,0,3111,3,131,75,2,211
PEQUE,2019,11,ANTIOQUIA,2271,768,74,4,0,0,3117,3,130,75,3,211
PEQUE,2019,12,ANTIOQUIA,2277,771,73,4,0,0,3125,3,130,75,3,211
PEQUE,2019,2,ANTIOQUIA,2240,747,78,4,0,0,3069,3,127,74,2,206
PEQUE,2019,3,ANTIOQUIA,2243,752,79,3,0,0,3077,3,127,74,2,206
PEQUE,2019,4,ANTIOQUIA,2245,753,79,3,0,0,3080,3,127,74,2,206
PEQUE,2019,5,ANTIOQUIA,2256,757,79,3,0,0,3095,3,129,74,2,208
PEQUE,2019,6,ANTIOQUIA,2258,757,78,3,0,0,3096,3,130,74,2,209
PEQUE,2019,7,ANTIOQUIA,2262,757,78,3,0,0,3100,3,130,74,2,209
PEQUE,2019,8,ANTIOQUIA,2266,758,78,4,0,0,3106,3,132,74,2,211
PEQUE,2019,9,ANTIOQUIA,2268,762,77,4,0,0,3111,3,131,75,2,211
PEQUE,2020,1,ANTIOQUIA,2276,772,72,5,0,0,3125,3,130,75,3,211
PEQUE,2020,10,ANTIOQUIA,2316,779,72,6,0,0,3173,5,130,75,64,274
PEQUE,2020,11,ANTIOQUIA,2317,783,72,6,0,0,3178,5,130,75,64,274
PEQUE,2020,12,ANTIOQUIA,2322,790,68,5,0,0,3185,5,130,75,64,274
PEQUE,2020,2,ANTIOQUIA,2281,772,72,8,0,0,3133,4,130,76,64,274
PEQUE,2020,3,ANTIOQUIA,2283,774,72,10,0,0,3139,4,130,76,64,274
PEQUE,2020,4,ANTIOQUIA,2288,774,72,6,0,0,3140,4,131,75,64,274
PEQUE,2020,5,ANTIOQUIA,2310,776,72,6,0,0,3164,4,131,75,64,274
PEQUE,2020,6,ANTIOQUIA,2310,777,72,6,0,0,3165,4,131,77,64,276
PEQUE,2020,7,ANTIOQUIA,2313,777,72,6,0,0,3168,5,131,75,64,275
PEQUE,2020,8,ANTIOQUIA,2323,778,72,6,0,0,3179,5,131,75,64,275
PEQUE,2020,9,ANTIOQUIA,2315,779,72,6,0,0,3172,5,130,75,64,274
PEQUE,2021,1,ANTIOQUIA,2322,797,68,5,0,0,3192,5,130,75,64,274
PEQUE,2021,10,ANTIOQUIA,2333,826,63,2,0,0,3224,5,132,75,64,276
PEQUE,2021,11,ANTIOQUIA,2337,830,63,2,0,0,3232,5,133,75,64,277
PEQUE,2021,12,ANTIOQUIA,2340,831,63,2,0,0,3236,5,133,75,64,277
PEQUE,2021,2,ANTIOQUIA,2323,797,68,5,0,0,3193,5,130,75,64,274
PEQUE,2021,3,ANTIOQUIA,2323,800,68,4,0,0,3195,5,131,75,64,275
PEQUE,2021,4,ANTIOQUIA,2323,803,68,4,0,0,3198,5,131,75,64,275
PEQUE,2021,5,ANTIOQUIA,2329,810,67,4,0,0,3210,5,131,75,64,275
PEQUE,2021,6,ANTIOQUIA,2332,810,67,4,0,0,3213,5,131,75,64,275
PEQUE,2021,7,ANTIOQUIA,2325,814,65,3,0,0,3207,5,132,75,64,276
PEQUE,2021,8,ANTIOQUIA,2330,819,64,2,0,0,3215,5,131,75,64,275
PEQUE,2021,9,ANTIOQUIA,2331,823,63,2,0,0,3219,5,133,75,64,277
PEQUE,2022,1,ANTIOQUIA,2340,832,63,2,0,0,3237,5,133,75,64,277
PEQUE,2022,10,ANTIOQUIA,2371,855,62,4,0,0,3292,4,139,76,64,283
PEQUE,2022,11,ANTIOQUIA,2375,858,62,5,0,0,3300,4,139,76,64,283
PEQUE,2022,12,ANTIOQUIA,2376,858,62,5,0,0,3301,4,138,76,64,282
PEQUE,2022,2,ANTIOQUIA,2344,833,63,2,0,0,3242,5,134,75,64,278
PEQUE,2022,3,ANTIOQUIA,2348,835,63,2,0,0,3248,4,134,76,64,278
PEQUE,2022,4,ANTIOQUIA,2352,839,63,2,0,0,3256,4,134,76,64,278
PEQUE,2022,5,ANTIOQUIA,2356,839,64,3,0,0,3262,4,135,76,64,279
PEQUE,2022,6,ANTIOQUIA,2362,841,64,2,0,0,3269,4,136,76,64,280
PEQUE,2022,7,ANTIOQUIA,2362,844,63,2,0,0,3271,4,137,76,64,281
PEQUE,2022,8,ANTIOQUIA,2363,845,63,2,0,0,3273,4,137,76,64,281
PEQUE,2022,9,ANTIOQUIA,2367,850,63,2,0,0,3282,4,138,76,64,282
PEQUE,2023,1,ANTIOQUIA,2381,865,62,5,0,0,3313,4,139,76,64,283
PEQUE,2023,2,ANTIOQUIA,2384,868,62,5,0,0,3319,4,140,76,64,284
PEQUE,2023,3,ANTIOQUIA,2391,867,62,4,0,0,3324,4,140,76,64,284
PEQUE,2023,4,ANTIOQUIA,2396,873,61,4,0,0,3334,4,140,76,64,284
PEQUE,2023,5,ANTIOQUIA,2417,874,61,4,0,0,3356,4,140,76,64,284
PEQUE,2023,6,ANTIOQUIA,2431,875,61,3,0,0,3370,4,140,76,64,284
PEQUE,2023,7,ANTIOQUIA,2445,877,61,3,0,0,3386,4,140,76,64,284
PEQUE,2023,8,ANTIOQUIA,2453,932,61,3,0,0,3449,4,141,76,64,285
PEQUE,2023,9,ANTIOQUIA,2458,936,58,3,0,0,3455,4,142,76,64,286
PUEBLORRICO,2018,1,ANTIOQUIA,1201,963,599,3,0,0,2766,27,234,36,5,302
PUEBLORRICO,2018,10,ANTIOQUIA,1315,1259,252,1,0,0,2827,28,240,36,5,309
PUEBLORRICO,2018,11,ANTIOQUIA,1314,1259,247,1,0,0,2821,28,239,36,5,308
PUEBLORRICO,2018,12,ANTIOQUIA,1317,1262,246,1,0,0,2826,28,239,36,5,308
PUEBLORRICO,2018,2,ANTIOQUIA,1289,1223,259,1,0,0,2772,27,233,36,5,301
PUEBLORRICO,2018,3,ANTIOQUIA,1288,1228,261,1,0,0,2778,27,235,36,5,303
PUEBLORRICO,2018,4,ANTIOQUIA,1289,1230,259,1,0,0,2779,27,237,36,5,305
PUEBLORRICO,2018,5,ANTIOQUIA,1286,1233,257,1,0,0,2777,27,237,36,5,305
PUEBLORRICO,2018,6,ANTIOQUIA,1296,1243,254,1,0,0,2794,27,236,36,5,304
PUEBLORRICO,2018,7,ANTIOQUIA,1300,1247,254,1,0,0,2802,27,238,36,5,306
PUEBLORRICO,2018,8,ANTIOQUIA,1309,1250,254,1,0,0,2814,27,238,36,5,306
PUEBLORRICO,2018,9,ANTIOQUIA,1312,1252,252,1,0,0,2817,28,238,36,5,307
PUEBLORRICO,2019,1,ANTIOQUIA,1318,1266,246,1,0,0,2831,28,238,36,5,307
PUEBLORRICO,2019,10,ANTIOQUIA,1345,1283,239,3,0,0,2870,28,248,37,5,318
PUEBLORRICO,2019,11,ANTIOQUIA,1349,1284,238,3,0,0,2874,28,247,37,5,317
PUEBLORRICO,2019,12,ANTIOQUIA,1351,1286,238,3,0,0,2878,29,247,37,5,318
PUEBLORRICO,2019,2,ANTIOQUIA,1319,1266,246,2,0,0,2833,28,240,36,5,309
PUEBLORRICO,2019,3,ANTIOQUIA,1322,1266,245,2,0,0,2835,28,240,36,5,309
PUEBLORRICO,2019,4,ANTIOQUIA,1325,1261,244,2,0,0,2832,28,244,36,5,313
PUEBLORRICO,2019,5,ANTIOQUIA,1327,1262,243,2,0,0,2834,28,244,36,5,313
PUEBLORRICO,2019,6,ANTIOQUIA,1326,1265,242,2,0,0,2835,28,245,36,5,314
PUEBLORRICO,2019,7,ANTIOQUIA,1328,1270,242,2,0,0,2842,28,243,36,5,312
PUEBLORRICO,2019,8,ANTIOQUIA,1341,1276,242,2,0,0,2861,28,245,36,5,314
PUEBLORRICO,2019,9,ANTIOQUIA,1342,1279,241,2,0,0,2864,28,247,37,5,317
PUEBLORRICO,2020,1,ANTIOQUIA,1348,1283,238,6,0,0,2875,29,248,37,5,319
PUEBLORRICO,2020,10,ANTIOQUIA,1362,1312,236,4,0,0,2914,28,252,37,68,385
PUEBLORRICO,2020,11,ANTIOQUIA,1362,1314,236,4,0,0,2916,28,253,37,68,386
PUEBLORRICO,2020,12,ANTIOQUIA,1366,1315,235,4,0,0,2920,28,254,37,68,387
PUEBLORRICO,2020,2,ANTIOQUIA,1349,1284,238,10,0,0,2881,29,248,41,68,386
PUEBLORRICO,2020,3,ANTIOQUIA,1349,1284,238,12,0,0,2883,29,248,41,68,386
PUEBLORRICO,2020,4,ANTIOQUIA,1352,1288,238,5,0,0,2883,29,252,37,68,386
PUEBLORRICO,2020,5,ANTIOQUIA,1353,1289,238,4,0,0,2884,29,252,37,68,386
PUEBLORRICO,2020,6,ANTIOQUIA,1353,1293,237,4,0,0,2887,29,252,37,68,386
PUEBLORRICO,2020,7,ANTIOQUIA,1353,1294,236,4,0,0,2887,29,252,37,68,386
PUEBLORRICO,2020,8,ANTIOQUIA,1356,1303,234,4,0,0,2897,28,252,37,68,385
PUEBLORRICO,2020,9,ANTIOQUIA,1357,1306,236,4,0,0,2903,28,252,37,68,385
PUEBLORRICO,2021,1,ANTIOQUIA,1367,1315,236,4,0,0,2922,28,254,37,68,387
PUEBLORRICO,2021,10,ANTIOQUIA,1390,1337,238,5,0,0,2970,28,259,37,68,392
PUEBLORRICO,2021,11,ANTIOQUIA,1390,1342,234,5,0,0,2971,28,259,37,68,392
PUEBLORRICO,2021,12,ANTIOQUIA,1393,1344,234,4,0,0,2975,28,259,37,68,392
PUEBLORRICO,2021,2,ANTIOQUIA,1368,1318,236,4,0,0,2926,28,258,37,68,391
PUEBLORRICO,2021,3,ANTIOQUIA,1373,1319,236,4,0,0,2932,28,258,37,68,391
PUEBLORRICO,2021,4,ANTIOQUIA,1375,1320,235,3,0,0,2933,28,258,37,68,391
PUEBLORRICO,2021,5,ANTIOQUIA,1379,1323,235,5,0,0,2942,27,259,37,68,391
PUEBLORRICO,2021,6,ANTIOQUIA,1378,1327,234,5,0,0,2944,27,259,37,68,391
PUEBLORRICO,2021,7,ANTIOQUIA,1380,1330,238,6,0,0,2954,27,259,37,68,391
PUEBLORRICO,2021,8,ANTIOQUIA,1385,1334,238,5,0,0,2962,27,259,37,68,391
PUEBLORRICO,2021,9,ANTIOQUIA,1387,1335,238,5,0,0,2965,27,258,37,68,390
PUEBLORRICO,2022,1,ANTIOQUIA,1397,1346,234,3,0,0,2980,28,259,37,68,392
PUEBLORRICO,2022,10,ANTIOQUIA,1414,1372,236,5,0,0,3027,29,260,37,68,394
PUEBLORRICO,2022,11,ANTIOQUIA,1415,1373,234,6,0,0,3028,30,260,37,68,395
PUEBLORRICO,2022,12,ANTIOQUIA,1415,1383,234,3,0,0,3035,30,260,37,68,395
PUEBLORRICO,2022,2,ANTIOQUIA,1396,1349,233,3,0,0,2981,28,259,37,68,392
PUEBLORRICO,2022,3,ANTIOQUIA,1399,1355,235,4,0,0,2993,28,257,37,68,390
PUEBLORRICO,2022,4,ANTIOQUIA,1406,1355,235,3,0,0,2999,28,257,37,68,390
PUEBLORRICO,2022,5,ANTIOQUIA,1409,1357,235,3,0,0,3004,28,259,37,68,392
PUEBLORRICO,2022,6,ANTIOQUIA,1411,1360,236,3,0,0,3010,28,259,37,68,392
PUEBLORRICO,2022,7,ANTIOQUIA,1414,1364,236,3,0,0,3017,29,260,37,68,394
PUEBLORRICO,2022,8,ANTIOQUIA,1398,1363,236,3,0,0,3000,29,258,37,68,392
PUEBLORRICO,2022,9,ANTIOQUIA,1407,1365,236,3,0,0,3011,29,259,37,68,393
PUEBLORRICO,2023,1,ANTIOQUIA,1416,1386,233,3,0,0,3038,31,259,37,68,395
PUEBLORRICO,2023,2,ANTIOQUIA,1418,1388,233,3,0,0,3042,30,259,37,68,394
PUEBLORRICO,2023,3,ANTIOQUIA,1426,1398,232,3,0,0,3059,31,259,37,68,395
PUEBLORRICO,2023,4,ANTIOQUIA,1435,1400,232,2,0,0,3069,31,260,37,68,396
PUEBLORRICO,2023,5,ANTIOQUIA,1438,1410,231,2,0,0,3081,31,260,37,69,397
PUEBLORRICO,2023,6,ANTIOQUIA,1443,1413,231,2,0,0,3089,31,261,37,69,398
PUEBLORRICO,2023,7,ANTIOQUIA,1444,1416,231,2,0,0,3093,31,263,37,69,400
PUEBLORRICO,2023,8,ANTIOQUIA,1445,1417,231,2,0,0,3095,32,263,37,69,401
PUEBLORRICO,2023,9,ANTIOQUIA,1441,1423,231,2,0,0,3097,33,263,37,69,402
PUERTO BERRIO,2018,1,ANTIOQUIA,8229,3401,1217,55,36,31,12969,139,1244,119,11,1513
PUERTO BERRIO,2018,10,ANTIOQUIA,8392,3479,1239,62,36,30,13238,133,1249,118,11,1511
PUERTO BERRIO,2018,11,ANTIOQUIA,8402,3473,1243,62,36,30,13246,137,1248,118,11,1514
PUERTO BERRIO,2018,12,ANTIOQUIA,8434,3473,1245,63,36,30,13281,137,1247,118,11,1513
PUERTO BERRIO,2018,2,ANTIOQUIA,8281,3402,1224,56,36,30,13029,136,1240,119,11,1506
PUERTO BERRIO,2018,3,ANTIOQUIA,8292,3408,1225,56,36,30,13047,136,1241,119,11,1507
PUERTO BERRIO,2018,4,ANTIOQUIA,8325,3409,1227,55,36,30,13082,135,1243,119,11,1508
PUERTO BERRIO,2018,5,ANTIOQUIA,8304,3404,1224,54,36,30,13052,134,1242,118,11,1505
PUERTO BERRIO,2018,6,ANTIOQUIA,8314,3406,1227,55,36,30,13068,135,1248,119,11,1513
PUERTO BERRIO,2018,7,ANTIOQUIA,8348,3449,1235,56,36,30,13154,136,1253,119,11,1519
PUERTO BERRIO,2018,8,ANTIOQUIA,8376,3456,1239,55,36,30,13192,136,1257,119,11,1523
PUERTO BERRIO,2018,9,ANTIOQUIA,8363,3462,1238,62,36,30,13191,133,1255,118,11,1517
PUERTO BERRIO,2019,1,ANTIOQUIA,8445,3474,1245,63,36,30,13293,139,1247,119,11,1516
PUERTO BERRIO,2019,10,ANTIOQUIA,8550,3501,1242,65,36,30,13424,139,1281,119,13,1552
PUERTO BERRIO,2019,11,ANTIOQUIA,8559,3506,1242,64,36,30,13437,139,1276,119,13,1547
PUERTO BERRIO,2019,12,ANTIOQUIA,8597,3515,1243,65,37,30,13487,138,1289,119,13,1559
PUERTO BERRIO,2019,2,ANTIOQUIA,8462,3477,1245,63,36,30,13313,139,1250,120,11,1520
PUERTO BERRIO,2019,3,ANTIOQUIA,8475,3488,1247,64,36,30,13340,137,1251,119,11,1518
PUERTO BERRIO,2019,4,ANTIOQUIA,8491,3495,1247,65,36,30,13364,138,1250,120,11,1519
PUERTO BERRIO,2019,5,ANTIOQUIA,8528,3502,1247,67,36,30,13410,142,1258,120,12,1532
PUERTO BERRIO,2019,6,ANTIOQUIA,8510,3503,1246,65,37,30,13391,139,1254,120,11,1524
PUERTO BERRIO,2019,7,ANTIOQUIA,8520,3507,1246,65,37,30,13405,137,1254,120,11,1522
PUERTO BERRIO,2019,8,ANTIOQUIA,8525,3503,1246,63,37,30,13404,137,1256,119,11,1523
PUERTO BERRIO,2019,9,ANTIOQUIA,8528,3492,1238,63,37,30,13388,138,1282,119,13,1552
PUERTO BERRIO,2020,1,ANTIOQUIA,8575,3511,1238,84,36,30,13474,136,1292,119,12,1559
PUERTO BERRIO,2020,10,ANTIOQUIA,8704,3547,1249,78,36,30,13644,141,1293,119,302,1855
PUERTO BERRIO,2020,11,ANTIOQUIA,8719,3546,1251,76,36,30,13658,140,1291,119,302,1852
PUERTO BERRIO,2020,12,ANTIOQUIA,8734,3549,1252,87,35,30,13687,138,1296,119,302,1855
PUERTO BERRIO,2020,2,ANTIOQUIA,8603,3519,1239,84,36,30,13511,141,1291,128,302,1862
PUERTO BERRIO,2020,3,ANTIOQUIA,8607,3519,1243,89,37,30,13525,140,1291,128,302,1861
PUERTO BERRIO,2020,4,ANTIOQUIA,8612,3524,1242,76,35,30,13519,140,1293,119,302,1854
PUERTO BERRIO,2020,5,ANTIOQUIA,8654,3534,1250,77,35,30,13580,138,1300,124,301,1863
PUERTO BERRIO,2020,6,ANTIOQUIA,8651,3537,1245,76,36,30,13575,141,1292,121,302,1856
PUERTO BERRIO,2020,7,ANTIOQUIA,8657,3534,1245,78,35,30,13579,141,1291,121,302,1855
PUERTO BERRIO,2020,8,ANTIOQUIA,8667,3541,1244,77,35,30,13594,141,1290,120,302,1853
PUERTO BERRIO,2020,9,ANTIOQUIA,8687,3543,1246,80,36,30,13622,140,1290,120,302,1852
PUERTO BERRIO,2021,1,ANTIOQUIA,8687,3591,1254,102,44,33,13711,138,1292,120,302,1852
PUERTO BERRIO,2021,10,ANTIOQUIA,8686,3638,1288,152,76,44,13884,135,1307,123,303,1868
PUERTO BERRIO,2021,11,ANTIOQUIA,8700,3641,1289,150,76,42,13898,135,1305,123,302,1865
PUERTO BERRIO,2021,12,ANTIOQUIA,8717,3644,1288,140,76,42,13907,137,1304,126,302,1869
PUERTO BERRIO,2021,2,ANTIOQUIA,8549,3614,1282,152,85,44,13726,136,1294,120,302,1852
PUERTO BERRIO,2021,3,ANTIOQUIA,8575,3622,1284,155,83,45,13764,134,1294,120,303,1851
PUERTO BERRIO,2021,4,ANTIOQUIA,8588,3625,1285,160,82,46,13786,134,1295,120,303,1852
PUERTO BERRIO,2021,5,ANTIOQUIA,8599,3626,1287,163,83,45,13803,136,1298,120,303,1857
PUERTO BERRIO,2021,6,ANTIOQUIA,8615,3623,1288,160,82,45,13813,136,1301,121,303,1861
PUERTO BERRIO,2021,7,ANTIOQUIA,8633,3630,1285,160,82,45,13835,135,1304,120,303,1862
PUERTO BERRIO,2021,8,ANTIOQUIA,8645,3632,1286,156,81,44,13844,135,1304,121,303,1863
PUERTO BERRIO,2021,9,ANTIOQUIA,8669,3632,1286,154,76,44,13861,135,1304,121,303,1863
PUERTO BERRIO,2022,1,ANTIOQUIA,8732,3645,1290,140,75,42,13924,136,1303,125,302,1866
PUERTO BERRIO,2022,10,ANTIOQUIA,8812,3666,1283,134,69,40,14004,128,1301,131,302,1862
PUERTO BERRIO,2022,11,ANTIOQUIA,8825,3675,1283,133,68,40,14024,129,1303,131,302,1865
PUERTO BERRIO,2022,12,ANTIOQUIA,8827,3683,1283,134,68,40,14035,131,1302,131,302,1866
PUERTO BERRIO,2022,2,ANTIOQUIA,8739,3647,1291,139,76,41,13933,138,1305,125,302,1870
PUERTO BERRIO,2022,3,ANTIOQUIA,8756,3654,1290,136,76,40,13952,135,1306,129,301,1871
PUERTO BERRIO,2022,4,ANTIOQUIA,8764,3659,1287,136,74,40,13960,135,1307,128,301,1871
PUERTO BERRIO,2022,5,ANTIOQUIA,8771,3666,1290,133,72,40,13972,134,1308,128,301,1871
PUERTO BERRIO,2022,6,ANTIOQUIA,8784,3665,1290,134,70,40,13983,134,1312,128,301,1875
PUERTO BERRIO,2022,7,ANTIOQUIA,8797,3663,1290,134,70,40,13994,134,1311,128,301,1874
PUERTO BERRIO,2022,8,ANTIOQUIA,8786,3660,1284,134,70,40,13974,133,1302,128,302,1865
PUERTO BERRIO,2022,9,ANTIOQUIA,8800,3662,1284,134,69,40,13989,130,1300,131,302,1863
PUERTO BERRIO,2023,1,ANTIOQUIA,8848,3686,1283,134,68,40,14059,130,1300,131,302,1863
PUERTO BERRIO,2023,2,ANTIOQUIA,8865,3701,1284,131,68,40,14089,130,1305,131,302,1868
PUERTO BERRIO,2023,3,ANTIOQUIA,8883,3706,1286,134,68,40,14117,132,1304,131,302,1869
PUERTO BERRIO,2023,4,ANTIOQUIA,8883,3706,1286,137,68,40,14120,130,1301,132,302,1865
PUERTO BERRIO,2023,5,ANTIOQUIA,8896,3709,1289,136,68,40,14138,130,1297,133,302,1862
PUERTO BERRIO,2023,6,ANTIOQUIA,8913,3710,1287,137,68,40,14155,130,1298,133,302,1863
PUERTO BERRIO,2023,7,ANTIOQUIA,8902,3708,1281,137,68,40,14136,129,1299,133,302,1863
PUERTO BERRIO,2023,8,ANTIOQUIA,8917,3706,1282,138,68,40,14151,129,1300,133,302,1864
PUERTO BERRIO,2023,9,ANTIOQUIA,8909,3702,1282,136,68,40,14137,130,1298,133,302,1863
PUERTO NARE,2018,1,ANTIOQUIA,1741,2870,318,22,5,4,4960,29,412,98,17,556
PUERTO NARE,2018,10,ANTIOQUIA,1753,2883,311,26,6,4,4983,29,415,98,18,560
PUERTO NARE,2018,11,ANTIOQUIA,1748,2879,312,25,6,4,4974,29,413,98,16,556
PUERTO NARE,2018,12,ANTIOQUIA,1749,2882,312,26,6,4,4979,29,416,98,16,559
PUERTO NARE,2018,2,ANTIOQUIA,1746,2873,317,22,5,4,4967,29,411,98,17,555
PUERTO NARE,2018,3,ANTIOQUIA,1741,2860,316,22,5,4,4948,29,415,98,17,559
PUERTO NARE,2018,4,ANTIOQUIA,1749,2876,318,22,5,4,4974,29,414,98,17,558
PUERTO NARE,2018,5,ANTIOQUIA,1746,2860,317,22,5,4,4954,29,414,98,16,557
PUERTO NARE,2018,6,ANTIOQUIA,1745,2865,317,22,5,4,4958,29,413,98,16,556
PUERTO NARE,2018,7,ANTIOQUIA,1748,2873,313,24,5,4,4967,29,414,98,16,557
PUERTO NARE,2018,8,ANTIOQUIA,1750,2876,313,25,5,4,4973,29,415,98,16,558
PUERTO NARE,2018,9,ANTIOQUIA,1749,2872,311,25,5,4,4966,29,414,98,16,557
PUERTO NARE,2019,1,ANTIOQUIA,1748,2885,312,26,5,4,4980,29,417,98,16,560
PUERTO NARE,2019,10,ANTIOQUIA,1776,2926,292,28,5,4,5031,30,420,99,17,566
PUERTO NARE,2019,11,ANTIOQUIA,1778,2930,291,28,5,4,5036,30,422,99,17,568
PUERTO NARE,2019,12,ANTIOQUIA,1780,2946,292,28,5,4,5055,30,427,99,17,573
PUERTO NARE,2019,2,ANTIOQUIA,1754,2892,310,28,5,4,4993,28,417,98,16,559
PUERTO NARE,2019,3,ANTIOQUIA,1757,2904,302,27,5,4,4999,28,417,98,16,559
PUERTO NARE,2019,4,ANTIOQUIA,1760,2904,304,28,5,4,5005,28,416,98,16,558
PUERTO NARE,2019,5,ANTIOQUIA,1781,2922,306,28,6,4,5047,29,417,98,16,560
PUERTO NARE,2019,6,ANTIOQUIA,1766,2912,302,28,5,4,5017,28,417,98,16,559
PUERTO NARE,2019,7,ANTIOQUIA,1768,2912,303,28,5,4,5020,28,418,99,16,561
PUERTO NARE,2019,8,ANTIOQUIA,1773,2918,301,27,5,4,5028,28,417,98,16,559
PUERTO NARE,2019,9,ANTIOQUIA,1775,2920,296,29,5,4,5029,30,420,98,17,565
PUERTO NARE,2020,1,ANTIOQUIA,1778,2937,287,29,5,4,5040,31,422,99,17,569
PUERTO NARE,2020,10,ANTIOQUIA,1787,2968,280,31,5,4,5075,35,434,99,138,706
PUERTO NARE,2020,11,ANTIOQUIA,1785,2975,280,31,5,4,5080,36,434,99,138,707
PUERTO NARE,2020,12,ANTIOQUIA,1787,2983,280,34,5,4,5093,36,434,99,138,707
PUERTO NARE,2020,2,ANTIOQUIA,1778,2938,286,30,5,4,5041,35,421,110,138,704
PUERTO NARE,2020,3,ANTIOQUIA,1780,2942,286,30,5,4,5047,35,421,110,138,704
PUERTO NARE,2020,4,ANTIOQUIA,1777,2945,285,30,5,4,5046,35,432,99,137,703
PUERTO NARE,2020,5,ANTIOQUIA,1786,2960,285,30,5,4,5070,33,434,99,138,704
PUERTO NARE,2020,6,ANTIOQUIA,1785,2955,285,30,5,4,5064,34,435,99,138,706
PUERTO NARE,2020,7,ANTIOQUIA,1789,2958,284,30,5,4,5070,34,434,99,138,705
PUERTO NARE,2020,8,ANTIOQUIA,1790,2961,283,29,5,4,5072,35,433,99,138,705
PUERTO NARE,2020,9,ANTIOQUIA,1787,2967,283,29,5,4,5075,35,434,99,138,706
PUERTO NARE,2021,1,ANTIOQUIA,1796,2984,279,35,5,4,5103,36,434,99,138,707
PUERTO NARE,2021,10,ANTIOQUIA,1916,3024,276,32,4,4,5256,35,439,99,138,711
PUERTO NARE,2021,11,ANTIOQUIA,1916,3023,276,31,4,4,5254,37,439,98,138,712
PUERTO NARE,2021,12,ANTIOQUIA,1916,3028,277,32,4,4,5261,37,438,98,138,711
PUERTO NARE,2021,2,ANTIOQUIA,1804,2986,280,34,4,4,5112,35,435,99,138,707
PUERTO NARE,2021,3,ANTIOQUIA,1809,2991,280,33,4,4,5121,35,435,99,138,707
PUERTO NARE,2021,4,ANTIOQUIA,1810,2998,282,31,4,4,5129,35,435,99,138,707
PUERTO NARE,2021,5,ANTIOQUIA,1810,3001,281,31,4,4,5131,35,439,99,138,711
PUERTO NARE,2021,6,ANTIOQUIA,1812,3008,278,31,4,4,5137,33,439,99,139,710
PUERTO NARE,2021,7,ANTIOQUIA,1814,3013,277,32,4,4,5144,33,441,99,138,711
PUERTO NARE,2021,8,ANTIOQUIA,1915,3017,276,32,4,4,5248,35,442,99,137,713
PUERTO NARE,2021,9,ANTIOQUIA,1915,3021,275,32,4,4,5251,35,441,99,138,713
PUERTO NARE,2022,1,ANTIOQUIA,1924,3033,277,30,4,4,5272,35,441,98,138,712
PUERTO NARE,2022,10,ANTIOQUIA,2127,3059,274,31,4,2,5497,33,444,100,137,714
PUERTO NARE,2022,11,ANTIOQUIA,2130,3062,275,30,4,2,5503,33,445,100,137,715
PUERTO NARE,2022,12,ANTIOQUIA,2130,3065,275,34,4,2,5510,33,444,100,137,714
PUERTO NARE,2022,2,ANTIOQUIA,2079,3040,276,31,4,4,5434,35,440,98,138,711
PUERTO NARE,2022,3,ANTIOQUIA,2132,3043,278,31,4,3,5491,33,442,101,136,712
PUERTO NARE,2022,4,ANTIOQUIA,2133,3048,277,31,4,3,5496,33,443,101,136,713
PUERTO NARE,2022,5,ANTIOQUIA,2134,3053,275,31,4,3,5500,34,444,101,137,716
PUERTO NARE,2022,6,ANTIOQUIA,2141,3051,273,31,4,3,5503,34,447,101,137,719
PUERTO NARE,2022,7,ANTIOQUIA,2134,3048,274,32,4,2,5494,35,449,101,134,719
PUERTO NARE,2022,8,ANTIOQUIA,2133,3053,275,30,4,2,5497,34,449,100,134,717
PUERTO NARE,2022,9,ANTIOQUIA,2125,3051,274,31,4,2,5487,33,444,100,137,714
PUERTO NARE,2023,1,ANTIOQUIA,2132,3074,275,34,4,2,5521,33,445,100,137,715
PUERTO NARE,2023,2,ANTIOQUIA,2138,3087,275,34,4,2,5540,33,445,101,137,716
PUERTO NARE,2023,3,ANTIOQUIA,2156,3094,276,34,4,2,5566,33,446,101,137,717
PUERTO NARE,2023,4,ANTIOQUIA,2167,3097,277,34,4,2,5581,33,449,101,137,720
PUERTO NARE,2023,5,ANTIOQUIA,2166,3097,277,34,4,2,5580,32,447,102,137,718
PUERTO NARE,2023,6,ANTIOQUIA,2168,3101,277,33,4,2,5585,32,444,101,137,714
PUERTO NARE,2023,7,ANTIOQUIA,2165,3099,277,29,4,2,5576,32,443,102,137,714
PUERTO NARE,2023,8,ANTIOQUIA,2173,3102,277,29,4,2,5587,34,443,102,138,717
PUERTO NARE,2023,9,ANTIOQUIA,2174,3106,277,29,4,2,5592,32,443,102,138,715
PUERTO TRIUNFO,2018,1,ANTIOQUIA,1145,4090,257,121,84,23,5720,48,542,93,11,694
PUERTO TRIUNFO,2018,10,ANTIOQUIA,1194,4182,253,124,78,23,5854,45,545,92,12,694
PUERTO TRIUNFO,2018,11,ANTIOQUIA,1197,4191,255,124,78,23,5868,45,545,92,13,695
PUERTO TRIUNFO,2018,12,ANTIOQUIA,1206,4200,257,125,77,23,5888,46,552,92,13,703
PUERTO TRIUNFO,2018,2,ANTIOQUIA,1188,4110,257,121,79,23,5778,44,540,93,11,688
PUERTO TRIUNFO,2018,3,ANTIOQUIA,1189,4120,257,120,80,23,5789,44,541,93,11,689
PUERTO TRIUNFO,2018,4,ANTIOQUIA,1192,4134,258,123,80,23,5810,45,541,92,11,689
PUERTO TRIUNFO,2018,5,ANTIOQUIA,1193,4132,258,122,80,23,5808,45,542,92,11,690
PUERTO TRIUNFO,2018,6,ANTIOQUIA,1195,4135,257,122,80,23,5812,45,550,92,11,698
PUERTO TRIUNFO,2018,7,ANTIOQUIA,1195,4155,256,122,80,23,5831,45,550,92,11,698
PUERTO TRIUNFO,2018,8,ANTIOQUIA,1198,4169,255,123,80,23,5848,45,552,92,11,700
PUERTO TRIUNFO,2018,9,ANTIOQUIA,1194,4176,253,124,78,23,5848,45,542,92,11,690
PUERTO TRIUNFO,2019,1,ANTIOQUIA,1206,4214,257,126,78,22,5903,46,551,92,13,702
PUERTO TRIUNFO,2019,10,ANTIOQUIA,1245,4342,256,130,79,22,6074,47,566,92,12,717
PUERTO TRIUNFO,2019,11,ANTIOQUIA,1249,4361,257,131,80,22,6100,47,566,92,12,717
PUERTO TRIUNFO,2019,12,ANTIOQUIA,1261,4385,260,130,80,22,6138,48,580,91,12,731
PUERTO TRIUNFO,2019,2,ANTIOQUIA,1208,4223,257,127,76,22,5913,46,552,92,13,703
PUERTO TRIUNFO,2019,3,ANTIOQUIA,1211,4249,257,127,78,22,5944,46,554,92,13,705
PUERTO TRIUNFO,2019,4,ANTIOQUIA,1213,4251,257,129,77,22,5949,47,557,92,13,709
PUERTO TRIUNFO,2019,5,ANTIOQUIA,1222,4271,260,131,79,22,5985,47,561,92,13,713
PUERTO TRIUNFO,2019,6,ANTIOQUIA,1220,4281,257,130,78,22,5988,47,561,92,12,712
PUERTO TRIUNFO,2019,7,ANTIOQUIA,1220,4295,255,131,79,22,6002,47,564,92,12,715
PUERTO TRIUNFO,2019,8,ANTIOQUIA,1230,4309,255,131,79,22,6026,47,565,92,12,716
PUERTO TRIUNFO,2019,9,ANTIOQUIA,1242,4333,256,131,79,22,6063,48,567,92,12,719
PUERTO TRIUNFO,2020,1,ANTIOQUIA,1254,4378,259,135,80,22,6128,49,575,91,12,727
PUERTO TRIUNFO,2020,10,ANTIOQUIA,1277,4505,262,134,84,22,6284,55,588,92,179,914
PUERTO TRIUNFO,2020,11,ANTIOQUIA,1290,4521,257,135,84,22,6309,55,588,93,179,915
PUERTO TRIUNFO,2020,12,ANTIOQUIA,1294,4530,258,132,85,22,6321,56,584,93,179,912
PUERTO TRIUNFO,2020,2,ANTIOQUIA,1258,4386,258,142,80,22,6146,54,573,97,179,903
PUERTO TRIUNFO,2020,3,ANTIOQUIA,1263,4394,258,142,80,22,6159,54,571,97,179,901
PUERTO TRIUNFO,2020,4,ANTIOQUIA,1264,4406,259,128,81,22,6160,54,580,92,179,905
PUERTO TRIUNFO,2020,5,ANTIOQUIA,1330,4539,263,148,99,24,6403,58,594,92,179,923
PUERTO TRIUNFO,2020,6,ANTIOQUIA,1271,4419,257,132,84,22,6185,54,580,92,179,905
PUERTO TRIUNFO,2020,7,ANTIOQUIA,1274,4428,261,132,84,22,6201,54,583,92,179,908
PUERTO TRIUNFO,2020,8,ANTIOQUIA,1275,4466,261,132,84,22,6240,55,587,92,179,913
PUERTO TRIUNFO,2020,9,ANTIOQUIA,1277,4488,262,132,84,22,6265,55,587,92,179,913
PUERTO TRIUNFO,2021,1,ANTIOQUIA,1296,4544,257,135,84,22,6338,55,586,93,179,913
PUERTO TRIUNFO,2021,10,ANTIOQUIA,1312,4661,257,158,82,23,6493,56,589,94,179,918
PUERTO TRIUNFO,2021,11,ANTIOQUIA,1306,4670,256,159,81,23,6495,56,588,93,179,916
PUERTO TRIUNFO,2021,12,ANTIOQUIA,1310,4680,255,159,82,22,6508,54,589,93,179,915
PUERTO TRIUNFO,2021,2,ANTIOQUIA,1297,4552,257,154,84,22,6366,55,587,93,179,914
PUERTO TRIUNFO,2021,3,ANTIOQUIA,1301,4568,258,153,84,22,6386,55,588,93,179,915
PUERTO TRIUNFO,2021,4,ANTIOQUIA,1303,4572,257,152,82,22,6388,54,589,93,179,915
PUERTO TRIUNFO,2021,5,ANTIOQUIA,1304,4589,258,155,81,22,6409,55,589,93,179,916
PUERTO TRIUNFO,2021,6,ANTIOQUIA,1311,4608,256,155,82,22,6434,55,591,93,179,918
PUERTO TRIUNFO,2021,7,ANTIOQUIA,1310,4614,256,158,82,22,6442,55,590,93,179,917
PUERTO TRIUNFO,2021,8,ANTIOQUIA,1311,4624,256,156,83,22,6452,56,590,94,179,919
PUERTO TRIUNFO,2021,9,ANTIOQUIA,1310,4636,257,156,82,22,6463,56,589,94,179,918
PUERTO TRIUNFO,2022,1,ANTIOQUIA,1311,4694,259,162,81,23,6530,54,589,93,179,915
PUERTO TRIUNFO,2022,10,ANTIOQUIA,1365,4813,260,166,83,25,6712,54,602,98,179,933
PUERTO TRIUNFO,2022,11,ANTIOQUIA,1368,4831,262,167,83,24,6735,54,606,98,179,937
PUERTO TRIUNFO,2022,12,ANTIOQUIA,1370,4836,261,167,83,24,6741,54,607,98,179,938
PUERTO TRIUNFO,2022,2,ANTIOQUIA,1317,4698,260,162,82,23,6542,54,590,93,179,916
PUERTO TRIUNFO,2022,3,ANTIOQUIA,1317,4725,261,166,81,23,6573,49,589,98,179,915
PUERTO TRIUNFO,2022,4,ANTIOQUIA,1319,4735,261,167,81,23,6586,50,591,98,179,918
PUERTO TRIUNFO,2022,5,ANTIOQUIA,1309,4752,260,165,81,24,6591,53,590,98,179,920
PUERTO TRIUNFO,2022,6,ANTIOQUIA,1356,4739,259,165,80,24,6623,53,590,98,179,920
PUERTO TRIUNFO,2022,7,ANTIOQUIA,1355,4760,260,163,83,24,6645,54,591,98,179,922
PUERTO TRIUNFO,2022,8,ANTIOQUIA,1355,4774,261,165,84,24,6663,53,594,98,179,924
PUERTO TRIUNFO,2022,9,ANTIOQUIA,1359,4804,257,164,83,24,6691,54,600,98,179,931
PUERTO TRIUNFO,2023,1,ANTIOQUIA,1373,4862,260,169,83,24,6771,54,610,98,179,941
PUERTO TRIUNFO,2023,2,ANTIOQUIA,1376,4879,260,168,83,24,6790,55,611,98,179,943
PUERTO TRIUNFO,2023,3,ANTIOQUIA,1381,4898,260,168,83,24,6814,55,616,99,179,949
PUERTO TRIUNFO,2023,4,ANTIOQUIA,1397,4914,260,169,83,24,6847,54,618,99,179,950
PUERTO TRIUNFO,2023,5,ANTIOQUIA,1398,4945,259,177,83,23,6885,56,625,99,179,959
PUERTO TRIUNFO,2023,6,ANTIOQUIA,1402,4963,259,175,81,23,6903,56,629,99,179,963
PUERTO TRIUNFO,2023,7,ANTIOQUIA,1402,4965,260,175,80,23,6905,55,636,99,179,969
PUERTO TRIUNFO,2023,8,ANTIOQUIA,1406,4973,260,175,81,23,6918,56,637,99,179,971
PUERTO TRIUNFO,2023,9,ANTIOQUIA,1408,4993,259,174,81,23,6938,55,639,99,179,972
REMEDIOS,2018,1,ANTIOQUIA,5445,3563,1021,11,0,0,10040,173,705,125,9,1012
REMEDIOS,2018,10,ANTIOQUIA,5566,3685,1039,10,0,0,10300,164,703,126,9,1002
REMEDIOS,2018,11,ANTIOQUIA,5566,3687,1041,8,0,0,10302,161,700,126,10,997
REMEDIOS,2018,12,ANTIOQUIA,5594,3697,1041,6,0,0,10338,159,700,126,10,995
REMEDIOS,2018,2,ANTIOQUIA,5450,3574,1022,11,0,0,10057,172,705,125,9,1011
REMEDIOS,2018,3,ANTIOQUIA,5452,3582,1023,12,0,0,10069,171,705,125,9,1010
REMEDIOS,2018,4,ANTIOQUIA,5477,3596,1024,12,0,0,10109,171,707,125,9,1012
REMEDIOS,2018,5,ANTIOQUIA,5450,3596,1025,10,0,0,10081,168,706,125,9,1008
REMEDIOS,2018,6,ANTIOQUIA,5465,3621,1030,9,0,0,10125,168,708,125,9,1010
REMEDIOS,2018,7,ANTIOQUIA,5511,3647,1031,9,0,0,10198,167,709,126,9,1011
REMEDIOS,2018,8,ANTIOQUIA,5547,3660,1036,10,0,0,10253,167,707,126,9,1009
REMEDIOS,2018,9,ANTIOQUIA,5537,3670,1039,10,0,0,10256,163,703,126,9,1001
REMEDIOS,2019,1,ANTIOQUIA,5471,3713,1080,14,2,0,10280,157,695,124,9,985
REMEDIOS,2019,10,ANTIOQUIA,4537,3641,1717,229,32,11,10167,151,696,122,9,978
REMEDIOS,2019,11,ANTIOQUIA,4552,3652,1718,221,33,11,10187,152,696,122,9,979
REMEDIOS,2019,12,ANTIOQUIA,4580,3668,1720,218,32,11,10229,152,697,121,9,979
REMEDIOS,2019,2,ANTIOQUIA,5237,3581,1339,107,23,7,10294,157,700,125,9,991
REMEDIOS,2019,3,ANTIOQUIA,4646,3547,1728,256,38,16,10231,157,694,125,9,985
REMEDIOS,2019,4,ANTIOQUIA,4372,3553,1729,256,38,16,9964,153,690,119,9,971
REMEDIOS,2019,5,ANTIOQUIA,4413,3563,1731,256,38,16,10017,154,691,119,9,973
REMEDIOS,2019,6,ANTIOQUIA,4396,3566,1732,254,38,16,10002,153,690,119,9,971
REMEDIOS,2019,7,ANTIOQUIA,4448,3579,1733,249,37,16,10062,149,695,119,9,972
REMEDIOS,2019,8,ANTIOQUIA,4480,3593,1731,245,36,16,10101,154,695,122,9,980
REMEDIOS,2019,9,ANTIOQUIA,4516,3620,1721,235,34,12,10138,150,696,122,9,977
REMEDIOS,2020,1,ANTIOQUIA,4571,3670,1720,226,33,11,10231,153,696,121,10,980
REMEDIOS,2020,10,ANTIOQUIA,4766,3773,1715,212,27,10,10503,155,725,121,214,1215
REMEDIOS,2020,11,ANTIOQUIA,4790,3794,1711,209,24,10,10538,153,726,121,214,1214
REMEDIOS,2020,12,ANTIOQUIA,4815,3808,1710,203,24,10,10570,154,725,121,214,1214
REMEDIOS,2020,2,ANTIOQUIA,4586,3687,1722,238,32,11,10276,156,698,128,214,1196
REMEDIOS,2020,3,ANTIOQUIA,4593,3698,1722,240,32,11,10296,157,700,128,214,1199
REMEDIOS,2020,4,ANTIOQUIA,4621,3709,1711,213,29,10,10293,152,704,121,214,1191
REMEDIOS,2020,5,ANTIOQUIA,4734,3730,1762,237,34,10,10507,154,705,121,214,1194
REMEDIOS,2020,6,ANTIOQUIA,4674,3731,1716,214,29,10,10374,157,702,121,214,1194
REMEDIOS,2020,7,ANTIOQUIA,4711,3743,1716,214,28,10,10422,152,703,122,214,1191
REMEDIOS,2020,8,ANTIOQUIA,4728,3754,1718,213,28,10,10451,152,701,121,214,1188
REMEDIOS,2020,9,ANTIOQUIA,4756,3771,1721,213,28,10,10499,152,703,121,214,1190
REMEDIOS,2021,1,ANTIOQUIA,4828,3821,1708,203,23,10,10593,154,731,121,214,1220
REMEDIOS,2021,10,ANTIOQUIA,5155,3944,1795,220,22,10,11146,154,746,122,214,1236
REMEDIOS,2021,11,ANTIOQUIA,5166,3961,1800,219,22,10,11178,154,746,122,214,1236
REMEDIOS,2021,12,ANTIOQUIA,5187,3987,1801,220,22,10,11227,156,745,122,214,1237
REMEDIOS,2021,2,ANTIOQUIA,4856,3830,1708,205,22,10,10631,152,732,121,214,1219
REMEDIOS,2021,3,ANTIOQUIA,4881,3838,1707,206,22,10,10664,152,731,121,214,1218
REMEDIOS,2021,4,ANTIOQUIA,4911,3849,1796,283,22,10,10871,152,733,121,214,1220
REMEDIOS,2021,5,ANTIOQUIA,4979,3856,1800,292,22,10,10959,152,735,122,214,1223
REMEDIOS,2021,6,ANTIOQUIA,5066,3863,1787,223,22,10,10971,152,734,122,214,1222
REMEDIOS,2021,7,ANTIOQUIA,5088,3882,1796,224,22,10,11022,153,737,122,214,1226
REMEDIOS,2021,8,ANTIOQUIA,5126,3899,1793,222,22,10,11072,153,742,122,214,1231
REMEDIOS,2021,9,ANTIOQUIA,5144,3918,1790,220,22,10,11104,154,742,122,214,1232
REMEDIOS,2022,1,ANTIOQUIA,5201,4005,1801,222,22,10,11261,159,746,122,214,1241
REMEDIOS,2022,10,ANTIOQUIA,5382,4152,1814,216,21,9,11594,152,758,122,217,1249
REMEDIOS,2022,11,ANTIOQUIA,5419,4182,1813,219,21,9,11663,153,762,122,217,1254
REMEDIOS,2022,12,ANTIOQUIA,5430,4196,1810,220,21,9,11686,153,761,122,217,1253
REMEDIOS,2022,2,ANTIOQUIA,5223,4017,1802,221,22,10,11295,159,746,122,214,1241
REMEDIOS,2022,3,ANTIOQUIA,5254,4033,1813,223,22,10,11355,157,747,122,214,1240
REMEDIOS,2022,4,ANTIOQUIA,5282,4064,1812,229,22,10,11419,157,747,122,215,1241
REMEDIOS,2022,5,ANTIOQUIA,5292,4083,1815,226,22,10,11448,154,747,122,215,1238
REMEDIOS,2022,6,ANTIOQUIA,5313,4095,1815,226,21,10,11480,156,748,122,215,1241
REMEDIOS,2022,7,ANTIOQUIA,5327,4100,1812,224,21,10,11494,154,749,122,198,1223
REMEDIOS,2022,8,ANTIOQUIA,5349,4115,1810,224,21,10,11529,153,750,122,199,1224
REMEDIOS,2022,9,ANTIOQUIA,5371,4131,1814,221,21,9,11567,154,753,122,217,1246
REMEDIOS,2023,1,ANTIOQUIA,5466,4214,1812,223,21,9,11745,152,764,122,217,1255
REMEDIOS,2023,2,ANTIOQUIA,5505,4229,1813,227,21,9,11804,152,769,122,217,1260
REMEDIOS,2023,3,ANTIOQUIA,5517,4238,1812,224,21,9,11821,150,767,122,217,1256
REMEDIOS,2023,4,ANTIOQUIA,5542,4250,1815,225,21,9,11862,151,770,122,217,1260
REMEDIOS,2023,5,ANTIOQUIA,5571,4267,1819,223,21,9,11910,151,772,123,217,1263
REMEDIOS,2023,6,ANTIOQUIA,5630,4293,1813,224,21,9,11990,151,773,123,217,1264
REMEDIOS,2023,7,ANTIOQUIA,5661,4309,1810,224,21,9,12034,152,774,126,217,1269
REMEDIOS,2023,8,ANTIOQUIA,5683,4330,1812,223,22,9,12079,149,779,126,218,1272
REMEDIOS,2023,9,ANTIOQUIA,5693,4347,1808,218,22,9,12097,149,780,123,219,1271
RETIRO,2018,1,ANTIOQUIA,269,1827,3845,1349,1775,62,9127,327,950,100,37,1414
RETIRO,2018,10,ANTIOQUIA,304,1865,3928,1370,1935,74,9476,336,953,108,37,1434
RETIRO,2018,11,ANTIOQUIA,304,1866,3976,1367,1941,74,9528,341,953,110,37,1441
RETIRO,2018,12,ANTIOQUIA,304,1904,3980,1394,1944,74,9600,337,954,110,37,1438
RETIRO,2018,2,ANTIOQUIA,270,1832,3856,1349,1841,61,9209,326,949,100,37,1412
RETIRO,2018,3,ANTIOQUIA,271,1835,3863,1353,1847,61,9230,331,949,100,36,1416
RETIRO,2018,4,ANTIOQUIA,280,1837,3867,1355,1852,70,9261,329,951,100,37,1417
RETIRO,2018,5,ANTIOQUIA,284,1838,3869,1358,1855,72,9276,328,951,100,36,1415
RETIRO,2018,6,ANTIOQUIA,297,1888,3876,1360,1866,72,9359,326,953,100,36,1415
RETIRO,2018,7,ANTIOQUIA,297,1890,3888,1361,1870,72,9378,336,956,103,36,1431
RETIRO,2018,8,ANTIOQUIA,300,1896,3913,1365,1876,73,9423,338,959,104,36,1437
RETIRO,2018,9,ANTIOQUIA,302,1861,3919,1367,1928,73,9450,338,953,106,37,1434
RETIRO,2019,1,ANTIOQUIA,304,1904,3987,1399,1956,74,9624,335,955,111,37,1438
RETIRO,2019,10,ANTIOQUIA,310,1500,4302,1482,2257,74,9925,357,970,114,38,1479
RETIRO,2019,11,ANTIOQUIA,310,1505,4303,1487,2255,74,9934,367,970,115,38,1490
RETIRO,2019,12,ANTIOQUIA,313,1507,4310,1489,2264,75,9958,373,971,117,38,1499
RETIRO,2019,2,ANTIOQUIA,304,1938,3998,1435,1977,76,9728,339,958,112,37,1446
RETIRO,2019,3,ANTIOQUIA,307,1512,4261,1426,2183,85,9774,337,957,112,37,1443
RETIRO,2019,4,ANTIOQUIA,307,1518,4268,1432,2187,85,9797,333,957,114,37,1441
RETIRO,2019,5,ANTIOQUIA,308,1520,4268,1440,2193,87,9816,336,958,112,37,1443
RETIRO,2019,6,ANTIOQUIA,308,1524,4276,1446,2208,75,9837,336,964,112,37,1449
RETIRO,2019,7,ANTIOQUIA,310,1527,4286,1442,2227,74,9866,335,963,113,37,1448
RETIRO,2019,8,ANTIOQUIA,310,1531,4297,1445,2252,74,9909,352,967,113,37,1469
RETIRO,2019,9,ANTIOQUIA,310,1497,4302,1482,2256,74,9921,353,968,114,37,1472
RETIRO,2020,1,ANTIOQUIA,310,1506,4314,1492,2296,75,9993,372,991,117,39,1519
RETIRO,2020,10,ANTIOQUIA,320,1556,4458,1518,2333,82,10267,389,1051,120,398,1958
RETIRO,2020,11,ANTIOQUIA,322,1566,4501,1525,2340,82,10336,384,1056,120,399,1959
RETIRO,2020,12,ANTIOQUIA,323,1575,4507,1530,2344,83,10362,383,1062,120,399,1964
RETIRO,2020,2,ANTIOQUIA,310,1502,4371,1498,2299,83,10063,382,1007,129,399,1917
RETIRO,2020,3,ANTIOQUIA,310,1503,4384,1498,2301,84,10080,385,1008,131,399,1923
RETIRO,2020,4,ANTIOQUIA,311,1508,4389,1498,2311,82,10099,373,1018,120,399,1910
RETIRO,2020,5,ANTIOQUIA,311,1524,4431,1508,2318,82,10174,375,1020,120,399,1914
RETIRO,2020,6,ANTIOQUIA,313,1525,4435,1503,2320,82,10178,375,1037,120,399,1931
RETIRO,2020,7,ANTIOQUIA,316,1535,4442,1507,2323,82,10205,373,1041,120,399,1933
RETIRO,2020,8,ANTIOQUIA,316,1545,4446,1509,2324,82,10222,377,1044,120,398,1939
RETIRO,2020,9,ANTIOQUIA,320,1553,4450,1512,2332,82,10249,382,1046,120,398,1946
RETIRO,2021,1,ANTIOQUIA,323,1578,4510,1537,2344,83,10375,386,1059,120,399,1964
RETIRO,2021,10,ANTIOQUIA,326,1611,4570,1639,2567,118,10831,412,1078,121,399,2010
RETIRO,2021,11,ANTIOQUIA,326,1615,4575,1646,2572,119,10853,412,1078,121,399,2010
RETIRO,2021,12,ANTIOQUIA,327,1622,4579,1648,2574,119,10869,418,1078,121,399,2016
RETIRO,2021,2,ANTIOQUIA,323,1587,4517,1546,2345,86,10404,391,1063,119,398,1971
RETIRO,2021,3,ANTIOQUIA,324,1591,4522,1604,2350,85,10476,396,1063,119,398,1976
RETIRO,2021,4,ANTIOQUIA,324,1610,4529,1604,2420,85,10572,398,1066,119,398,1981
RETIRO,2021,5,ANTIOQUIA,324,1612,4535,1605,2469,87,10632,403,1069,119,398,1989
RETIRO,2021,6,ANTIOQUIA,325,1601,4556,1613,2548,87,10730,404,1068,119,398,1989
RETIRO,2021,7,ANTIOQUIA,325,1605,4556,1615,2552,87,10740,400,1071,120,398,1989
RETIRO,2021,8,ANTIOQUIA,325,1605,4559,1620,2554,87,10750,401,1073,120,395,1989
RETIRO,2021,9,ANTIOQUIA,325,1604,4564,1620,2561,87,10761,402,1078,121,398,1999
RETIRO,2022,1,ANTIOQUIA,327,1627,4589,1649,2627,120,10939,418,1082,121,399,2020
RETIRO,2022,10,ANTIOQUIA,332,1658,4710,1774,2741,138,11353,506,1114,131,395,2146
RETIRO,2022,11,ANTIOQUIA,332,1660,4727,1785,2754,140,11398,526,1114,131,395,2166
RETIRO,2022,12,ANTIOQUIA,332,1664,4728,1795,2762,140,11421,532,1114,131,395,2172
RETIRO,2022,2,ANTIOQUIA,327,1627,4605,1655,2633,120,10967,431,1084,121,399,2035
RETIRO,2022,3,ANTIOQUIA,327,1632,4643,1660,2672,125,11059,437,1088,128,395,2048
RETIRO,2022,4,ANTIOQUIA,327,1638,4646,1668,2679,125,11083,451,1087,128,395,2061
RETIRO,2022,5,ANTIOQUIA,330,1642,4680,1670,2698,128,11148,459,1085,130,395,2069
RETIRO,2022,6,ANTIOQUIA,332,1648,4684,1679,2714,136,11193,470,1087,130,395,2082
RETIRO,2022,7,ANTIOQUIA,332,1646,4693,1686,2720,137,11214,487,1097,131,395,2110
RETIRO,2022,8,ANTIOQUIA,332,1650,4698,1723,2726,139,11268,492,1100,131,395,2118
RETIRO,2022,9,ANTIOQUIA,332,1655,4706,1770,2731,140,11334,500,1111,131,395,2137
RETIRO,2023,1,ANTIOQUIA,332,1670,4736,1853,2777,140,11508,523,1113,132,395,2163
RETIRO,2023,2,ANTIOQUIA,333,1680,4743,1858,2788,142,11544,516,1114,132,396,2158
RETIRO,2023,3,ANTIOQUIA,333,1691,4748,1868,2799,143,11582,507,1114,133,396,2150
RETIRO,2023,4,ANTIOQUIA,334,1698,4759,1879,2809,144,11623,511,1117,132,396,2156
RETIRO,2023,5,ANTIOQUIA,337,1715,4763,1884,2815,146,11660,517,1113,133,397,2160
RETIRO,2023,6,ANTIOQUIA,337,1723,4771,1893,2820,146,11690,516,1109,133,397,2155
RETIRO,2023,7,ANTIOQUIA,337,1728,4805,1902,2831,147,11750,518,1109,133,397,2157
RETIRO,2023,8,ANTIOQUIA,337,1733,4795,1900,2848,146,11759,526,1111,133,398,2168
RETIRO,2023,9,ANTIOQUIA,339,1742,4801,1909,2857,147,11795,524,1120,133,398,2175
RIONEGRO,2018,1,ANTIOQUIA,1298,9764,19117,8644,2076,623,41522,706,5891,251,99,6947
RIONEGRO,2018,10,ANTIOQUIA,1443,10193,19589,9189,2244,644,43302,738,6143,255,100,7236
RIONEGRO,2018,11,ANTIOQUIA,1456,10238,19677,9150,2245,645,43411,742,6142,255,100,7239
RIONEGRO,2018,12,ANTIOQUIA,1470,10258,19873,9294,2250,660,43805,749,6099,254,101,7203
RIONEGRO,2018,2,ANTIOQUIA,1303,9852,19131,8751,2073,622,41732,703,5947,251,99,7000
RIONEGRO,2018,3,ANTIOQUIA,1302,9869,19162,8773,2075,624,41805,709,5975,251,100,7035
RIONEGRO,2018,4,ANTIOQUIA,1306,9897,19196,8936,2075,643,42053,718,5988,252,101,7059
RIONEGRO,2018,5,ANTIOQUIA,1336,9913,19215,8952,2076,645,42137,712,6008,258,101,7079
RIONEGRO,2018,6,ANTIOQUIA,1335,10061,19268,8961,2202,637,42464,717,6023,255,101,7096
RIONEGRO,2018,7,ANTIOQUIA,1380,10101,19286,8975,2219,640,42601,717,6037,255,100,7109
RIONEGRO,2018,8,ANTIOQUIA,1394,10131,19304,9037,2237,640,42743,728,6064,255,99,7146
RIONEGRO,2018,9,ANTIOQUIA,1421,10161,19475,9111,2240,642,43050,730,6125,256,99,7210
RIONEGRO,2019,1,ANTIOQUIA,1464,10301,19913,9377,2249,676,43980,744,6282,272,98,7396
RIONEGRO,2019,10,ANTIOQUIA,1761,9916,21188,9650,2424,969,45908,859,6491,280,107,7737
RIONEGRO,2019,11,ANTIOQUIA,1792,9913,21259,9871,2422,977,46234,843,6530,284,108,7765
RIONEGRO,2019,12,ANTIOQUIA,1797,9951,21318,9875,2423,979,46343,846,6581,283,109,7819
RIONEGRO,2019,2,ANTIOQUIA,1475,10302,19936,9403,2218,705,44039,785,6315,272,100,7472
RIONEGRO,2019,3,ANTIOQUIA,1563,9818,20621,9299,2216,742,44259,779,6322,271,103,7475
RIONEGRO,2019,4,ANTIOQUIA,1622,9679,20846,9266,2207,976,44596,781,6329,272,103,7485
RIONEGRO,2019,5,ANTIOQUIA,1631,9690,20859,9281,2207,976,44644,784,6340,276,103,7503
RIONEGRO,2019,6,ANTIOQUIA,1637,9755,20797,9350,2217,968,44724,841,6352,276,103,7572
RIONEGRO,2019,7,ANTIOQUIA,1666,9781,20827,9373,2218,968,44833,845,6382,276,104,7607
RIONEGRO,2019,8,ANTIOQUIA,1674,9883,20904,9486,2291,965,45203,849,6419,277,105,7650
RIONEGRO,2019,9,ANTIOQUIA,1703,9903,20923,9555,2423,963,45470,860,6436,280,104,7680
RIONEGRO,2020,1,ANTIOQUIA,1803,9934,21338,10041,2423,1000,46539,846,6559,298,105,7808
RIONEGRO,2020,10,ANTIOQUIA,1871,10348,21526,10287,2627,1036,47695,868,6763,321,1827,9779
RIONEGRO,2020,11,ANTIOQUIA,1879,10383,21563,10307,2628,1165,47925,869,6820,322,1828,9839
RIONEGRO,2020,12,ANTIOQUIA,1891,10417,21759,10496,2619,1176,48358,878,6835,323,1828,9864
RIONEGRO,2020,2,ANTIOQUIA,1804,9953,21100,10065,2610,1001,46533,863,6745,328,1828,9764
RIONEGRO,2020,3,ANTIOQUIA,1815,10097,21209,10082,2616,1002,46821,867,6753,333,1827,9780
RIONEGRO,2020,4,ANTIOQUIA,1832,10211,21557,9983,2522,1003,47108,863,6710,307,1828,9708
RIONEGRO,2020,5,ANTIOQUIA,1840,10229,21318,10005,2621,1016,47029,870,6900,306,1828,9904
RIONEGRO,2020,6,ANTIOQUIA,1847,10231,21612,9997,2533,1019,47239,869,6720,307,1827,9723
RIONEGRO,2020,7,ANTIOQUIA,1858,10247,21643,10011,2534,1028,47321,868,6728,308,1828,9732
RIONEGRO,2020,8,ANTIOQUIA,1868,10278,21641,10054,2531,1027,47399,871,6735,314,1828,9748
RIONEGRO,2020,9,ANTIOQUIA,1872,10317,21488,10258,2628,1032,47595,867,6751,319,1828,9765
RIONEGRO,2021,1,ANTIOQUIA,1954,10328,21548,10807,2636,1251,48524,876,6836,323,1828,9863
RIONEGRO,2021,10,ANTIOQUIA,1987,10763,22009,11746,2819,1280,50604,921,7008,332,1830,10091
RIONEGRO,2021,11,ANTIOQUIA,1990,10789,22173,11769,2829,1282,50832,927,7022,331,1830,10110
RIONEGRO,2021,12,ANTIOQUIA,1987,10807,22220,11863,2842,1287,51006,927,7021,332,1830,10110
RIONEGRO,2021,2,ANTIOQUIA,1953,10357,21585,10827,2735,1255,48712,878,6846,324,1828,9876
RIONEGRO,2021,3,ANTIOQUIA,1949,10401,21622,10855,2735,1263,48825,882,6859,326,1828,9895
RIONEGRO,2021,4,ANTIOQUIA,1950,10433,21643,10862,2745,1264,48897,890,6894,326,1829,9939
RIONEGRO,2021,5,ANTIOQUIA,1967,10449,21849,10983,2774,1271,49293,891,6909,326,1828,9954
RIONEGRO,2021,6,ANTIOQUIA,1976,10469,21858,11170,2776,1270,49519,886,6927,326,1829,9968
RIONEGRO,2021,7,ANTIOQUIA,1978,10496,21894,11192,2775,1273,49608,900,6936,327,1830,9993
RIONEGRO,2021,8,ANTIOQUIA,1980,10552,21911,11510,2778,1276,50007,909,6960,330,1832,10031
RIONEGRO,2021,9,ANTIOQUIA,1980,10710,21952,11531,2783,1277,50233,920,6982,331,1833,10066
RIONEGRO,2022,1,ANTIOQUIA,1987,10838,22245,11876,2848,1287,51081,934,7042,332,1832,10140
RIONEGRO,2022,10,ANTIOQUIA,2343,10777,21458,12472,4773,1409,53232,998,7224,349,1837,10408
RIONEGRO,2022,11,ANTIOQUIA,2324,10793,21548,12620,4742,1415,53442,1025,7277,349,1839,10490
RIONEGRO,2022,12,ANTIOQUIA,2326,10828,21574,12638,4746,1423,53535,1016,7277,348,1840,10481
RIONEGRO,2022,2,ANTIOQUIA,2312,10882,22263,12074,2855,1289,51675,945,7052,331,1833,10161
RIONEGRO,2022,3,ANTIOQUIA,2306,10343,21150,13366,3358,1379,51902,950,7065,340,1830,10185
RIONEGRO,2022,4,ANTIOQUIA,2306,10344,21060,12298,4751,1397,52156,962,7072,340,1831,10205
RIONEGRO,2022,5,ANTIOQUIA,2294,10394,21155,12268,4754,1399,52264,964,7090,345,1833,10232
RIONEGRO,2022,6,ANTIOQUIA,2306,10442,21211,12269,4761,1400,52389,970,7168,349,1835,10322
RIONEGRO,2022,7,ANTIOQUIA,2317,10509,21239,12359,4767,1402,52593,971,7172,349,1835,10327
RIONEGRO,2022,8,ANTIOQUIA,2323,10607,21220,12362,4768,1403,52683,979,7173,349,1835,10336
RIONEGRO,2022,9,ANTIOQUIA,2325,10741,21324,12370,4774,1407,52941,991,7175,349,1836,10351
RIONEGRO,2023,1,ANTIOQUIA,2470,10897,21629,12663,4850,1415,53924,1012,7275,349,1841,10477
RIONEGRO,2023,2,ANTIOQUIA,2478,10948,21667,12663,4860,1410,54026,1014,7297,350,1843,10504
RIONEGRO,2023,3,ANTIOQUIA,2484,11010,21813,12684,4860,1431,54282,1016,7307,349,1842,10514
RIONEGRO,2023,4,ANTIOQUIA,2484,11106,21875,12664,4827,1550,54506,1019,7353,352,1842,10566
RIONEGRO,2023,5,ANTIOQUIA,2483,11138,21902,12683,4828,1553,54587,1029,7367,353,1844,10593
RIONEGRO,2023,6,ANTIOQUIA,2496,11185,22034,12617,4830,1554,54716,1037,7375,353,1844,10609
RIONEGRO,2023,7,ANTIOQUIA,2501,11223,22014,12681,4834,1556,54809,1045,7387,353,1842,10627
RIONEGRO,2023,8,ANTIOQUIA,2507,11309,22101,12789,4868,1559,55133,1040,7388,353,1843,10624
RIONEGRO,2023,9,ANTIOQUIA,2511,11438,22286,12879,4871,1564,55549,1048,7376,353,1843,10620
SABANALARGA,2018,1,ANTIOQUIA,2586,986,169,1,0,0,3742,8,153,65,6,232
SABANALARGA,2018,10,ANTIOQUIA,2639,1023,168,1,0,0,3831,9,157,65,6,237
SABANALARGA,2018,11,ANTIOQUIA,2639,1019,168,1,0,0,3827,9,157,65,6,237
SABANALARGA,2018,12,ANTIOQUIA,2649,1022,170,1,0,0,3842,9,158,65,6,238
SABANALARGA,2018,2,ANTIOQUIA,2578,985,170,1,0,0,3734,5,153,65,6,229
SABANALARGA,2018,3,ANTIOQUIA,2579,988,170,1,0,0,3738,9,153,65,6,233
SABANALARGA,2018,4,ANTIOQUIA,2587,992,171,1,0,0,3751,9,153,65,6,233
SABANALARGA,2018,5,ANTIOQUIA,2578,997,170,1,0,0,3746,9,154,65,6,234
SABANALARGA,2018,6,ANTIOQUIA,2587,1001,169,1,0,0,3758,9,154,65,6,234
SABANALARGA,2018,7,ANTIOQUIA,2594,1007,169,1,0,0,3771,9,154,65,6,234
SABANALARGA,2018,8,ANTIOQUIA,2603,1012,169,1,0,0,3785,9,155,65,6,235
SABANALARGA,2018,9,ANTIOQUIA,2600,1014,168,1,0,0,3783,9,156,65,6,236
SABANALARGA,2019,1,ANTIOQUIA,2661,1022,170,1,0,0,3854,9,158,65,6,238
SABANALARGA,2019,10,ANTIOQUIA,2689,1046,169,1,0,0,3905,9,162,66,6,243
SABANALARGA,2019,11,ANTIOQUIA,2696,1047,169,1,0,0,3913,9,163,66,6,244
SABANALARGA,2019,12,ANTIOQUIA,2710,1049,169,1,0,0,3929,6,164,66,6,242
SABANALARGA,2019,2,ANTIOQUIA,2651,1025,170,1,0,0,3847,9,158,66,6,239
SABANALARGA,2019,3,ANTIOQUIA,2656,1029,170,1,0,0,3856,9,160,66,6,241
SABANALARGA,2019,4,ANTIOQUIA,2660,1032,169,1,0,0,3862,9,160,66,6,241
SABANALARGA,2019,5,ANTIOQUIA,2669,1037,169,1,0,0,3876,9,160,66,6,241
SABANALARGA,2019,6,ANTIOQUIA,2671,1037,169,1,0,0,3878,9,161,66,6,242
SABANALARGA,2019,7,ANTIOQUIA,2671,1039,169,1,0,0,3880,9,162,66,6,243
SABANALARGA,2019,8,ANTIOQUIA,2673,1042,168,1,0,0,3884,9,163,66,6,244
SABANALARGA,2019,9,ANTIOQUIA,2686,1045,169,1,0,0,3901,9,162,66,6,243
SABANALARGA,2020,1,ANTIOQUIA,2706,1050,168,5,0,0,3929,6,163,66,6,241
SABANALARGA,2020,10,ANTIOQUIA,2750,1073,167,1,0,0,3991,5,169,66,70,310
SABANALARGA,2020,11,ANTIOQUIA,2753,1075,167,1,0,0,3996,5,171,66,70,312
SABANALARGA,2020,12,ANTIOQUIA,2754,1075,167,1,0,0,3997,5,171,66,70,312
SABANALARGA,2020,2,ANTIOQUIA,2712,1055,167,9,0,0,3943,6,165,70,70,311
SABANALARGA,2020,3,ANTIOQUIA,2721,1059,167,9,0,0,3956,6,166,70,70,312
SABANALARGA,2020,4,ANTIOQUIA,2731,1059,167,1,0,0,3958,6,170,66,70,312
SABANALARGA,2020,5,ANTIOQUIA,2731,1058,167,2,0,0,3958,6,170,66,70,312
SABANALARGA,2020,6,ANTIOQUIA,2734,1060,167,1,0,0,3962,6,170,66,70,312
SABANALARGA,2020,7,ANTIOQUIA,2739,1062,167,1,0,0,3969,5,170,66,70,311
SABANALARGA,2020,8,ANTIOQUIA,2741,1068,167,1,0,0,3977,5,170,66,70,311
SABANALARGA,2020,9,ANTIOQUIA,2784,1074,167,1,0,0,4026,5,170,66,70,311
SABANALARGA,2021,1,ANTIOQUIA,2757,1076,167,1,0,0,4001,5,172,66,70,313
SABANALARGA,2021,10,ANTIOQUIA,2780,1090,165,2,0,0,4037,5,172,66,70,313
SABANALARGA,2021,11,ANTIOQUIA,2783,1092,165,2,0,0,4042,5,172,66,70,313
SABANALARGA,2021,12,ANTIOQUIA,2784,1094,165,2,0,0,4045,5,173,66,70,314
SABANALARGA,2021,2,ANTIOQUIA,2763,1077,167,2,0,0,4009,5,172,66,70,313
SABANALARGA,2021,3,ANTIOQUIA,2764,1078,167,2,0,0,4011,5,172,66,70,313
SABANALARGA,2021,4,ANTIOQUIA,2768,1082,167,2,0,0,4019,5,172,66,70,313
SABANALARGA,2021,5,ANTIOQUIA,2772,1082,167,2,0,0,4023,5,173,66,69,313
SABANALARGA,2021,6,ANTIOQUIA,2772,1084,166,1,0,0,4023,5,171,66,69,311
SABANALARGA,2021,7,ANTIOQUIA,2780,1085,166,1,0,0,4032,5,171,66,69,311
SABANALARGA,2021,8,ANTIOQUIA,2779,1087,165,2,0,0,4033,5,172,66,68,311
SABANALARGA,2021,9,ANTIOQUIA,2779,1089,165,2,0,0,4035,5,172,66,70,313
SABANALARGA,2022,1,ANTIOQUIA,2791,1095,166,2,0,0,4054,5,174,66,70,315
SABANALARGA,2022,10,ANTIOQUIA,2814,1129,164,2,0,0,4109,5,176,64,69,314
SABANALARGA,2022,11,ANTIOQUIA,2820,1137,163,3,0,0,4123,5,176,64,69,314
SABANALARGA,2022,12,ANTIOQUIA,2826,1140,162,3,0,0,4131,5,176,64,69,314
SABANALARGA,2022,2,ANTIOQUIA,2792,1096,166,2,0,0,4056,5,174,66,70,315
SABANALARGA,2022,3,ANTIOQUIA,2795,1102,165,2,0,0,4064,5,175,66,69,315
SABANALARGA,2022,4,ANTIOQUIA,2793,1114,166,2,0,0,4075,5,175,66,69,315
SABANALARGA,2022,5,ANTIOQUIA,2802,1119,166,2,0,0,4089,5,175,66,69,315
SABANALARGA,2022,6,ANTIOQUIA,2812,1119,165,2,0,0,4098,5,175,66,69,315
SABANALARGA,2022,7,ANTIOQUIA,2799,1121,165,2,0,0,4087,5,175,64,69,313
SABANALARGA,2022,8,ANTIOQUIA,2806,1128,163,3,0,0,4100,5,174,64,69,312
SABANALARGA,2022,9,ANTIOQUIA,2810,1132,164,2,0,0,4108,5,174,64,69,312
SABANALARGA,2023,1,ANTIOQUIA,2830,1145,161,3,0,0,4139,5,179,64,69,317
SABANALARGA,2023,2,ANTIOQUIA,2833,1150,161,3,0,0,4147,5,180,64,69,318
SABANALARGA,2023,3,ANTIOQUIA,2847,1151,161,4,0,0,4163,5,179,64,69,317
SABANALARGA,2023,4,ANTIOQUIA,2860,1153,161,3,0,0,4177,5,179,64,69,317
SABANALARGA,2023,5,ANTIOQUIA,2873,1155,161,5,0,0,4194,5,178,65,69,317
SABANALARGA,2023,6,ANTIOQUIA,2886,1157,161,5,0,0,4209,5,178,65,69,317
SABANALARGA,2023,7,ANTIOQUIA,2891,1160,161,4,0,0,4216,5,179,65,69,318
SABANALARGA,2023,8,ANTIOQUIA,2898,1161,161,3,0,0,4223,5,180,65,69,319
SABANALARGA,2023,9,ANTIOQUIA,2898,1161,161,3,0,0,4223,5,179,65,69,318
SABANETA,2018,1,ANTIOQUIA,394,7290,14890,10149,89,5,32817,657,2905,74,48,3684
SABANETA,2018,10,ANTIOQUIA,396,7147,15911,11955,80,5,35494,675,3010,77,49,3811
SABANETA,2018,11,ANTIOQUIA,396,7135,15916,11959,80,5,35491,676,3007,77,49,3809
SABANETA,2018,12,ANTIOQUIA,397,7144,15955,11965,80,6,35547,675,3019,77,49,3820
SABANETA,2018,2,ANTIOQUIA,394,7330,15030,10299,89,163,33305,655,2932,74,47,3708
SABANETA,2018,3,ANTIOQUIA,392,7325,15245,10501,89,163,33715,652,2982,74,48,3756
SABANETA,2018,4,ANTIOQUIA,394,7343,15385,10734,89,163,34108,659,3002,74,48,3783
SABANETA,2018,5,ANTIOQUIA,394,7330,15464,10913,89,161,34351,658,2992,76,48,3774
SABANETA,2018,6,ANTIOQUIA,394,7246,15697,11345,89,5,34776,664,2986,76,49,3775
SABANETA,2018,7,ANTIOQUIA,394,7140,15930,11550,80,6,35100,668,2986,76,49,3779
SABANETA,2018,8,ANTIOQUIA,395,7176,15926,11586,80,5,35168,674,3014,78,49,3815
SABANETA,2018,9,ANTIOQUIA,395,7119,15878,11838,80,5,35315,674,3012,77,49,3812
SABANETA,2019,1,ANTIOQUIA,398,7231,16057,12068,80,6,35840,671,3031,76,48,3826
SABANETA,2019,10,ANTIOQUIA,399,8107,16776,13369,79,6,38736,677,3104,83,46,3910
SABANETA,2019,11,ANTIOQUIA,402,8231,17056,13372,79,6,39146,678,3118,83,46,3925
SABANETA,2019,12,ANTIOQUIA,403,8248,17120,13480,79,6,39336,683,3147,83,46,3959
SABANETA,2019,2,ANTIOQUIA,398,7254,16193,12334,80,7,36266,673,3044,76,48,3841
SABANETA,2019,3,ANTIOQUIA,398,7260,16259,12337,79,6,36339,674,3061,76,48,3859
SABANETA,2019,4,ANTIOQUIA,399,7443,16261,12541,80,6,36730,672,3061,76,48,3857
SABANETA,2019,5,ANTIOQUIA,399,7452,16397,12939,80,6,37273,673,3064,76,48,3861
SABANETA,2019,6,ANTIOQUIA,399,7465,16496,13027,79,6,37472,674,3074,76,48,3872
SABANETA,2019,7,ANTIOQUIA,399,7476,16684,13108,79,6,37752,672,3082,76,47,3877
SABANETA,2019,8,ANTIOQUIA,399,7873,16718,12895,79,6,37970,673,3091,79,46,3889
SABANETA,2019,9,ANTIOQUIA,399,7876,16732,13151,79,6,38243,674,3095,82,45,3896
SABANETA,2020,1,ANTIOQUIA,402,8348,17113,13620,79,6,39568,690,3146,85,46,3967
SABANETA,2020,10,ANTIOQUIA,407,9598,17575,13977,79,6,41642,718,3267,94,432,4511
SABANETA,2020,11,ANTIOQUIA,404,9831,17573,14072,79,6,41965,713,3272,94,432,4511
SABANETA,2020,12,ANTIOQUIA,404,9855,17582,14072,79,6,41998,722,3280,94,432,4528
SABANETA,2020,2,ANTIOQUIA,402,8261,17350,14042,79,6,40140,691,3162,119,432,4404
SABANETA,2020,3,ANTIOQUIA,402,8294,17444,14221,79,6,40446,693,3184,122,432,4431
SABANETA,2020,4,ANTIOQUIA,404,8567,17477,13947,79,6,40480,695,3215,93,432,4435
SABANETA,2020,5,ANTIOQUIA,406,8692,17518,13961,95,6,40678,695,3283,94,431,4503
SABANETA,2020,6,ANTIOQUIA,407,8692,17711,13967,79,6,40862,702,3231,94,432,4459
SABANETA,2020,7,ANTIOQUIA,407,8711,17745,13979,79,6,40927,706,3263,94,432,4495
SABANETA,2020,8,ANTIOQUIA,407,8749,17931,13973,79,6,41145,704,3260,94,432,4490
SABANETA,2020,9,ANTIOQUIA,406,9567,17588,13975,79,6,41621,715,3267,94,432,4508
SABANETA,2021,1,ANTIOQUIA,404,9939,17583,14070,79,6,42081,725,3281,94,432,4532
SABANETA,2021,10,ANTIOQUIA,407,10338,18151,15427,78,7,44408,734,3363,94,432,4623
SABANETA,2021,11,ANTIOQUIA,407,10361,18195,15666,78,7,44714,738,3353,94,432,4617
SABANETA,2021,12,ANTIOQUIA,407,10385,18208,15791,78,7,44876,741,3366,95,432,4634
SABANETA,2021,2,ANTIOQUIA,404,10003,17687,14190,78,6,42368,727,3288,94,432,4541
SABANETA,2021,3,ANTIOQUIA,404,10023,17686,14221,79,6,42419,728,3300,95,432,4555
SABANETA,2021,4,ANTIOQUIA,404,10032,17678,14229,79,7,42429,733,3310,95,432,4570
SABANETA,2021,5,ANTIOQUIA,403,10009,17720,14254,79,7,42472,735,3317,96,432,4580
SABANETA,2021,6,ANTIOQUIA,403,9929,17752,14370,77,7,42538,733,3317,96,432,4578
SABANETA,2021,7,ANTIOQUIA,404,9942,17924,14607,78,7,42962,736,3325,96,432,4589
SABANETA,2021,8,ANTIOQUIA,404,10064,17983,14871,78,7,43407,740,3329,95,431,4595
SABANETA,2021,9,ANTIOQUIA,404,10325,18007,14882,78,7,43703,740,3350,94,432,4616
SABANETA,2022,1,ANTIOQUIA,408,10388,18265,15820,78,7,44966,739,3353,96,432,4620
SABANETA,2022,10,ANTIOQUIA,395,10844,18814,16156,81,7,46297,733,3367,97,430,4627
SABANETA,2022,11,ANTIOQUIA,397,10628,18260,16942,81,7,46315,732,3371,98,430,4631
SABANETA,2022,12,ANTIOQUIA,400,10652,18285,16934,81,7,46359,728,3376,98,430,4632
SABANETA,2022,2,ANTIOQUIA,409,10399,18275,15820,78,7,44988,738,3358,96,433,4625
SABANETA,2022,3,ANTIOQUIA,408,10438,18432,15731,79,7,45095,734,3356,97,431,4618
SABANETA,2022,4,ANTIOQUIA,408,10464,18445,15732,80,7,45136,732,3365,97,431,4625
SABANETA,2022,5,ANTIOQUIA,387,10509,18635,15841,79,7,45458,736,3355,96,431,4618
SABANETA,2022,6,ANTIOQUIA,391,10520,18666,15844,79,7,45507,738,3365,96,431,4630
SABANETA,2022,7,ANTIOQUIA,396,10530,18682,15841,79,7,45535,734,3356,96,431,4617
SABANETA,2022,8,ANTIOQUIA,396,10539,18701,15922,81,7,45646,735,3359,96,431,4621
SABANETA,2022,9,ANTIOQUIA,395,10762,18727,15923,81,7,45895,739,3354,96,431,4620
SABANETA,2023,1,ANTIOQUIA,400,10673,18484,17020,81,7,46665,730,3379,98,430,4637
SABANETA,2023,2,ANTIOQUIA,399,10696,18517,17168,81,7,46868,726,3391,99,430,4646
SABANETA,2023,3,ANTIOQUIA,399,10933,18566,17221,82,7,47208,729,3394,99,430,4652
SABANETA,2023,4,ANTIOQUIA,398,10955,18502,17372,83,7,47317,729,3396,99,430,4654
SABANETA,2023,5,ANTIOQUIA,398,10968,18530,17344,83,7,47330,730,3390,99,430,4649
SABANETA,2023,6,ANTIOQUIA,395,10947,18535,17337,83,7,47304,725,3383,100,430,4638
SABANETA,2023,7,ANTIOQUIA,395,11202,18617,17685,82,7,47988,731,3365,101,431,4628
SABANETA,2023,8,ANTIOQUIA,395,11111,18622,18144,82,7,48361,752,3376,102,431,4661
SABANETA,2023,9,ANTIOQUIA,398,11262,18660,18523,82,7,48932,748,3374,102,431,4655
SALGAR,2018,1,ANTIOQUIA,2829,1982,868,49,7,3,5738,144,370,70,7,591
SALGAR,2018,10,ANTIOQUIA,2903,2028,875,51,8,2,5867,142,373,71,8,594
SALGAR,2018,11,ANTIOQUIA,2910,2031,875,52,8,2,5878,141,373,71,8,593
SALGAR,2018,12,ANTIOQUIA,2918,2034,875,52,8,2,5889,141,372,71,8,592
SALGAR,2018,2,ANTIOQUIA,2829,1989,870,49,7,3,5747,143,370,70,7,590
SALGAR,2018,3,ANTIOQUIA,2831,1995,867,48,8,3,5752,142,371,70,7,590
SALGAR,2018,4,ANTIOQUIA,2833,1996,871,48,8,3,5759,142,372,70,7,591
SALGAR,2018,5,ANTIOQUIA,2815,1996,870,49,8,3,5741,140,372,70,7,589
SALGAR,2018,6,ANTIOQUIA,2823,1996,875,51,8,3,5756,141,375,70,7,593
SALGAR,2018,7,ANTIOQUIA,2832,1999,874,51,8,2,5766,142,373,70,7,592
SALGAR,2018,8,ANTIOQUIA,2852,2012,876,51,8,2,5801,142,373,71,7,593
SALGAR,2018,9,ANTIOQUIA,2872,2019,874,51,8,2,5826,140,374,71,7,592
SALGAR,2019,1,ANTIOQUIA,2924,2038,876,52,8,2,5900,141,373,71,8,593
SALGAR,2019,10,ANTIOQUIA,2946,2045,878,54,8,1,5932,141,385,72,8,606
SALGAR,2019,11,ANTIOQUIA,2952,2047,877,53,8,1,5938,140,385,72,8,605
SALGAR,2019,12,ANTIOQUIA,2961,2054,878,54,8,1,5956,140,386,72,8,606
SALGAR,2019,2,ANTIOQUIA,2923,2037,877,52,8,2,5899,141,376,71,8,596
SALGAR,2019,3,ANTIOQUIA,2924,2034,874,52,8,2,5894,141,382,72,8,603
SALGAR,2019,4,ANTIOQUIA,2928,2035,874,52,8,2,5899,140,382,72,8,602
SALGAR,2019,5,ANTIOQUIA,2935,2037,875,52,8,2,5909,142,382,72,8,604
SALGAR,2019,6,ANTIOQUIA,2933,2034,874,52,8,2,5903,142,383,72,8,605
SALGAR,2019,7,ANTIOQUIA,2944,2039,874,52,8,1,5918,141,383,72,8,604
SALGAR,2019,8,ANTIOQUIA,2945,2042,875,53,8,1,5924,141,383,72,8,604
SALGAR,2019,9,ANTIOQUIA,2945,2042,876,54,8,1,5926,141,384,72,8,605
SALGAR,2020,1,ANTIOQUIA,2962,2054,875,55,8,1,5955,140,386,72,8,606
SALGAR,2020,10,ANTIOQUIA,3013,2074,877,53,8,1,6026,143,396,71,93,703
SALGAR,2020,11,ANTIOQUIA,3019,2075,875,52,8,1,6030,143,396,71,93,703
SALGAR,2020,12,ANTIOQUIA,3027,2083,874,53,8,1,6046,143,399,71,93,706
SALGAR,2020,2,ANTIOQUIA,2963,2053,875,55,8,1,5955,142,386,76,93,697
SALGAR,2020,3,ANTIOQUIA,2971,2054,875,56,8,1,5965,143,386,76,93,698
SALGAR,2020,4,ANTIOQUIA,2975,2053,875,54,8,1,5966,143,393,72,93,701
SALGAR,2020,5,ANTIOQUIA,2980,2057,875,54,8,1,5975,142,394,72,93,701
SALGAR,2020,6,ANTIOQUIA,2983,2058,875,54,8,1,5979,143,394,73,93,703
SALGAR,2020,7,ANTIOQUIA,2997,2066,877,53,8,1,6002,145,395,71,93,704
SALGAR,2020,8,ANTIOQUIA,3008,2068,876,53,8,1,6014,143,395,71,93,702
SALGAR,2020,9,ANTIOQUIA,3008,2071,875,53,8,1,6016,143,396,71,93,703
SALGAR,2021,1,ANTIOQUIA,3030,2076,876,52,8,1,6043,143,398,71,93,705
SALGAR,2021,10,ANTIOQUIA,3043,2112,877,54,8,1,6095,141,405,71,93,710
SALGAR,2021,11,ANTIOQUIA,3044,2114,877,53,8,1,6097,141,405,71,93,710
SALGAR,2021,12,ANTIOQUIA,3048,2119,877,53,8,1,6106,141,405,71,93,710
SALGAR,2021,2,ANTIOQUIA,3033,2078,876,52,8,1,6048,142,399,71,93,705
SALGAR,2021,3,ANTIOQUIA,3033,2082,876,52,8,1,6052,143,402,71,93,709
SALGAR,2021,4,ANTIOQUIA,3034,2085,876,53,8,1,6057,142,402,71,93,708
SALGAR,2021,5,ANTIOQUIA,3035,2090,876,55,8,1,6065,141,401,71,93,706
SALGAR,2021,6,ANTIOQUIA,3041,2095,876,54,8,1,6075,142,401,71,93,707
SALGAR,2021,7,ANTIOQUIA,3040,2095,876,53,8,1,6073,141,402,71,93,707
SALGAR,2021,8,ANTIOQUIA,3041,2096,876,54,8,1,6076,142,404,71,93,710
SALGAR,2021,9,ANTIOQUIA,3042,2099,876,54,8,1,6080,141,404,71,93,709
SALGAR,2022,1,ANTIOQUIA,3052,2125,877,53,8,1,6116,141,405,71,93,710
SALGAR,2022,10,ANTIOQUIA,3082,2187,876,53,8,1,6207,136,405,74,94,709
SALGAR,2022,11,ANTIOQUIA,3084,2187,876,52,8,1,6208,136,405,74,94,709
SALGAR,2022,12,ANTIOQUIA,3085,2197,877,52,8,1,6220,137,405,74,94,710
SALGAR,2022,2,ANTIOQUIA,3054,2131,878,53,8,1,6125,140,405,71,93,709
SALGAR,2022,3,ANTIOQUIA,3060,2171,877,53,8,1,6170,137,407,74,92,710
SALGAR,2022,4,ANTIOQUIA,3063,2175,878,53,8,1,6178,137,406,74,92,709
SALGAR,2022,5,ANTIOQUIA,3065,2176,879,53,8,1,6182,137,407,74,92,710
SALGAR,2022,6,ANTIOQUIA,3067,2178,878,53,8,1,6185,137,407,74,92,710
SALGAR,2022,7,ANTIOQUIA,3078,2182,881,53,8,1,6203,137,406,74,93,710
SALGAR,2022,8,ANTIOQUIA,3076,2179,879,53,8,1,6196,136,407,74,93,710
SALGAR,2022,9,ANTIOQUIA,3079,2182,877,52,8,1,6199,136,405,74,93,708
SALGAR,2023,1,ANTIOQUIA,3088,2199,877,52,8,1,6225,137,405,74,94,710
SALGAR,2023,2,ANTIOQUIA,3094,2207,879,52,8,1,6241,137,405,74,94,710
SALGAR,2023,3,ANTIOQUIA,3097,2213,880,54,8,1,6253,137,407,74,94,712
SALGAR,2023,4,ANTIOQUIA,3113,2220,881,54,8,1,6277,137,408,74,94,713
SALGAR,2023,5,ANTIOQUIA,3123,2222,877,54,8,1,6285,137,407,74,94,712
SALGAR,2023,6,ANTIOQUIA,3135,2229,883,54,8,1,6310,137,407,74,94,712
SALGAR,2023,7,ANTIOQUIA,3141,2226,876,55,8,1,6307,136,405,74,94,709
SALGAR,2023,8,ANTIOQUIA,3147,2232,876,55,8,1,6319,135,405,74,94,708
SALGAR,2023,9,ANTIOQUIA,3156,2234,878,54,8,1,6331,136,405,76,94,711
SAN ANDRES DE CUERQUIA,2018,1,ANTIOQUIA,1430,902,134,4,0,0,2470,26,188,63,2,279
SAN ANDRES DE CUERQUIA,2018,10,ANTIOQUIA,1442,935,127,6,0,0,2510,30,193,63,2,288
SAN ANDRES DE CUERQUIA,2018,11,ANTIOQUIA,1440,934,127,5,0,0,2506,30,194,61,2,287
SAN ANDRES DE CUERQUIA,2018,12,ANTIOQUIA,1444,933,128,5,0,0,2510,30,194,61,2,287
SAN ANDRES DE CUERQUIA,2018,2,ANTIOQUIA,1432,903,134,4,0,0,2473,26,188,63,2,279
SAN ANDRES DE CUERQUIA,2018,3,ANTIOQUIA,1433,915,134,4,0,0,2486,26,192,63,2,283
SAN ANDRES DE CUERQUIA,2018,4,ANTIOQUIA,1438,915,134,4,0,0,2491,26,192,63,2,283
SAN ANDRES DE CUERQUIA,2018,5,ANTIOQUIA,1428,919,129,4,0,0,2480,26,193,62,2,283
SAN ANDRES DE CUERQUIA,2018,6,ANTIOQUIA,1430,921,130,4,0,0,2485,27,193,62,2,284
SAN ANDRES DE CUERQUIA,2018,7,ANTIOQUIA,1433,924,130,5,0,0,2492,27,193,63,2,285
SAN ANDRES DE CUERQUIA,2018,8,ANTIOQUIA,1434,927,128,5,0,0,2494,29,193,63,2,287
SAN ANDRES DE CUERQUIA,2018,9,ANTIOQUIA,1430,930,127,5,0,0,2492,29,193,62,2,286
SAN ANDRES DE CUERQUIA,2019,1,ANTIOQUIA,1446,934,128,5,0,0,2513,30,195,61,2,288
SAN ANDRES DE CUERQUIA,2019,10,ANTIOQUIA,1472,952,128,10,0,0,2562,33,194,61,2,290
SAN ANDRES DE CUERQUIA,2019,11,ANTIOQUIA,1480,956,127,8,0,0,2571,33,194,61,2,290
SAN ANDRES DE CUERQUIA,2019,12,ANTIOQUIA,1494,960,127,10,0,0,2591,33,195,61,2,291
SAN ANDRES DE CUERQUIA,2019,2,ANTIOQUIA,1451,938,128,5,0,0,2522,30,195,61,2,288
SAN ANDRES DE CUERQUIA,2019,3,ANTIOQUIA,1451,939,128,6,0,0,2524,30,195,60,2,287
SAN ANDRES DE CUERQUIA,2019,4,ANTIOQUIA,1457,939,128,6,0,0,2530,31,196,61,2,290
SAN ANDRES DE CUERQUIA,2019,5,ANTIOQUIA,1481,944,128,6,0,0,2559,32,195,60,2,289
SAN ANDRES DE CUERQUIA,2019,6,ANTIOQUIA,1462,941,128,6,0,0,2537,32,195,60,2,289
SAN ANDRES DE CUERQUIA,2019,7,ANTIOQUIA,1463,943,128,6,0,0,2540,33,194,60,2,289
SAN ANDRES DE CUERQUIA,2019,8,ANTIOQUIA,1463,945,128,9,0,0,2545,33,195,60,2,290
SAN ANDRES DE CUERQUIA,2019,9,ANTIOQUIA,1468,948,128,9,0,0,2553,33,194,61,2,290
SAN ANDRES DE CUERQUIA,2020,1,ANTIOQUIA,1483,960,127,10,0,0,2580,33,194,61,2,290
SAN ANDRES DE CUERQUIA,2020,10,ANTIOQUIA,1527,980,128,11,0,0,2646,34,191,61,41,327
SAN ANDRES DE CUERQUIA,2020,11,ANTIOQUIA,1525,981,128,13,0,0,2647,36,191,61,41,329
SAN ANDRES DE CUERQUIA,2020,12,ANTIOQUIA,1532,983,128,13,0,0,2656,36,193,61,41,331
SAN ANDRES DE CUERQUIA,2020,2,ANTIOQUIA,1488,969,127,12,0,0,2596,36,194,61,41,332
SAN ANDRES DE CUERQUIA,2020,3,ANTIOQUIA,1489,968,127,12,0,0,2596,36,194,61,41,332
SAN ANDRES DE CUERQUIA,2020,4,ANTIOQUIA,1489,965,127,8,0,0,2589,34,194,61,41,330
SAN ANDRES DE CUERQUIA,2020,5,ANTIOQUIA,1505,965,128,9,0,0,2607,34,194,61,41,330
SAN ANDRES DE CUERQUIA,2020,6,ANTIOQUIA,1507,965,128,9,0,0,2609,34,194,61,41,330
SAN ANDRES DE CUERQUIA,2020,7,ANTIOQUIA,1511,968,128,10,0,0,2617,34,193,61,41,329
SAN ANDRES DE CUERQUIA,2020,8,ANTIOQUIA,1518,971,128,13,0,0,2630,33,191,61,41,326
SAN ANDRES DE CUERQUIA,2020,9,ANTIOQUIA,1524,978,128,11,0,0,2641,34,191,61,41,327
SAN ANDRES DE CUERQUIA,2021,1,ANTIOQUIA,1534,984,129,13,0,0,2660,36,193,61,41,331
SAN ANDRES DE CUERQUIA,2021,10,ANTIOQUIA,1556,1009,126,12,0,0,2703,37,192,61,41,331
SAN ANDRES DE CUERQUIA,2021,11,ANTIOQUIA,1560,1009,126,14,0,0,2709,37,191,60,41,329
SAN ANDRES DE CUERQUIA,2021,12,ANTIOQUIA,1570,1011,127,14,0,0,2722,37,191,60,41,329
SAN ANDRES DE CUERQUIA,2021,2,ANTIOQUIA,1537,989,128,13,0,0,2667,36,193,61,41,331
SAN ANDRES DE CUERQUIA,2021,3,ANTIOQUIA,1543,997,128,12,0,0,2680,36,193,61,41,331
SAN ANDRES DE CUERQUIA,2021,4,ANTIOQUIA,1545,997,127,12,0,0,2681,36,193,61,41,331
SAN ANDRES DE CUERQUIA,2021,5,ANTIOQUIA,1547,1003,127,12,0,0,2689,35,192,61,41,329
SAN ANDRES DE CUERQUIA,2021,6,ANTIOQUIA,1546,1002,127,12,0,0,2687,36,192,61,41,330
SAN ANDRES DE CUERQUIA,2021,7,ANTIOQUIA,1547,1004,127,12,0,0,2690,38,193,61,41,333
SAN ANDRES DE CUERQUIA,2021,8,ANTIOQUIA,1552,1008,128,13,0,0,2701,38,193,61,41,333
SAN ANDRES DE CUERQUIA,2021,9,ANTIOQUIA,1551,1008,127,14,0,0,2700,37,192,61,41,331
SAN ANDRES DE CUERQUIA,2022,1,ANTIOQUIA,1572,1011,127,14,0,0,2724,38,191,60,41,330
SAN ANDRES DE CUERQUIA,2022,10,ANTIOQUIA,1581,1032,124,12,0,0,2749,41,194,61,42,338
SAN ANDRES DE CUERQUIA,2022,11,ANTIOQUIA,1582,1043,124,12,0,0,2761,41,194,61,42,338
SAN ANDRES DE CUERQUIA,2022,12,ANTIOQUIA,1584,1043,124,11,0,0,2762,41,194,61,42,338
SAN ANDRES DE CUERQUIA,2022,2,ANTIOQUIA,1572,1011,127,14,0,0,2724,40,190,60,41,331
SAN ANDRES DE CUERQUIA,2022,3,ANTIOQUIA,1576,1017,126,13,0,0,2732,39,190,61,41,331
SAN ANDRES DE CUERQUIA,2022,4,ANTIOQUIA,1581,1020,126,12,0,0,2739,39,191,61,41,332
SAN ANDRES DE CUERQUIA,2022,5,ANTIOQUIA,1581,1019,125,12,0,0,2737,39,191,61,42,333
SAN ANDRES DE CUERQUIA,2022,6,ANTIOQUIA,1584,1020,125,12,0,0,2741,39,191,61,42,333
SAN ANDRES DE CUERQUIA,2022,7,ANTIOQUIA,1573,1022,124,12,0,0,2731,39,190,61,42,332
SAN ANDRES DE CUERQUIA,2022,8,ANTIOQUIA,1577,1023,124,12,0,0,2736,40,190,61,42,333
SAN ANDRES DE CUERQUIA,2022,9,ANTIOQUIA,1578,1030,124,12,0,0,2744,41,194,61,42,338
SAN ANDRES DE CUERQUIA,2023,1,ANTIOQUIA,1589,1044,124,11,0,0,2768,41,194,61,42,338
SAN ANDRES DE CUERQUIA,2023,2,ANTIOQUIA,1589,1048,124,11,0,0,2772,41,194,61,42,338
SAN ANDRES DE CUERQUIA,2023,3,ANTIOQUIA,1592,1051,124,12,0,0,2779,41,194,61,42,338
SAN ANDRES DE CUERQUIA,2023,4,ANTIOQUIA,1595,1052,124,12,0,0,2783,41,194,61,42,338
SAN ANDRES DE CUERQUIA,2023,5,ANTIOQUIA,1596,1053,124,12,0,0,2785,41,194,61,42,338
SAN ANDRES DE CUERQUIA,2023,6,ANTIOQUIA,1597,1054,122,12,0,0,2785,42,193,61,42,338
SAN ANDRES DE CUERQUIA,2023,7,ANTIOQUIA,1598,1058,122,12,0,0,2790,43,193,61,42,339
SAN ANDRES DE CUERQUIA,2023,8,ANTIOQUIA,1606,1060,122,12,0,0,2800,43,195,61,42,341
SAN ANDRES DE CUERQUIA,2023,9,ANTIOQUIA,1599,1061,121,14,0,0,2795,43,195,61,42,341
SAN CARLOS,2018,1,ANTIOQUIA,2498,2835,1144,13,3,2,6495,27,420,130,8,585
SAN CARLOS,2018,10,ANTIOQUIA,2633,2931,1152,15,3,2,6736,26,418,134,9,587
SAN CARLOS,2018,11,ANTIOQUIA,2638,2936,1151,13,2,2,6742,26,422,131,8,587
SAN CARLOS,2018,12,ANTIOQUIA,2654,2942,1148,14,2,2,6762,26,423,131,8,588
SAN CARLOS,2018,2,ANTIOQUIA,2535,2840,1145,13,3,2,6538,27,420,130,8,585
SAN CARLOS,2018,3,ANTIOQUIA,2555,2863,1144,13,3,2,6580,27,421,130,8,586
SAN CARLOS,2018,4,ANTIOQUIA,2581,2880,1147,13,3,2,6626,27,420,131,8,586
SAN CARLOS,2018,5,ANTIOQUIA,2580,2889,1149,13,3,2,6636,26,419,131,8,584
SAN CARLOS,2018,6,ANTIOQUIA,2595,2897,1151,15,3,2,6663,26,418,131,8,583
SAN CARLOS,2018,7,ANTIOQUIA,2608,2910,1152,15,3,2,6690,26,418,133,8,585
SAN CARLOS,2018,8,ANTIOQUIA,2627,2927,1152,16,3,2,6727,26,419,133,8,586
SAN CARLOS,2018,9,ANTIOQUIA,2625,2926,1151,15,2,2,6721,26,417,133,8,584
SAN CARLOS,2019,1,ANTIOQUIA,2672,2948,1147,15,3,2,6787,26,424,131,8,589
SAN CARLOS,2019,10,ANTIOQUIA,2709,2994,1137,13,2,2,6857,28,433,132,8,601
SAN CARLOS,2019,11,ANTIOQUIA,2728,2997,1138,13,2,2,6880,28,434,132,8,602
SAN CARLOS,2019,12,ANTIOQUIA,2747,3010,1138,13,2,2,6912,28,435,132,8,603
SAN CARLOS,2019,2,ANTIOQUIA,2676,2953,1148,15,3,2,6797,26,424,132,8,590
SAN CARLOS,2019,3,ANTIOQUIA,2676,2956,1145,14,2,2,6795,26,428,132,8,594
SAN CARLOS,2019,4,ANTIOQUIA,2682,2958,1141,14,2,2,6799,27,429,132,8,596
SAN CARLOS,2019,5,ANTIOQUIA,2700,2967,1140,13,2,2,6824,27,431,132,8,598
SAN CARLOS,2019,6,ANTIOQUIA,2694,2968,1139,12,2,2,6817,27,432,132,8,599
SAN CARLOS,2019,7,ANTIOQUIA,2698,2975,1138,12,2,2,6827,27,432,132,8,599
SAN CARLOS,2019,8,ANTIOQUIA,2702,2982,1138,12,2,2,6838,27,432,132,8,599
SAN CARLOS,2019,9,ANTIOQUIA,2706,2986,1138,12,2,2,6846,28,432,132,8,600
SAN CARLOS,2020,1,ANTIOQUIA,2745,3001,1137,15,2,2,6902,27,435,132,8,602
SAN CARLOS,2020,10,ANTIOQUIA,2850,3050,1144,18,1,2,7065,30,441,132,138,741
SAN CARLOS,2020,11,ANTIOQUIA,2863,3060,1145,19,1,2,7090,30,441,132,138,741
SAN CARLOS,2020,12,ANTIOQUIA,2872,3070,1146,21,1,2,7112,30,441,132,138,741
SAN CARLOS,2020,2,ANTIOQUIA,2749,3003,1137,17,2,2,6910,29,436,136,138,739
SAN CARLOS,2020,3,ANTIOQUIA,2751,3009,1137,19,2,2,6920,29,436,136,138,739
SAN CARLOS,2020,4,ANTIOQUIA,2752,3011,1137,16,2,2,6920,29,440,132,138,739
SAN CARLOS,2020,5,ANTIOQUIA,2770,3023,1138,16,2,2,6951,30,439,132,138,739
SAN CARLOS,2020,6,ANTIOQUIA,2770,3023,1140,16,2,2,6953,31,439,132,138,740
SAN CARLOS,2020,7,ANTIOQUIA,2786,3027,1140,17,2,2,6974,30,440,132,138,740
SAN CARLOS,2020,8,ANTIOQUIA,2814,3033,1142,17,2,2,7010,29,441,132,138,740
SAN CARLOS,2020,9,ANTIOQUIA,2847,3042,1141,17,2,2,7051,29,442,133,138,742
SAN CARLOS,2021,1,ANTIOQUIA,2878,3075,1155,20,1,2,7131,30,442,132,138,742
SAN CARLOS,2021,10,ANTIOQUIA,2956,3139,1180,19,1,2,7297,30,449,132,138,749
SAN CARLOS,2021,11,ANTIOQUIA,2958,3142,1180,19,1,2,7302,30,450,132,138,750
SAN CARLOS,2021,12,ANTIOQUIA,2968,3155,1183,19,1,2,7328,30,451,132,138,751
SAN CARLOS,2021,2,ANTIOQUIA,2884,3083,1158,20,1,2,7148,31,445,132,138,746
SAN CARLOS,2021,3,ANTIOQUIA,2894,3088,1161,21,1,2,7167,31,445,132,138,746
SAN CARLOS,2021,4,ANTIOQUIA,2902,3099,1161,19,1,2,7184,31,445,132,138,746
SAN CARLOS,2021,5,ANTIOQUIA,2913,3107,1162,20,1,2,7205,30,446,132,138,746
SAN CARLOS,2021,6,ANTIOQUIA,2943,3116,1157,19,1,2,7238,30,447,132,138,747
SAN CARLOS,2021,7,ANTIOQUIA,2947,3121,1157,19,1,2,7247,30,447,132,138,747
SAN CARLOS,2021,8,ANTIOQUIA,2949,3123,1157,19,1,2,7251,30,448,132,138,748
SAN CARLOS,2021,9,ANTIOQUIA,2954,3131,1156,19,1,2,7263,30,448,132,138,748
SAN CARLOS,2022,1,ANTIOQUIA,2970,3155,1183,19,1,2,7330,31,451,132,138,752
SAN CARLOS,2022,10,ANTIOQUIA,3270,3181,1197,23,0,2,7673,31,450,135,137,753
SAN CARLOS,2022,11,ANTIOQUIA,3268,3191,1200,25,0,2,7686,31,451,135,137,754
SAN CARLOS,2022,12,ANTIOQUIA,3272,3197,1200,25,0,2,7696,33,454,135,137,759
SAN CARLOS,2022,2,ANTIOQUIA,2972,3158,1185,19,1,2,7337,33,451,132,138,754
SAN CARLOS,2022,3,ANTIOQUIA,2992,3165,1190,19,1,2,7369,31,451,135,137,754
SAN CARLOS,2022,4,ANTIOQUIA,3065,3170,1194,21,1,2,7453,31,451,135,137,754
SAN CARLOS,2022,5,ANTIOQUIA,3162,3173,1192,21,1,2,7551,31,451,135,137,754
SAN CARLOS,2022,6,ANTIOQUIA,3250,3175,1192,23,1,2,7643,31,451,135,137,754
SAN CARLOS,2022,7,ANTIOQUIA,3260,3180,1194,22,0,2,7658,30,449,135,137,751
SAN CARLOS,2022,8,ANTIOQUIA,3265,3175,1194,22,0,2,7658,31,447,135,137,750
SAN CARLOS,2022,9,ANTIOQUIA,3264,3180,1196,23,0,2,7665,31,450,135,137,753
SAN CARLOS,2023,1,ANTIOQUIA,3277,3198,1209,26,0,2,7712,32,455,135,137,759
SAN CARLOS,2023,2,ANTIOQUIA,3284,3207,1216,27,0,2,7736,32,462,135,137,766
SAN CARLOS,2023,3,ANTIOQUIA,3293,3211,1224,29,0,2,7759,32,463,135,137,767
SAN CARLOS,2023,4,ANTIOQUIA,3305,3214,1230,28,0,2,7779,33,465,135,137,770
SAN CARLOS,2023,5,ANTIOQUIA,3324,3221,1228,28,0,2,7803,33,465,135,137,770
SAN CARLOS,2023,6,ANTIOQUIA,3355,3234,1228,29,0,2,7848,33,466,135,137,771
SAN CARLOS,2023,7,ANTIOQUIA,3374,3241,1234,29,0,2,7880,33,469,135,137,774
SAN CARLOS,2023,8,ANTIOQUIA,3393,3247,1235,33,0,2,7910,33,469,135,137,774
SAN CARLOS,2023,9,ANTIOQUIA,3398,3262,1235,36,0,2,7933,39,469,135,137,780
SAN FRANCISCO,2018,1,ANTIOQUIA,751,1043,99,0,0,0,1893,6,103,42,2,153
SAN FRANCISCO,2018,10,ANTIOQUIA,1008,1192,105,0,0,0,2305,7,115,45,2,169
SAN FRANCISCO,2018,11,ANTIOQUIA,1012,1193,105,0,0,0,2310,7,115,45,2,169
SAN FRANCISCO,2018,12,ANTIOQUIA,1016,1193,104,0,0,0,2313,7,120,45,2,174
SAN FRANCISCO,2018,2,ANTIOQUIA,754,1045,99,0,0,0,1898,6,103,41,2,152
SAN FRANCISCO,2018,3,ANTIOQUIA,755,1049,99,0,0,0,1903,6,103,41,2,152
SAN FRANCISCO,2018,4,ANTIOQUIA,757,1051,98,0,0,0,1906,6,104,41,2,153
SAN FRANCISCO,2018,5,ANTIOQUIA,753,1045,98,0,0,0,1896,6,104,41,2,153
SAN FRANCISCO,2018,6,ANTIOQUIA,755,1043,99,0,0,0,1897,6,104,41,2,153
SAN FRANCISCO,2018,7,ANTIOQUIA,759,1043,99,0,0,0,1901,6,104,41,2,153
SAN FRANCISCO,2018,8,ANTIOQUIA,763,1043,99,0,0,0,1905,6,106,41,2,155
SAN FRANCISCO,2018,9,ANTIOQUIA,1000,1187,105,0,0,0,2292,6,114,45,2,167
SAN FRANCISCO,2019,1,ANTIOQUIA,1019,1195,106,0,0,0,2320,7,120,45,2,174
SAN FRANCISCO,2019,10,ANTIOQUIA,1016,1176,109,0,0,0,2301,8,122,43,2,175
SAN FRANCISCO,2019,11,ANTIOQUIA,1055,1204,109,0,0,0,2368,8,123,45,2,178
SAN FRANCISCO,2019,12,ANTIOQUIA,1024,1177,108,0,0,0,2309,8,122,42,2,174
SAN FRANCISCO,2019,2,ANTIOQUIA,1021,1196,106,0,0,0,2323,7,120,45,2,174
SAN FRANCISCO,2019,3,ANTIOQUIA,1020,1203,109,0,0,0,2332,7,120,45,2,174
SAN FRANCISCO,2019,4,ANTIOQUIA,1021,1202,109,0,0,0,2332,7,122,45,2,176
SAN FRANCISCO,2019,5,ANTIOQUIA,1041,1201,109,0,0,0,2351,7,122,45,2,176
SAN FRANCISCO,2019,6,ANTIOQUIA,1046,1205,109,0,0,0,2360,7,122,45,2,176
SAN FRANCISCO,2019,7,ANTIOQUIA,1051,1206,109,0,0,0,2366,8,122,45,2,177
SAN FRANCISCO,2019,8,ANTIOQUIA,1050,1198,109,0,0,0,2357,8,122,44,2,176
SAN FRANCISCO,2019,9,ANTIOQUIA,1014,1177,109,0,0,0,2300,8,122,42,2,174
SAN FRANCISCO,2020,1,ANTIOQUIA,1021,1179,109,3,0,0,2312,8,122,43,2,175
SAN FRANCISCO,2020,10,ANTIOQUIA,1024,1187,111,0,0,0,2322,9,124,45,50,228
SAN FRANCISCO,2020,11,ANTIOQUIA,1023,1188,111,0,0,0,2322,9,124,45,50,228
SAN FRANCISCO,2020,12,ANTIOQUIA,1024,1191,111,0,0,0,2326,8,125,46,50,229
SAN FRANCISCO,2020,2,ANTIOQUIA,1063,1211,109,3,0,0,2386,9,123,45,50,227
SAN FRANCISCO,2020,3,ANTIOQUIA,1066,1216,109,3,0,0,2394,9,123,45,50,227
SAN FRANCISCO,2020,4,ANTIOQUIA,1067,1219,110,0,0,0,2396,9,121,47,50,227
SAN FRANCISCO,2020,5,ANTIOQUIA,1095,1237,111,0,0,0,2443,9,121,47,50,227
SAN FRANCISCO,2020,6,ANTIOQUIA,1072,1225,110,0,0,0,2407,9,121,47,50,227
SAN FRANCISCO,2020,7,ANTIOQUIA,1037,1194,110,0,0,0,2341,9,121,45,50,225
SAN FRANCISCO,2020,8,ANTIOQUIA,1031,1187,112,0,0,0,2330,9,121,44,50,224
SAN FRANCISCO,2020,9,ANTIOQUIA,1022,1185,112,0,0,0,2319,9,122,45,50,226
SAN FRANCISCO,2021,1,ANTIOQUIA,1024,1193,111,0,0,0,2328,8,124,46,50,228
SAN FRANCISCO,2021,10,ANTIOQUIA,1040,1205,115,0,0,0,2360,8,130,46,50,234
SAN FRANCISCO,2021,11,ANTIOQUIA,1038,1205,115,0,0,0,2358,8,131,46,50,235
SAN FRANCISCO,2021,12,ANTIOQUIA,1040,1207,118,0,0,0,2365,8,130,46,50,234
SAN FRANCISCO,2021,2,ANTIOQUIA,1030,1194,111,0,0,0,2335,8,124,46,50,228
SAN FRANCISCO,2021,3,ANTIOQUIA,1035,1200,111,0,0,0,2346,8,124,46,50,228
SAN FRANCISCO,2021,4,ANTIOQUIA,1035,1204,112,0,0,0,2351,8,124,46,49,227
SAN FRANCISCO,2021,5,ANTIOQUIA,1038,1203,112,1,0,0,2354,7,126,46,49,228
SAN FRANCISCO,2021,6,ANTIOQUIA,1038,1203,112,1,0,0,2354,7,126,46,50,229
SAN FRANCISCO,2021,7,ANTIOQUIA,1037,1204,111,0,0,0,2352,7,126,46,50,229
SAN FRANCISCO,2021,8,ANTIOQUIA,1041,1205,113,1,0,0,2360,8,128,46,50,232
SAN FRANCISCO,2021,9,ANTIOQUIA,1041,1206,114,0,0,0,2361,8,129,46,50,233
SAN FRANCISCO,2022,1,ANTIOQUIA,1041,1208,118,0,0,0,2367,8,130,46,50,234
SAN FRANCISCO,2022,10,ANTIOQUIA,1054,1213,120,0,0,0,2387,7,134,51,50,242
SAN FRANCISCO,2022,11,ANTIOQUIA,1057,1210,120,1,0,0,2388,7,136,50,50,243
SAN FRANCISCO,2022,12,ANTIOQUIA,1056,1215,120,1,0,0,2392,7,136,51,50,244
SAN FRANCISCO,2022,2,ANTIOQUIA,1044,1208,118,0,0,0,2370,9,130,46,50,235
SAN FRANCISCO,2022,3,ANTIOQUIA,1044,1209,119,0,0,0,2372,8,130,47,50,235
SAN FRANCISCO,2022,4,ANTIOQUIA,1046,1209,119,0,0,0,2374,8,131,47,50,236
SAN FRANCISCO,2022,5,ANTIOQUIA,1043,1212,118,0,0,0,2373,8,133,47,50,238
SAN FRANCISCO,2022,6,ANTIOQUIA,1047,1209,118,0,0,0,2374,8,133,47,50,238
SAN FRANCISCO,2022,7,ANTIOQUIA,1047,1210,118,0,0,0,2375,8,133,47,50,238
SAN FRANCISCO,2022,8,ANTIOQUIA,1047,1209,118,0,0,0,2374,8,133,47,50,238
SAN FRANCISCO,2022,9,ANTIOQUIA,1051,1212,120,0,0,0,2383,7,134,50,50,241
SAN FRANCISCO,2023,1,ANTIOQUIA,1055,1217,120,1,0,0,2393,7,136,51,50,244
SAN FRANCISCO,2023,2,ANTIOQUIA,1058,1215,120,1,0,0,2394,7,136,51,50,244
SAN FRANCISCO,2023,3,ANTIOQUIA,1058,1218,120,0,0,0,2396,8,137,51,50,246
SAN FRANCISCO,2023,4,ANTIOQUIA,1061,1219,120,0,0,0,2400,7,137,51,50,245
SAN FRANCISCO,2023,5,ANTIOQUIA,1062,1220,120,0,0,0,2402,7,137,51,50,245
SAN FRANCISCO,2023,6,ANTIOQUIA,1066,1221,120,1,0,0,2408,7,137,51,50,245
SAN FRANCISCO,2023,7,ANTIOQUIA,1066,1225,120,0,0,0,2411,7,137,51,50,245
SAN FRANCISCO,2023,8,ANTIOQUIA,1072,1234,120,0,0,0,2426,7,137,51,50,245
SAN FRANCISCO,2023,9,ANTIOQUIA,1068,1238,120,0,0,0,2426,7,137,52,50,246
SAN JERONIMO,2018,1,ANTIOQUIA,1220,3305,763,1216,672,112,7288,75,433,57,10,575
SAN JERONIMO,2018,10,ANTIOQUIA,1285,3390,773,1296,672,111,7527,92,427,58,12,589
SAN JERONIMO,2018,11,ANTIOQUIA,1291,3382,767,1295,671,111,7517,92,428,58,10,588
SAN JERONIMO,2018,12,ANTIOQUIA,1295,3389,770,1296,671,111,7532,92,427,58,10,587
SAN JERONIMO,2018,2,ANTIOQUIA,1222,3312,763,1216,670,112,7295,75,431,57,10,573
SAN JERONIMO,2018,3,ANTIOQUIA,1223,3326,764,1209,671,111,7304,78,430,57,10,575
SAN JERONIMO,2018,4,ANTIOQUIA,1227,3334,766,1210,671,112,7320,80,430,57,10,577
SAN JERONIMO,2018,5,ANTIOQUIA,1225,3328,767,1216,673,113,7322,79,427,57,10,573
SAN JERONIMO,2018,6,ANTIOQUIA,1238,3345,768,1224,672,112,7359,81,426,58,10,575
SAN JERONIMO,2018,7,ANTIOQUIA,1240,3356,767,1218,671,111,7363,84,426,58,10,578
SAN JERONIMO,2018,8,ANTIOQUIA,1264,3374,769,1293,671,111,7482,85,429,58,10,582
SAN JERONIMO,2018,9,ANTIOQUIA,1269,3376,768,1293,671,111,7488,84,428,58,10,580
SAN JERONIMO,2019,1,ANTIOQUIA,1314,3420,772,1295,673,111,7585,92,431,58,10,591
SAN JERONIMO,2019,10,ANTIOQUIA,1368,3490,782,1471,674,111,7896,93,434,58,10,595
SAN JERONIMO,2019,11,ANTIOQUIA,1369,3503,782,1472,674,111,7911,94,437,58,10,599
SAN JERONIMO,2019,12,ANTIOQUIA,1373,3508,786,1476,676,111,7930,96,439,58,10,603
SAN JERONIMO,2019,2,ANTIOQUIA,1298,3416,774,1299,673,111,7571,88,427,58,10,583
SAN JERONIMO,2019,3,ANTIOQUIA,1308,3426,769,1299,672,111,7585,88,430,58,10,586
SAN JERONIMO,2019,4,ANTIOQUIA,1333,3437,776,1312,673,111,7642,89,430,58,10,587
SAN JERONIMO,2019,5,ANTIOQUIA,1336,3458,777,1367,674,111,7723,92,429,58,10,589
SAN JERONIMO,2019,6,ANTIOQUIA,1338,3456,779,1439,673,111,7796,91,431,58,10,590
SAN JERONIMO,2019,7,ANTIOQUIA,1358,3470,780,1456,673,111,7848,90,432,58,10,590
SAN JERONIMO,2019,8,ANTIOQUIA,1360,3483,782,1459,673,111,7868,92,432,58,10,592
SAN JERONIMO,2019,9,ANTIOQUIA,1368,3484,781,1466,674,111,7884,93,435,58,10,596
SAN JERONIMO,2020,1,ANTIOQUIA,1372,3509,785,1485,675,111,7937,102,437,58,10,607
SAN JERONIMO,2020,10,ANTIOQUIA,1406,3603,793,1508,680,116,8106,119,445,58,241,863
SAN JERONIMO,2020,11,ANTIOQUIA,1404,3605,791,1511,679,115,8105,120,449,58,241,868
SAN JERONIMO,2020,12,ANTIOQUIA,1407,3622,792,1511,679,115,8126,119,449,58,241,867
SAN JERONIMO,2020,2,ANTIOQUIA,1375,3518,787,1491,675,111,7957,114,437,65,241,857
SAN JERONIMO,2020,3,ANTIOQUIA,1376,3523,789,1493,672,111,7964,118,437,65,241,861
SAN JERONIMO,2020,4,ANTIOQUIA,1378,3529,790,1485,672,111,7965,117,444,58,241,860
SAN JERONIMO,2020,5,ANTIOQUIA,1393,3544,791,1486,674,111,7999,115,447,58,241,861
SAN JERONIMO,2020,6,ANTIOQUIA,1385,3540,790,1485,674,111,7985,118,445,58,241,862
SAN JERONIMO,2020,7,ANTIOQUIA,1393,3558,793,1484,673,112,8013,119,442,58,241,860
SAN JERONIMO,2020,8,ANTIOQUIA,1404,3588,790,1491,679,119,8071,119,444,59,241,863
SAN JERONIMO,2020,9,ANTIOQUIA,1406,3596,793,1501,680,117,8093,118,445,58,241,862
SAN JERONIMO,2021,1,ANTIOQUIA,1411,3626,791,1517,679,115,8139,119,451,58,241,869
SAN JERONIMO,2021,10,ANTIOQUIA,1446,3692,804,1530,680,114,8266,129,464,57,238,888
SAN JERONIMO,2021,11,ANTIOQUIA,1445,3707,811,1533,679,115,8290,137,466,58,238,899
SAN JERONIMO,2021,12,ANTIOQUIA,1450,3721,816,1535,680,115,8317,138,474,58,238,908
SAN JERONIMO,2021,2,ANTIOQUIA,1410,3635,792,1516,678,114,8145,119,452,57,241,869
SAN JERONIMO,2021,3,ANTIOQUIA,1413,3642,796,1515,681,114,8161,119,452,57,241,869
SAN JERONIMO,2021,4,ANTIOQUIA,1419,3646,801,1515,681,116,8178,122,452,57,241,872
SAN JERONIMO,2021,5,ANTIOQUIA,1421,3663,803,1519,681,115,8202,122,453,57,240,872
SAN JERONIMO,2021,6,ANTIOQUIA,1428,3664,803,1517,680,113,8205,123,453,57,240,873
SAN JERONIMO,2021,7,ANTIOQUIA,1431,3669,804,1524,681,113,8222,122,457,57,240,876
SAN JERONIMO,2021,8,ANTIOQUIA,1434,3679,806,1524,681,114,8238,124,457,57,240,878
SAN JERONIMO,2021,9,ANTIOQUIA,1444,3685,801,1525,681,114,8250,128,459,57,240,884
SAN JERONIMO,2022,1,ANTIOQUIA,1450,3731,818,1535,680,116,8330,138,474,58,238,908
SAN JERONIMO,2022,10,ANTIOQUIA,1434,3324,1295,541,1312,600,8506,153,508,59,241,961
SAN JERONIMO,2022,11,ANTIOQUIA,1440,3336,1292,557,1354,602,8581,154,508,59,241,962
SAN JERONIMO,2022,12,ANTIOQUIA,1447,3348,1291,556,1356,602,8600,150,508,59,241,958
SAN JERONIMO,2022,2,ANTIOQUIA,1450,3751,817,1534,681,116,8349,140,474,58,238,910
SAN JERONIMO,2022,3,ANTIOQUIA,1456,3779,823,1537,681,116,8392,137,476,58,238,909
SAN JERONIMO,2022,4,ANTIOQUIA,1446,3809,838,1537,681,115,8426,141,477,57,238,913
SAN JERONIMO,2022,5,ANTIOQUIA,1447,3813,857,1512,698,129,8456,145,476,58,239,918
SAN JERONIMO,2022,6,ANTIOQUIA,1435,3228,1324,565,1316,604,8472,146,500,58,239,943
SAN JERONIMO,2022,7,ANTIOQUIA,1426,3227,1317,565,1316,603,8454,148,505,59,239,951
SAN JERONIMO,2022,8,ANTIOQUIA,1430,3248,1316,567,1316,603,8480,152,507,59,240,958
SAN JERONIMO,2022,9,ANTIOQUIA,1435,3270,1309,567,1315,602,8498,152,504,60,240,956
SAN JERONIMO,2023,1,ANTIOQUIA,1454,3355,1298,555,1359,607,8628,145,513,59,241,958
SAN JERONIMO,2023,2,ANTIOQUIA,1457,3343,1271,405,1573,607,8656,149,511,60,241,961
SAN JERONIMO,2023,3,ANTIOQUIA,1464,3353,1274,424,1574,607,8696,151,512,60,241,964
SAN JERONIMO,2023,4,ANTIOQUIA,1467,3369,1282,420,1571,607,8716,151,514,60,241,966
SAN JERONIMO,2023,5,ANTIOQUIA,1470,3400,1281,404,1567,607,8729,152,514,61,241,968
SAN JERONIMO,2023,6,ANTIOQUIA,1474,3416,1283,408,1576,607,8764,156,511,61,241,969
SAN JERONIMO,2023,7,ANTIOQUIA,1472,3415,1284,405,1595,607,8778,156,508,61,241,966
SAN JERONIMO,2023,8,ANTIOQUIA,1471,3426,1287,404,1597,605,8790,158,509,62,241,970
SAN JERONIMO,2023,9,ANTIOQUIA,1477,3438,1291,406,1803,400,8815,158,504,62,241,965
SAN JOSE DE LA MONTANA,2018,1,ANTIOQUIA,263,1097,168,24,0,2,1554,237,154,32,4,427
SAN JOSE DE LA MONTANA,2018,10,ANTIOQUIA,259,1109,169,26,0,2,1565,244,152,32,5,433
SAN JOSE DE LA MONTANA,2018,11,ANTIOQUIA,261,1111,169,27,0,2,1570,245,152,32,4,433
SAN JOSE DE LA MONTANA,2018,12,ANTIOQUIA,261,1112,169,27,0,2,1571,244,154,32,4,434
SAN JOSE DE LA MONTANA,2018,2,ANTIOQUIA,259,1096,168,24,0,2,1549,237,155,32,4,428
SAN JOSE DE LA MONTANA,2018,3,ANTIOQUIA,259,1098,168,24,0,2,1551,238,155,32,4,429
SAN JOSE DE LA MONTANA,2018,4,ANTIOQUIA,259,1100,168,24,0,2,1553,238,153,32,4,427
SAN JOSE DE LA MONTANA,2018,5,ANTIOQUIA,259,1098,168,25,0,2,1552,239,153,32,4,428
SAN JOSE DE LA MONTANA,2018,6,ANTIOQUIA,259,1100,168,25,0,2,1554,240,152,32,4,428
SAN JOSE DE LA MONTANA,2018,7,ANTIOQUIA,259,1104,169,25,0,2,1559,244,153,32,4,433
SAN JOSE DE LA MONTANA,2018,8,ANTIOQUIA,259,1107,169,25,0,2,1562,244,153,32,4,433
SAN JOSE DE LA MONTANA,2018,9,ANTIOQUIA,259,1107,169,26,0,2,1563,244,152,32,4,432
SAN JOSE DE LA MONTANA,2019,1,ANTIOQUIA,261,1112,169,27,0,2,1571,243,155,32,4,434
SAN JOSE DE LA MONTANA,2019,10,ANTIOQUIA,267,1122,171,32,0,2,1594,249,155,34,3,441
SAN JOSE DE LA MONTANA,2019,11,ANTIOQUIA,269,1123,171,33,0,2,1598,249,155,34,3,441
SAN JOSE DE LA MONTANA,2019,12,ANTIOQUIA,271,1128,171,34,0,2,1606,252,156,34,3,445
SAN JOSE DE LA MONTANA,2019,2,ANTIOQUIA,261,1115,169,27,0,2,1574,243,155,32,4,434
SAN JOSE DE LA MONTANA,2019,3,ANTIOQUIA,261,1115,169,27,0,2,1574,243,155,32,4,434
SAN JOSE DE LA MONTANA,2019,4,ANTIOQUIA,262,1116,169,27,0,2,1576,244,155,32,4,435
SAN JOSE DE LA MONTANA,2019,5,ANTIOQUIA,262,1122,170,27,0,2,1583,247,155,32,4,438
SAN JOSE DE LA MONTANA,2019,6,ANTIOQUIA,263,1119,170,28,0,2,1582,245,155,32,4,436
SAN JOSE DE LA MONTANA,2019,7,ANTIOQUIA,265,1120,170,28,0,2,1585,245,155,32,4,436
SAN JOSE DE LA MONTANA,2019,8,ANTIOQUIA,266,1119,170,27,0,2,1584,247,154,32,3,436
SAN JOSE DE LA MONTANA,2019,9,ANTIOQUIA,266,1121,171,30,0,2,1590,247,155,34,3,439
SAN JOSE DE LA MONTANA,2020,1,ANTIOQUIA,270,1128,171,35,0,2,1606,250,156,34,3,443
SAN JOSE DE LA MONTANA,2020,10,ANTIOQUIA,281,1134,172,34,0,2,1623,253,160,34,34,481
SAN JOSE DE LA MONTANA,2020,11,ANTIOQUIA,281,1136,172,34,0,2,1625,253,160,34,34,481
SAN JOSE DE LA MONTANA,2020,12,ANTIOQUIA,281,1142,171,33,0,2,1629,253,160,34,34,481
SAN JOSE DE LA MONTANA,2020,2,ANTIOQUIA,271,1127,170,34,0,2,1604,247,156,35,34,472
SAN JOSE DE LA MONTANA,2020,3,ANTIOQUIA,273,1127,170,34,0,2,1606,249,156,35,34,474
SAN JOSE DE LA MONTANA,2020,4,ANTIOQUIA,277,1133,171,33,0,2,1616,251,157,35,34,477
SAN JOSE DE LA MONTANA,2020,5,ANTIOQUIA,278,1133,172,33,0,2,1618,252,157,34,34,477
SAN JOSE DE LA MONTANA,2020,6,ANTIOQUIA,278,1133,172,33,0,2,1618,252,157,34,34,477
SAN JOSE DE LA MONTANA,2020,7,ANTIOQUIA,278,1135,172,34,0,2,1621,252,158,34,34,478
SAN JOSE DE LA MONTANA,2020,8,ANTIOQUIA,279,1136,172,34,0,2,1623,253,158,34,34,479
SAN JOSE DE LA MONTANA,2020,9,ANTIOQUIA,280,1135,172,34,0,2,1623,252,159,34,34,479
SAN JOSE DE LA MONTANA,2021,1,ANTIOQUIA,282,1183,172,33,0,2,1672,254,158,34,34,480
SAN JOSE DE LA MONTANA,2021,10,ANTIOQUIA,289,1210,171,35,0,2,1707,259,162,34,34,489
SAN JOSE DE LA MONTANA,2021,11,ANTIOQUIA,289,1210,171,55,0,2,1727,260,161,34,34,489
SAN JOSE DE LA MONTANA,2021,12,ANTIOQUIA,291,1214,171,56,0,2,1734,260,161,34,34,489
SAN JOSE DE LA MONTANA,2021,2,ANTIOQUIA,284,1183,170,33,0,2,1672,255,159,34,34,482
SAN JOSE DE LA MONTANA,2021,3,ANTIOQUIA,285,1186,170,33,0,2,1676,255,159,34,34,482
SAN JOSE DE LA MONTANA,2021,4,ANTIOQUIA,287,1187,170,33,0,2,1679,256,159,34,34,483
SAN JOSE DE LA MONTANA,2021,5,ANTIOQUIA,287,1190,170,33,0,2,1682,256,161,34,34,485
SAN JOSE DE LA MONTANA,2021,6,ANTIOQUIA,286,1192,169,33,0,2,1682,255,162,34,34,485
SAN JOSE DE LA MONTANA,2021,7,ANTIOQUIA,287,1193,169,33,0,2,1684,257,163,34,34,488
SAN JOSE DE LA MONTANA,2021,8,ANTIOQUIA,288,1194,170,34,0,2,1688,258,163,34,34,489
SAN JOSE DE LA MONTANA,2021,9,ANTIOQUIA,288,1207,171,34,0,2,1702,258,162,34,34,488
SAN JOSE DE LA MONTANA,2022,1,ANTIOQUIA,291,1214,172,57,0,2,1736,260,161,34,34,489
SAN JOSE DE LA MONTANA,2022,10,ANTIOQUIA,310,1231,171,34,0,2,1748,265,161,34,33,493
SAN JOSE DE LA MONTANA,2022,11,ANTIOQUIA,310,1232,171,34,0,2,1749,264,162,34,33,493
SAN JOSE DE LA MONTANA,2022,12,ANTIOQUIA,310,1233,171,35,0,2,1751,265,162,34,33,494
SAN JOSE DE LA MONTANA,2022,2,ANTIOQUIA,291,1216,173,57,0,2,1739,262,161,34,34,491
SAN JOSE DE LA MONTANA,2022,3,ANTIOQUIA,311,1219,174,36,0,2,1742,262,162,34,33,491
SAN JOSE DE LA MONTANA,2022,4,ANTIOQUIA,310,1221,173,36,0,2,1742,264,160,34,33,491
SAN JOSE DE LA MONTANA,2022,5,ANTIOQUIA,309,1223,173,34,0,2,1741,265,161,34,33,493
SAN JOSE DE LA MONTANA,2022,6,ANTIOQUIA,309,1224,173,33,0,2,1741,266,161,34,33,494
SAN JOSE DE LA MONTANA,2022,7,ANTIOQUIA,310,1224,171,33,0,2,1740,266,161,34,33,494
SAN JOSE DE LA MONTANA,2022,8,ANTIOQUIA,310,1224,171,33,0,2,1740,265,161,34,33,493
SAN JOSE DE LA MONTANA,2022,9,ANTIOQUIA,310,1227,170,34,0,2,1743,265,161,34,33,493
SAN JOSE DE LA MONTANA,2023,1,ANTIOQUIA,311,1234,171,35,0,2,1753,264,162,34,33,493
SAN JOSE DE LA MONTANA,2023,2,ANTIOQUIA,311,1233,171,35,0,2,1752,266,161,34,33,494
SAN JOSE DE LA MONTANA,2023,3,ANTIOQUIA,311,1233,171,35,0,2,1752,266,161,34,33,494
SAN JOSE DE LA MONTANA,2023,4,ANTIOQUIA,311,1235,171,35,0,2,1754,266,161,34,33,494
SAN JOSE DE LA MONTANA,2023,5,ANTIOQUIA,311,1235,171,34,0,2,1753,266,160,34,33,493
SAN JOSE DE LA MONTANA,2023,6,ANTIOQUIA,308,1239,171,33,0,2,1753,265,161,34,33,493
SAN JOSE DE LA MONTANA,2023,7,ANTIOQUIA,307,1238,170,33,0,2,1750,265,161,34,33,493
SAN JOSE DE LA MONTANA,2023,8,ANTIOQUIA,307,1240,171,33,0,2,1753,265,161,34,33,493
SAN JOSE DE LA MONTANA,2023,9,ANTIOQUIA,307,1242,169,32,0,2,1752,266,161,34,33,494
SAN JUAN DE URABA,2018,1,ANTIOQUIA,5310,755,14,15,0,0,6094,7,228,55,3,293
SAN JUAN DE URABA,2018,10,ANTIOQUIA,5529,775,15,16,0,0,6335,7,234,55,3,299
SAN JUAN DE URABA,2018,11,ANTIOQUIA,5549,774,15,16,0,0,6354,7,235,55,3,300
SAN JUAN DE URABA,2018,12,ANTIOQUIA,5582,777,15,16,0,0,6390,7,234,55,3,299
SAN JUAN DE URABA,2018,2,ANTIOQUIA,5344,759,14,15,0,0,6132,7,227,55,3,292
SAN JUAN DE URABA,2018,3,ANTIOQUIA,5358,763,14,15,0,0,6150,7,229,55,3,294
SAN JUAN DE URABA,2018,4,ANTIOQUIA,5420,767,14,15,0,0,6216,7,228,55,3,293
SAN JUAN DE URABA,2018,5,ANTIOQUIA,5395,768,14,15,0,0,6192,7,228,55,3,293
SAN JUAN DE URABA,2018,6,ANTIOQUIA,5436,770,14,15,0,0,6235,7,229,55,3,294
SAN JUAN DE URABA,2018,7,ANTIOQUIA,5468,772,15,18,0,0,6273,7,230,55,3,295
SAN JUAN DE URABA,2018,8,ANTIOQUIA,5492,772,15,16,0,0,6295,7,230,55,3,295
SAN JUAN DE URABA,2018,9,ANTIOQUIA,5496,772,15,15,0,0,6298,7,231,55,3,296
SAN JUAN DE URABA,2019,1,ANTIOQUIA,5591,776,16,17,0,0,6400,6,235,56,3,300
SAN JUAN DE URABA,2019,10,ANTIOQUIA,5833,785,16,16,0,0,6650,8,248,57,3,316
SAN JUAN DE URABA,2019,11,ANTIOQUIA,5866,787,16,16,0,0,6685,8,249,57,3,317
SAN JUAN DE URABA,2019,12,ANTIOQUIA,5982,790,17,21,0,0,6810,9,251,57,3,320
SAN JUAN DE URABA,2019,2,ANTIOQUIA,5615,778,16,16,0,0,6425,6,237,57,3,303
SAN JUAN DE URABA,2019,3,ANTIOQUIA,5660,776,16,15,0,0,6467,6,236,56,3,301
SAN JUAN DE URABA,2019,4,ANTIOQUIA,5702,775,16,15,0,0,6508,6,238,57,3,304
SAN JUAN DE URABA,2019,5,ANTIOQUIA,5752,779,16,16,0,0,6563,6,242,57,4,309
SAN JUAN DE URABA,2019,6,ANTIOQUIA,5738,780,16,16,0,0,6550,7,244,55,3,309
SAN JUAN DE URABA,2019,7,ANTIOQUIA,5759,780,16,16,0,0,6571,7,243,57,3,310
SAN JUAN DE URABA,2019,8,ANTIOQUIA,5797,783,16,15,0,0,6611,7,245,56,3,311
SAN JUAN DE URABA,2019,9,ANTIOQUIA,5831,785,16,15,0,0,6647,7,247,57,3,314
SAN JUAN DE URABA,2020,1,ANTIOQUIA,5938,787,15,26,0,0,6766,9,249,57,4,319
SAN JUAN DE URABA,2020,10,ANTIOQUIA,6169,812,15,23,0,0,7019,11,254,55,194,514
SAN JUAN DE URABA,2020,11,ANTIOQUIA,6201,813,15,23,0,0,7052,12,254,54,195,515
SAN JUAN DE URABA,2020,12,ANTIOQUIA,6231,817,15,25,0,0,7088,12,253,56,195,516
SAN JUAN DE URABA,2020,2,ANTIOQUIA,5963,787,15,30,0,0,6795,11,251,59,195,516
SAN JUAN DE URABA,2020,3,ANTIOQUIA,5979,786,15,31,0,0,6811,10,251,56,195,512
SAN JUAN DE URABA,2020,4,ANTIOQUIA,6009,785,15,21,0,0,6830,10,252,58,195,515
SAN JUAN DE URABA,2020,5,ANTIOQUIA,6036,791,15,22,0,0,6864,9,252,55,195,511
SAN JUAN DE URABA,2020,6,ANTIOQUIA,6050,799,15,22,0,0,6886,10,251,55,195,511
SAN JUAN DE URABA,2020,7,ANTIOQUIA,6100,803,15,22,0,0,6940,10,252,55,195,512
SAN JUAN DE URABA,2020,8,ANTIOQUIA,6133,809,15,22,0,0,6979,10,251,55,195,511
SAN JUAN DE URABA,2020,9,ANTIOQUIA,6145,811,15,22,0,0,6993,10,254,55,195,514
SAN JUAN DE URABA,2021,1,ANTIOQUIA,6265,820,15,25,0,0,7125,12,256,51,195,514
SAN JUAN DE URABA,2021,10,ANTIOQUIA,6443,866,15,28,0,0,7352,13,264,41,195,513
SAN JUAN DE URABA,2021,11,ANTIOQUIA,6481,864,15,29,0,0,7389,13,266,41,195,515
SAN JUAN DE URABA,2021,12,ANTIOQUIA,6551,868,15,31,0,0,7465,14,272,40,195,521
SAN JUAN DE URABA,2021,2,ANTIOQUIA,6290,821,15,28,0,0,7154,12,258,51,195,516
SAN JUAN DE URABA,2021,3,ANTIOQUIA,6319,826,15,27,0,0,7187,12,258,52,195,517
SAN JUAN DE URABA,2021,4,ANTIOQUIA,6334,830,15,26,0,0,7205,12,263,50,195,520
SAN JUAN DE URABA,2021,5,ANTIOQUIA,6339,829,15,29,0,0,7212,12,261,49,195,517
SAN JUAN DE URABA,2021,6,ANTIOQUIA,6348,835,15,28,0,0,7226,12,261,48,195,516
SAN JUAN DE URABA,2021,7,ANTIOQUIA,6367,847,15,28,0,0,7257,12,264,47,195,518
SAN JUAN DE URABA,2021,8,ANTIOQUIA,6398,855,15,28,0,0,7296,13,263,43,195,514
SAN JUAN DE URABA,2021,9,ANTIOQUIA,6416,857,15,29,0,0,7317,13,263,42,195,513
SAN JUAN DE URABA,2022,1,ANTIOQUIA,6542,870,15,31,0,0,7458,14,273,40,195,522
SAN JUAN DE URABA,2022,10,ANTIOQUIA,6970,886,15,29,0,0,7900,13,300,43,195,551
SAN JUAN DE URABA,2022,11,ANTIOQUIA,6991,890,15,30,0,0,7926,13,300,44,195,552
SAN JUAN DE URABA,2022,12,ANTIOQUIA,7027,896,15,29,0,0,7967,13,300,44,196,553
SAN JUAN DE URABA,2022,2,ANTIOQUIA,6587,871,15,30,0,0,7503,14,274,40,195,523
SAN JUAN DE URABA,2022,3,ANTIOQUIA,6619,873,15,29,0,0,7536,13,276,41,195,525
SAN JUAN DE URABA,2022,4,ANTIOQUIA,6651,880,15,28,0,0,7574,13,282,42,195,532
SAN JUAN DE URABA,2022,5,ANTIOQUIA,6716,879,15,29,0,0,7639,13,282,42,195,532
SAN JUAN DE URABA,2022,6,ANTIOQUIA,6821,876,15,30,0,0,7742,13,284,42,195,534
SAN JUAN DE URABA,2022,7,ANTIOQUIA,6875,876,15,30,0,0,7796,13,290,42,195,540
SAN JUAN DE URABA,2022,8,ANTIOQUIA,6910,876,15,30,0,0,7831,13,292,43,195,543
SAN JUAN DE URABA,2022,9,ANTIOQUIA,6935,881,15,31,0,0,7862,13,297,43,195,548
SAN JUAN DE URABA,2023,1,ANTIOQUIA,7068,901,15,28,0,0,8012,13,302,44,196,555
SAN JUAN DE URABA,2023,2,ANTIOQUIA,7107,904,15,28,0,0,8054,13,307,44,196,560
SAN JUAN DE URABA,2023,3,ANTIOQUIA,7157,910,15,28,0,0,8110,14,307,44,195,560
SAN JUAN DE URABA,2023,4,ANTIOQUIA,7204,914,15,28,0,0,8161,14,308,44,195,561
SAN JUAN DE URABA,2023,5,ANTIOQUIA,7240,915,15,25,0,0,8195,14,309,44,195,562
SAN JUAN DE URABA,2023,6,ANTIOQUIA,7227,915,15,24,0,0,8181,14,314,44,195,567
SAN JUAN DE URABA,2023,7,ANTIOQUIA,7268,916,15,27,0,0,8226,14,313,44,195,566
SAN JUAN DE URABA,2023,8,ANTIOQUIA,7281,920,15,30,0,0,8246,14,321,44,195,574
SAN JUAN DE URABA,2023,9,ANTIOQUIA,7289,920,15,29,0,0,8253,14,322,45,195,576
SAN LUIS,2018,1,ANTIOQUIA,2143,3224,82,4,0,0,5453,28,283,99,8,418
SAN LUIS,2018,10,ANTIOQUIA,1942,3145,79,7,0,0,5173,29,285,95,10,419
SAN LUIS,2018,11,ANTIOQUIA,1945,3139,78,10,0,0,5172,29,285,95,9,418
SAN LUIS,2018,12,ANTIOQUIA,1955,3143,79,21,0,0,5198,29,286,95,9,419
SAN LUIS,2018,2,ANTIOQUIA,2157,3229,82,5,0,0,5473,28,283,99,8,418
SAN LUIS,2018,3,ANTIOQUIA,2161,3240,82,6,0,0,5489,28,283,99,9,419
SAN LUIS,2018,4,ANTIOQUIA,2169,3253,82,6,0,0,5510,29,284,99,9,421
SAN LUIS,2018,5,ANTIOQUIA,2159,3253,83,6,0,0,5501,28,285,99,9,421
SAN LUIS,2018,6,ANTIOQUIA,2162,3262,83,6,0,0,5513,28,287,99,9,423
SAN LUIS,2018,7,ANTIOQUIA,2165,3269,83,7,0,0,5524,28,287,99,9,423
SAN LUIS,2018,8,ANTIOQUIA,2176,3275,83,6,0,0,5540,28,287,98,9,422
SAN LUIS,2018,9,ANTIOQUIA,1932,3133,78,6,0,0,5149,30,285,95,9,419
SAN LUIS,2019,1,ANTIOQUIA,1993,3158,79,23,0,0,5253,29,290,95,9,423
SAN LUIS,2019,10,ANTIOQUIA,2233,3215,78,11,0,0,5537,29,297,97,10,433
SAN LUIS,2019,11,ANTIOQUIA,2236,3221,78,11,0,0,5546,28,296,97,10,431
SAN LUIS,2019,12,ANTIOQUIA,2250,3236,78,10,0,0,5574,28,296,99,10,433
SAN LUIS,2019,2,ANTIOQUIA,2008,3168,79,22,0,0,5277,30,291,95,9,425
SAN LUIS,2019,3,ANTIOQUIA,2017,3188,79,20,0,0,5304,29,292,95,9,425
SAN LUIS,2019,4,ANTIOQUIA,2019,3275,79,52,0,0,5425,29,295,96,10,430
SAN LUIS,2019,5,ANTIOQUIA,2158,3204,78,11,0,0,5451,29,294,96,9,428
SAN LUIS,2019,6,ANTIOQUIA,2174,3207,78,11,0,0,5470,29,295,96,10,430
SAN LUIS,2019,7,ANTIOQUIA,2209,3212,78,11,0,0,5510,29,294,97,10,430
SAN LUIS,2019,8,ANTIOQUIA,2214,3218,78,12,0,0,5522,29,295,98,10,432
SAN LUIS,2019,9,ANTIOQUIA,2218,3221,78,12,0,0,5529,28,296,98,10,432
SAN LUIS,2020,1,ANTIOQUIA,2254,3234,78,17,0,0,5583,28,297,98,10,433
SAN LUIS,2020,10,ANTIOQUIA,2322,3280,79,10,0,0,5691,33,305,100,67,505
SAN LUIS,2020,11,ANTIOQUIA,2337,3288,80,10,0,0,5715,34,305,100,67,506
SAN LUIS,2020,12,ANTIOQUIA,2348,3299,80,11,0,0,5738,34,306,100,67,507
SAN LUIS,2020,2,ANTIOQUIA,2266,3238,78,18,0,0,5600,34,297,99,67,497
SAN LUIS,2020,3,ANTIOQUIA,2277,3241,78,18,0,0,5614,33,301,99,67,500
SAN LUIS,2020,4,ANTIOQUIA,2281,3244,78,9,0,0,5612,35,301,99,67,502
SAN LUIS,2020,5,ANTIOQUIA,2289,3246,78,9,0,0,5622,34,303,99,67,503
SAN LUIS,2020,6,ANTIOQUIA,2284,3246,78,9,0,0,5617,35,303,99,67,504
SAN LUIS,2020,7,ANTIOQUIA,2297,3253,79,9,0,0,5638,34,303,100,67,504
SAN LUIS,2020,8,ANTIOQUIA,2303,3261,79,9,0,0,5652,34,304,100,67,505
SAN LUIS,2020,9,ANTIOQUIA,2312,3274,79,10,0,0,5675,34,305,100,67,506
SAN LUIS,2021,1,ANTIOQUIA,2355,3306,80,11,0,0,5752,34,307,100,67,508
SAN LUIS,2021,10,ANTIOQUIA,2440,3379,78,13,0,0,5910,35,310,100,67,512
SAN LUIS,2021,11,ANTIOQUIA,2457,3385,78,14,0,0,5934,34,312,100,67,513
SAN LUIS,2021,12,ANTIOQUIA,2460,3386,78,14,0,0,5938,34,311,100,67,512
SAN LUIS,2021,2,ANTIOQUIA,2373,3320,80,11,0,0,5784,34,307,100,67,508
SAN LUIS,2021,3,ANTIOQUIA,2396,3324,79,13,0,0,5812,34,307,100,67,508
SAN LUIS,2021,4,ANTIOQUIA,2399,3335,79,13,0,0,5826,34,308,100,67,509
SAN LUIS,2021,5,ANTIOQUIA,2412,3350,79,12,0,0,5853,34,307,100,67,508
SAN LUIS,2021,6,ANTIOQUIA,2423,3350,79,12,0,0,5864,35,307,100,67,509
SAN LUIS,2021,7,ANTIOQUIA,2427,3357,79,13,0,0,5876,35,309,100,67,511
SAN LUIS,2021,8,ANTIOQUIA,2437,3364,79,13,0,0,5893,34,312,100,67,513
SAN LUIS,2021,9,ANTIOQUIA,2437,3365,79,13,0,0,5894,34,312,100,67,513
SAN LUIS,2022,1,ANTIOQUIA,2466,3385,78,14,0,0,5943,34,313,99,67,513
SAN LUIS,2022,10,ANTIOQUIA,2492,3422,81,15,0,0,6010,31,310,106,66,513
SAN LUIS,2022,11,ANTIOQUIA,2503,3428,81,16,0,0,6028,31,311,106,66,514
SAN LUIS,2022,12,ANTIOQUIA,2508,3437,81,16,0,0,6042,30,311,106,66,513
SAN LUIS,2022,2,ANTIOQUIA,2470,3386,78,15,0,0,5949,34,313,100,67,514
SAN LUIS,2022,3,ANTIOQUIA,2478,3393,78,15,0,0,5964,29,312,105,66,512
SAN LUIS,2022,4,ANTIOQUIA,2475,3396,80,14,0,0,5965,29,313,105,66,513
SAN LUIS,2022,5,ANTIOQUIA,2476,3400,80,14,0,0,5970,29,313,105,66,513
SAN LUIS,2022,6,ANTIOQUIA,2491,3390,80,12,0,0,5973,29,316,105,66,516
SAN LUIS,2022,7,ANTIOQUIA,2483,3397,79,12,0,0,5971,29,315,105,66,515
SAN LUIS,2022,8,ANTIOQUIA,2483,3400,79,12,0,0,5974,30,309,105,66,510
SAN LUIS,2022,9,ANTIOQUIA,2492,3414,81,14,0,0,6001,30,310,106,66,512
SAN LUIS,2023,1,ANTIOQUIA,2511,3447,81,16,0,0,6055,30,309,106,66,511
SAN LUIS,2023,2,ANTIOQUIA,2515,3455,81,18,0,0,6069,32,309,106,66,513
SAN LUIS,2023,3,ANTIOQUIA,2523,3469,81,17,0,0,6090,31,309,106,66,512
SAN LUIS,2023,4,ANTIOQUIA,2529,3479,81,17,0,0,6106,30,309,107,66,512
SAN LUIS,2023,5,ANTIOQUIA,2544,3501,81,20,0,0,6146,30,309,108,66,513
SAN LUIS,2023,6,ANTIOQUIA,2559,3513,81,21,0,0,6174,30,309,108,66,513
SAN LUIS,2023,7,ANTIOQUIA,2579,3520,82,22,0,0,6203,30,309,108,66,513
SAN LUIS,2023,8,ANTIOQUIA,2623,3537,83,23,0,0,6266,30,311,108,66,515
SAN LUIS,2023,9,ANTIOQUIA,2635,3553,83,23,0,0,6294,30,312,108,66,516
SAN PEDRO DE LOS MILAGROS,2018,1,ANTIOQUIA,741,4242,2994,390,114,77,8558,220,982,68,5,1275
SAN PEDRO DE LOS MILAGROS,2018,10,ANTIOQUIA,771,4328,3065,380,109,74,8727,236,996,69,5,1306
SAN PEDRO DE LOS MILAGROS,2018,11,ANTIOQUIA,771,4337,3063,382,107,74,8734,239,996,69,5,1309
SAN PEDRO DE LOS MILAGROS,2018,12,ANTIOQUIA,788,4404,3055,381,107,73,8808,240,995,69,7,1311
SAN PEDRO DE LOS MILAGROS,2018,2,ANTIOQUIA,743,4260,3020,388,113,77,8601,220,984,69,5,1278
SAN PEDRO DE LOS MILAGROS,2018,3,ANTIOQUIA,739,4268,3029,387,112,77,8612,222,992,69,5,1288
SAN PEDRO DE LOS MILAGROS,2018,4,ANTIOQUIA,748,4285,3037,387,109,77,8643,226,990,69,5,1290
SAN PEDRO DE LOS MILAGROS,2018,5,ANTIOQUIA,745,4291,3041,384,108,77,8646,229,987,69,5,1290
SAN PEDRO DE LOS MILAGROS,2018,6,ANTIOQUIA,757,4295,3046,383,110,77,8668,232,993,69,5,1299
SAN PEDRO DE LOS MILAGROS,2018,7,ANTIOQUIA,761,4301,3054,381,108,77,8682,235,997,69,5,1306
SAN PEDRO DE LOS MILAGROS,2018,8,ANTIOQUIA,766,4311,3058,381,108,77,8701,237,995,69,5,1306
SAN PEDRO DE LOS MILAGROS,2018,9,ANTIOQUIA,768,4319,3064,380,109,75,8715,236,995,69,5,1305
SAN PEDRO DE LOS MILAGROS,2019,1,ANTIOQUIA,865,4568,2844,349,107,73,8806,240,994,69,7,1310
SAN PEDRO DE LOS MILAGROS,2019,10,ANTIOQUIA,1163,3917,3370,370,118,122,9060,275,1010,69,7,1361
SAN PEDRO DE LOS MILAGROS,2019,11,ANTIOQUIA,1176,3970,3384,369,117,122,9138,276,1013,69,7,1365
SAN PEDRO DE LOS MILAGROS,2019,12,ANTIOQUIA,1181,3933,3440,376,118,121,9169,279,1014,69,7,1369
SAN PEDRO DE LOS MILAGROS,2019,2,ANTIOQUIA,874,4582,2849,360,107,72,8844,245,999,69,7,1320
SAN PEDRO DE LOS MILAGROS,2019,3,ANTIOQUIA,889,4607,2848,354,107,73,8878,244,1002,69,7,1322
SAN PEDRO DE LOS MILAGROS,2019,4,ANTIOQUIA,897,4627,2839,353,106,73,8895,249,1001,69,7,1326
SAN PEDRO DE LOS MILAGROS,2019,5,ANTIOQUIA,904,4649,2846,354,106,73,8932,251,1005,69,7,1332
SAN PEDRO DE LOS MILAGROS,2019,6,ANTIOQUIA,902,4650,2851,354,104,73,8934,251,1007,69,7,1334
SAN PEDRO DE LOS MILAGROS,2019,7,ANTIOQUIA,900,4662,2881,350,102,73,8968,252,1007,69,7,1335
SAN PEDRO DE LOS MILAGROS,2019,8,ANTIOQUIA,1034,4195,3144,376,123,113,8985,258,1004,68,7,1337
SAN PEDRO DE LOS MILAGROS,2019,9,ANTIOQUIA,1158,3958,3300,372,123,122,9033,269,1008,70,6,1353
SAN PEDRO DE LOS MILAGROS,2020,1,ANTIOQUIA,1188,3939,3439,375,115,117,9173,285,1012,69,7,1373
SAN PEDRO DE LOS MILAGROS,2020,10,ANTIOQUIA,1207,3934,3580,442,115,119,9397,305,1019,70,133,1527
SAN PEDRO DE LOS MILAGROS,2020,11,ANTIOQUIA,1214,3947,3583,450,114,118,9426,307,1019,70,133,1529
SAN PEDRO DE LOS MILAGROS,2020,12,ANTIOQUIA,1217,3974,3580,466,114,118,9469,311,1025,70,133,1539
SAN PEDRO DE LOS MILAGROS,2020,2,ANTIOQUIA,1188,3887,3462,444,116,118,9215,290,1011,74,133,1508
SAN PEDRO DE LOS MILAGROS,2020,3,ANTIOQUIA,1190,3891,3468,444,116,118,9227,291,1015,74,133,1513
SAN PEDRO DE LOS MILAGROS,2020,4,ANTIOQUIA,1196,3911,3564,375,115,118,9279,294,1022,69,133,1518
SAN PEDRO DE LOS MILAGROS,2020,5,ANTIOQUIA,1197,3921,3568,385,115,118,9304,296,1026,69,133,1524
SAN PEDRO DE LOS MILAGROS,2020,6,ANTIOQUIA,1197,3920,3566,390,115,118,9306,300,1020,70,133,1523
SAN PEDRO DE LOS MILAGROS,2020,7,ANTIOQUIA,1199,3929,3568,394,116,119,9325,301,1023,70,132,1526
SAN PEDRO DE LOS MILAGROS,2020,8,ANTIOQUIA,1203,3939,3581,401,115,119,9358,302,1021,70,133,1526
SAN PEDRO DE LOS MILAGROS,2020,9,ANTIOQUIA,1206,3925,3573,435,114,119,9372,303,1022,70,133,1528
SAN PEDRO DE LOS MILAGROS,2021,1,ANTIOQUIA,1216,3979,3577,471,116,118,9477,316,1021,70,133,1540
SAN PEDRO DE LOS MILAGROS,2021,10,ANTIOQUIA,1245,4155,3682,579,125,117,9903,345,1018,71,132,1566
SAN PEDRO DE LOS MILAGROS,2021,11,ANTIOQUIA,1245,4170,3687,571,124,117,9914,349,1018,71,132,1570
SAN PEDRO DE LOS MILAGROS,2021,12,ANTIOQUIA,1250,4188,3688,576,124,117,9943,354,1027,71,132,1584
SAN PEDRO DE LOS MILAGROS,2021,2,ANTIOQUIA,1217,3999,3586,480,117,118,9517,317,1024,70,133,1544
SAN PEDRO DE LOS MILAGROS,2021,3,ANTIOQUIA,1221,4015,3602,485,118,118,9559,316,1016,70,133,1535
SAN PEDRO DE LOS MILAGROS,2021,4,ANTIOQUIA,1223,4037,3619,486,118,118,9601,320,1016,70,133,1539
SAN PEDRO DE LOS MILAGROS,2021,5,ANTIOQUIA,1228,4058,3634,511,118,119,9668,320,1013,70,133,1536
SAN PEDRO DE LOS MILAGROS,2021,6,ANTIOQUIA,1233,4061,3641,511,118,121,9685,322,1015,70,132,1539
SAN PEDRO DE LOS MILAGROS,2021,7,ANTIOQUIA,1229,4101,3665,567,127,120,9809,322,1015,70,132,1539
SAN PEDRO DE LOS MILAGROS,2021,8,ANTIOQUIA,1233,4124,3671,580,126,119,9853,327,1017,71,132,1547
SAN PEDRO DE LOS MILAGROS,2021,9,ANTIOQUIA,1239,4129,3680,580,125,118,9871,336,1020,71,132,1559
SAN PEDRO DE LOS MILAGROS,2022,1,ANTIOQUIA,1256,4196,3692,575,124,116,9959,357,1026,71,132,1586
SAN PEDRO DE LOS MILAGROS,2022,10,ANTIOQUIA,1286,4327,3906,639,155,115,10428,376,1048,71,134,1629
SAN PEDRO DE LOS MILAGROS,2022,11,ANTIOQUIA,1289,4310,3961,642,156,115,10473,378,1053,71,134,1636
SAN PEDRO DE LOS MILAGROS,2022,12,ANTIOQUIA,1290,4318,3967,645,155,115,10490,380,1051,71,134,1636
SAN PEDRO DE LOS MILAGROS,2022,2,ANTIOQUIA,1253,4226,3691,580,137,117,10004,360,1028,71,132,1591
SAN PEDRO DE LOS MILAGROS,2022,3,ANTIOQUIA,1255,4290,3737,572,152,116,10122,362,1032,71,132,1597
SAN PEDRO DE LOS MILAGROS,2022,4,ANTIOQUIA,1254,4287,3764,582,153,116,10156,366,1044,71,132,1613
SAN PEDRO DE LOS MILAGROS,2022,5,ANTIOQUIA,1253,4289,3797,618,154,116,10227,363,1042,71,132,1608
SAN PEDRO DE LOS MILAGROS,2022,6,ANTIOQUIA,1263,4317,3806,620,154,116,10276,366,1043,71,132,1612
SAN PEDRO DE LOS MILAGROS,2022,7,ANTIOQUIA,1263,4328,3835,627,154,116,10323,372,1045,71,132,1620
SAN PEDRO DE LOS MILAGROS,2022,8,ANTIOQUIA,1273,4341,3859,631,154,116,10374,372,1049,71,134,1626
SAN PEDRO DE LOS MILAGROS,2022,9,ANTIOQUIA,1285,4318,3900,630,155,116,10404,373,1047,71,134,1625
SAN PEDRO DE LOS MILAGROS,2023,1,ANTIOQUIA,1291,4323,3980,651,154,115,10514,377,1051,71,134,1633
SAN PEDRO DE LOS MILAGROS,2023,2,ANTIOQUIA,1292,4357,4004,652,153,115,10573,378,1054,71,134,1637
SAN PEDRO DE LOS MILAGROS,2023,3,ANTIOQUIA,1293,4374,4007,661,152,115,10602,383,1054,71,134,1642
SAN PEDRO DE LOS MILAGROS,2023,4,ANTIOQUIA,1298,4378,4005,689,151,115,10636,385,1054,71,134,1644
SAN PEDRO DE LOS MILAGROS,2023,5,ANTIOQUIA,1296,4373,4053,692,151,115,10680,390,1055,71,134,1650
SAN PEDRO DE LOS MILAGROS,2023,6,ANTIOQUIA,1297,4378,4065,697,151,115,10703,392,1052,71,134,1649
SAN PEDRO DE LOS MILAGROS,2023,7,ANTIOQUIA,1294,4412,4061,707,151,115,10740,396,1053,71,135,1655
SAN PEDRO DE LOS MILAGROS,2023,8,ANTIOQUIA,1296,4400,4113,701,151,115,10776,398,1060,71,135,1664
SAN PEDRO DE LOS MILAGROS,2023,9,ANTIOQUIA,1295,4404,4113,707,151,115,10785,402,1061,71,136,1670
SAN PEDRO DE URABA,2018,1,ANTIOQUIA,8034,902,19,11,1,0,8967,8,460,109,24,601
SAN PEDRO DE URABA,2018,10,ANTIOQUIA,8209,912,21,15,1,0,9158,8,449,109,24,590
SAN PEDRO DE URABA,2018,11,ANTIOQUIA,8176,905,22,16,1,0,9120,8,448,109,24,589
SAN PEDRO DE URABA,2018,12,ANTIOQUIA,8238,908,22,16,1,0,9185,8,447,109,24,588
SAN PEDRO DE URABA,2018,2,ANTIOQUIA,8034,901,19,11,1,0,8966,8,454,109,24,595
SAN PEDRO DE URABA,2018,3,ANTIOQUIA,8066,900,19,11,1,0,8997,8,456,108,24,596
SAN PEDRO DE URABA,2018,4,ANTIOQUIA,8120,905,19,12,1,0,9057,8,454,109,24,595
SAN PEDRO DE URABA,2018,5,ANTIOQUIA,8060,901,19,13,1,0,8994,8,452,108,24,592
SAN PEDRO DE URABA,2018,6,ANTIOQUIA,8109,905,19,14,1,0,9048,8,456,109,24,597
SAN PEDRO DE URABA,2018,7,ANTIOQUIA,8137,910,19,14,1,0,9081,8,458,109,24,599
SAN PEDRO DE URABA,2018,8,ANTIOQUIA,8189,911,19,15,1,0,9135,8,459,109,24,600
SAN PEDRO DE URABA,2018,9,ANTIOQUIA,8139,908,21,15,1,0,9084,8,448,109,24,589
SAN PEDRO DE URABA,2019,1,ANTIOQUIA,8207,911,22,16,1,0,9157,8,446,110,24,588
SAN PEDRO DE URABA,2019,10,ANTIOQUIA,8541,915,24,18,0,0,9498,8,446,112,24,590
SAN PEDRO DE URABA,2019,11,ANTIOQUIA,8543,918,23,18,0,0,9502,8,445,113,24,590
SAN PEDRO DE URABA,2019,12,ANTIOQUIA,8623,926,25,18,0,0,9592,8,453,114,24,599
SAN PEDRO DE URABA,2019,2,ANTIOQUIA,8268,912,22,15,1,0,9218,9,444,110,24,587
SAN PEDRO DE URABA,2019,3,ANTIOQUIA,8293,914,22,16,1,0,9246,9,448,111,25,593
SAN PEDRO DE URABA,2019,4,ANTIOQUIA,8382,917,22,17,1,0,9339,9,445,112,24,590
SAN PEDRO DE URABA,2019,5,ANTIOQUIA,8486,924,22,17,1,0,9450,8,446,112,24,590
SAN PEDRO DE URABA,2019,6,ANTIOQUIA,8446,915,22,17,1,0,9401,8,446,112,24,590
SAN PEDRO DE URABA,2019,7,ANTIOQUIA,8468,915,23,19,0,0,9425,8,443,113,24,588
SAN PEDRO DE URABA,2019,8,ANTIOQUIA,8487,916,23,19,0,0,9445,8,443,111,24,586
SAN PEDRO DE URABA,2019,9,ANTIOQUIA,8530,917,23,20,0,0,9490,8,442,112,24,586
SAN PEDRO DE URABA,2020,1,ANTIOQUIA,8591,917,24,27,0,0,9559,8,449,113,25,595
SAN PEDRO DE URABA,2020,10,ANTIOQUIA,9158,928,24,30,0,0,10140,11,476,118,182,787
SAN PEDRO DE URABA,2020,11,ANTIOQUIA,9208,929,24,30,0,0,10191,10,478,118,182,788
SAN PEDRO DE URABA,2020,12,ANTIOQUIA,9257,934,24,30,0,0,10245,10,477,117,182,786
SAN PEDRO DE URABA,2020,2,ANTIOQUIA,8607,915,24,33,0,0,9579,11,450,134,183,778
SAN PEDRO DE URABA,2020,3,ANTIOQUIA,8698,920,23,37,0,0,9678,11,454,133,183,781
SAN PEDRO DE URABA,2020,4,ANTIOQUIA,8677,918,23,23,0,0,9641,11,473,112,183,779
SAN PEDRO DE URABA,2020,5,ANTIOQUIA,8878,921,24,24,1,0,9848,9,473,113,183,778
SAN PEDRO DE URABA,2020,6,ANTIOQUIA,8960,922,24,24,0,0,9930,11,476,116,183,786
SAN PEDRO DE URABA,2020,7,ANTIOQUIA,9010,923,24,25,0,0,9982,11,476,117,182,786
SAN PEDRO DE URABA,2020,8,ANTIOQUIA,9092,925,24,26,0,0,10067,11,477,118,182,788
SAN PEDRO DE URABA,2020,9,ANTIOQUIA,9118,928,24,27,0,0,10097,11,475,118,182,786
SAN PEDRO DE URABA,2021,1,ANTIOQUIA,9313,936,24,30,0,0,10303,10,476,117,182,785
SAN PEDRO DE URABA,2021,10,ANTIOQUIA,9431,951,22,31,0,0,10435,11,481,117,182,791
SAN PEDRO DE URABA,2021,11,ANTIOQUIA,9452,954,22,30,0,0,10458,10,485,118,182,795
SAN PEDRO DE URABA,2021,12,ANTIOQUIA,9585,958,22,31,0,0,10596,10,492,119,182,803
SAN PEDRO DE URABA,2021,2,ANTIOQUIA,9373,937,23,30,0,0,10363,10,479,117,182,788
SAN PEDRO DE URABA,2021,3,ANTIOQUIA,9432,942,23,31,0,0,10428,10,481,115,182,788
SAN PEDRO DE URABA,2021,4,ANTIOQUIA,9465,941,22,29,0,0,10457,10,479,115,181,785
SAN PEDRO DE URABA,2021,5,ANTIOQUIA,9424,940,22,29,0,0,10415,10,478,115,182,785
SAN PEDRO DE URABA,2021,6,ANTIOQUIA,9420,939,22,29,0,0,10410,10,478,116,182,786
SAN PEDRO DE URABA,2021,7,ANTIOQUIA,9429,940,22,30,0,0,10421,10,477,116,182,785
SAN PEDRO DE URABA,2021,8,ANTIOQUIA,9430,940,22,30,0,0,10422,11,479,117,182,789
SAN PEDRO DE URABA,2021,9,ANTIOQUIA,9409,944,22,31,0,0,10406,11,477,117,182,787
SAN PEDRO DE URABA,2022,1,ANTIOQUIA,9540,959,22,34,0,0,10555,10,496,118,182,806
SAN PEDRO DE URABA,2022,10,ANTIOQUIA,9865,1083,22,34,0,0,11004,7,504,118,181,810
SAN PEDRO DE URABA,2022,11,ANTIOQUIA,9904,1087,22,36,0,0,11049,8,508,116,181,813
SAN PEDRO DE URABA,2022,12,ANTIOQUIA,9938,1094,23,36,0,0,11091,7,508,117,181,813
SAN PEDRO DE URABA,2022,2,ANTIOQUIA,9589,962,22,35,0,0,10608,10,494,118,182,804
SAN PEDRO DE URABA,2022,3,ANTIOQUIA,9667,963,22,36,0,0,10688,8,494,119,182,803
SAN PEDRO DE URABA,2022,4,ANTIOQUIA,9682,966,23,35,0,0,10706,8,494,119,182,803
SAN PEDRO DE URABA,2022,5,ANTIOQUIA,9707,1067,22,36,0,0,10832,8,491,119,181,799
SAN PEDRO DE URABA,2022,6,ANTIOQUIA,9739,1070,22,36,0,0,10867,8,494,118,181,801
SAN PEDRO DE URABA,2022,7,ANTIOQUIA,9774,1072,22,32,0,0,10900,8,497,118,180,803
SAN PEDRO DE URABA,2022,8,ANTIOQUIA,9804,1076,22,33,0,0,10935,8,496,118,180,802
SAN PEDRO DE URABA,2022,9,ANTIOQUIA,9840,1080,22,32,0,0,10974,7,500,118,181,806
SAN PEDRO DE URABA,2023,1,ANTIOQUIA,9969,1105,23,35,0,0,11132,7,509,117,181,814
SAN PEDRO DE URABA,2023,2,ANTIOQUIA,10025,1105,24,35,0,0,11189,7,513,117,181,818
SAN PEDRO DE URABA,2023,3,ANTIOQUIA,10053,1105,24,33,0,0,11215,7,517,117,181,822
SAN PEDRO DE URABA,2023,4,ANTIOQUIA,10088,1108,24,33,0,0,11253,7,523,117,181,828
SAN PEDRO DE URABA,2023,5,ANTIOQUIA,10121,1109,24,31,0,0,11285,7,523,117,181,828
SAN PEDRO DE URABA,2023,6,ANTIOQUIA,10164,1104,24,29,0,0,11321,7,530,117,181,835
SAN PEDRO DE URABA,2023,7,ANTIOQUIA,10257,1028,24,29,0,0,11338,7,527,117,181,832
SAN PEDRO DE URABA,2023,8,ANTIOQUIA,10272,1029,23,27,0,0,11351,7,530,117,181,835
SAN PEDRO DE URABA,2023,9,ANTIOQUIA,10310,1032,24,33,0,0,11399,7,529,117,181,834
SAN RAFAEL,2018,1,ANTIOQUIA,1743,4096,388,16,1,0,6244,15,357,114,4,490
SAN RAFAEL,2018,10,ANTIOQUIA,1750,4172,402,17,1,0,6342,18,368,114,4,504
SAN RAFAEL,2018,11,ANTIOQUIA,1755,4164,404,17,1,0,6341,19,368,114,4,505
SAN RAFAEL,2018,12,ANTIOQUIA,1768,4178,409,19,1,0,6375,19,370,114,4,507
SAN RAFAEL,2018,2,ANTIOQUIA,1740,4100,390,15,1,0,6246,15,357,114,4,490
SAN RAFAEL,2018,3,ANTIOQUIA,1738,4106,401,16,1,0,6262,15,357,114,4,490
SAN RAFAEL,2018,4,ANTIOQUIA,1748,4119,399,16,1,0,6283,15,357,114,4,490
SAN RAFAEL,2018,5,ANTIOQUIA,1744,4121,399,16,1,0,6281,16,367,115,4,502
SAN RAFAEL,2018,6,ANTIOQUIA,1747,4125,403,17,1,0,6293,17,366,115,4,502
SAN RAFAEL,2018,7,ANTIOQUIA,1749,4128,404,17,1,0,6299,17,366,115,4,502
SAN RAFAEL,2018,8,ANTIOQUIA,1752,4138,404,17,1,0,6312,18,369,115,4,506
SAN RAFAEL,2018,9,ANTIOQUIA,1744,4143,402,17,1,0,6307,18,368,114,4,504
SAN RAFAEL,2019,1,ANTIOQUIA,1773,4194,409,20,1,0,6397,19,368,114,4,505
SAN RAFAEL,2019,10,ANTIOQUIA,1815,4241,419,22,1,0,6498,29,378,115,4,526
SAN RAFAEL,2019,11,ANTIOQUIA,1823,4247,419,23,1,0,6513,30,378,115,4,527
SAN RAFAEL,2019,12,ANTIOQUIA,1844,4265,419,27,1,0,6556,29,378,115,4,526
SAN RAFAEL,2019,2,ANTIOQUIA,1777,4197,409,20,1,0,6404,22,371,114,4,511
SAN RAFAEL,2019,3,ANTIOQUIA,1782,4204,410,20,1,0,6417,22,371,114,4,511
SAN RAFAEL,2019,4,ANTIOQUIA,1785,4210,412,21,1,0,6429,24,370,114,4,512
SAN RAFAEL,2019,5,ANTIOQUIA,1795,4224,412,21,1,0,6453,26,374,115,4,519
SAN RAFAEL,2019,6,ANTIOQUIA,1787,4224,412,21,1,0,6445,26,375,115,4,520
SAN RAFAEL,2019,7,ANTIOQUIA,1792,4229,415,22,1,0,6459,26,377,115,4,522
SAN RAFAEL,2019,8,ANTIOQUIA,1808,4235,418,22,1,0,6484,27,377,115,4,523
SAN RAFAEL,2019,9,ANTIOQUIA,1810,4235,419,22,1,0,6487,28,378,115,4,525
SAN RAFAEL,2020,1,ANTIOQUIA,1844,4265,419,27,1,0,6556,29,379,114,4,526
SAN RAFAEL,2020,10,ANTIOQUIA,1883,4316,423,74,1,0,6697,30,386,113,130,659
SAN RAFAEL,2020,11,ANTIOQUIA,1891,4329,424,96,1,0,6741,30,387,113,130,660
SAN RAFAEL,2020,12,ANTIOQUIA,1909,4367,427,97,1,0,6801,31,389,113,130,663
SAN RAFAEL,2020,2,ANTIOQUIA,1845,4267,421,27,1,0,6561,30,379,117,130,656
SAN RAFAEL,2020,3,ANTIOQUIA,1847,4269,422,32,1,0,6571,30,380,117,130,657
SAN RAFAEL,2020,4,ANTIOQUIA,1847,4270,421,37,1,0,6576,29,383,114,130,656
SAN RAFAEL,2020,5,ANTIOQUIA,1863,4285,423,41,1,0,6613,30,386,119,130,665
SAN RAFAEL,2020,6,ANTIOQUIA,1863,4283,422,40,1,0,6609,29,383,114,130,656
SAN RAFAEL,2020,7,ANTIOQUIA,1867,4286,423,40,1,0,6617,28,385,113,130,656
SAN RAFAEL,2020,8,ANTIOQUIA,1873,4302,422,43,1,0,6641,28,386,113,130,657
SAN RAFAEL,2020,9,ANTIOQUIA,1878,4313,422,49,1,0,6663,28,386,113,130,657
SAN RAFAEL,2021,1,ANTIOQUIA,1938,4413,426,57,1,0,6835,31,388,113,130,662
SAN RAFAEL,2021,10,ANTIOQUIA,1988,4518,428,56,1,0,6991,39,389,113,130,671
SAN RAFAEL,2021,11,ANTIOQUIA,1990,4528,429,55,1,0,7003,40,390,113,130,673
SAN RAFAEL,2021,12,ANTIOQUIA,1993,4541,439,54,1,0,7028,41,392,112,130,675
SAN RAFAEL,2021,2,ANTIOQUIA,1940,4433,426,64,1,0,6864,36,387,113,130,666
SAN RAFAEL,2021,3,ANTIOQUIA,1948,4449,427,71,1,0,6896,36,388,113,130,667
SAN RAFAEL,2021,4,ANTIOQUIA,1953,4450,427,76,1,0,6907,37,391,113,130,671
SAN RAFAEL,2021,5,ANTIOQUIA,1958,4461,427,77,1,0,6924,37,391,113,130,671
SAN RAFAEL,2021,6,ANTIOQUIA,1979,4474,429,63,1,0,6946,36,390,113,130,669
SAN RAFAEL,2021,7,ANTIOQUIA,1982,4486,429,64,1,0,6962,38,391,113,130,672
SAN RAFAEL,2021,8,ANTIOQUIA,1979,4493,429,63,1,0,6965,38,391,113,130,672
SAN RAFAEL,2021,9,ANTIOQUIA,1982,4509,429,60,1,0,6981,39,390,113,130,672
SAN RAFAEL,2022,1,ANTIOQUIA,1995,4539,439,52,1,0,7026,40,391,112,130,673
SAN RAFAEL,2022,10,ANTIOQUIA,1945,4666,465,52,0,0,7128,42,390,114,130,676
SAN RAFAEL,2022,11,ANTIOQUIA,1940,4667,466,60,0,0,7133,43,393,114,131,681
SAN RAFAEL,2022,12,ANTIOQUIA,1945,4677,467,56,0,0,7145,43,393,114,131,681
SAN RAFAEL,2022,2,ANTIOQUIA,1999,4549,441,52,1,0,7042,40,390,113,130,673
SAN RAFAEL,2022,3,ANTIOQUIA,2004,4572,446,52,1,0,7075,39,388,114,130,671
SAN RAFAEL,2022,4,ANTIOQUIA,2004,4574,446,50,1,0,7075,40,390,114,130,674
SAN RAFAEL,2022,5,ANTIOQUIA,1995,4608,458,49,1,0,7111,38,389,115,130,672
SAN RAFAEL,2022,6,ANTIOQUIA,2002,4617,461,49,1,0,7130,40,390,115,130,675
SAN RAFAEL,2022,7,ANTIOQUIA,1932,4601,461,50,1,0,7045,39,389,114,130,672
SAN RAFAEL,2022,8,ANTIOQUIA,1939,4616,465,52,1,0,7073,41,391,114,130,676
SAN RAFAEL,2022,9,ANTIOQUIA,1944,4631,465,49,0,0,7089,41,391,114,130,676
SAN RAFAEL,2023,1,ANTIOQUIA,1946,4689,466,65,0,0,7166,45,393,115,131,684
SAN RAFAEL,2023,2,ANTIOQUIA,1955,4709,463,61,0,0,7188,44,393,116,131,684
SAN RAFAEL,2023,3,ANTIOQUIA,1961,4726,462,64,0,0,7213,48,394,116,131,689
SAN RAFAEL,2023,4,ANTIOQUIA,1969,4741,462,61,0,0,7233,48,394,116,131,689
SAN RAFAEL,2023,5,ANTIOQUIA,1983,4761,462,63,0,0,7269,48,394,116,131,689
SAN RAFAEL,2023,6,ANTIOQUIA,1990,4785,461,74,0,0,7310,48,394,116,131,689
SAN RAFAEL,2023,7,ANTIOQUIA,2008,4810,462,77,0,0,7357,51,397,116,131,695
SAN RAFAEL,2023,8,ANTIOQUIA,2025,4834,461,71,0,0,7391,53,397,116,131,697
SAN RAFAEL,2023,9,ANTIOQUIA,2039,4881,462,81,0,0,7463,54,399,116,131,700
SAN ROQUE,2018,1,ANTIOQUIA,2958,4279,626,57,10,11,7941,98,503,121,14,736
SAN ROQUE,2018,10,ANTIOQUIA,3007,4334,616,62,10,11,8040,98,514,123,16,751
SAN ROQUE,2018,11,ANTIOQUIA,3007,4331,610,62,10,11,8031,99,514,122,15,750
SAN ROQUE,2018,12,ANTIOQUIA,3012,4333,608,62,10,11,8036,99,514,122,15,750
SAN ROQUE,2018,2,ANTIOQUIA,2963,4285,627,57,10,11,7953,97,501,121,13,732
SAN ROQUE,2018,3,ANTIOQUIA,2970,4286,627,57,10,11,7961,95,501,121,13,730
SAN ROQUE,2018,4,ANTIOQUIA,2977,4293,626,58,10,11,7975,96,501,121,13,731
SAN ROQUE,2018,5,ANTIOQUIA,2975,4291,626,58,10,11,7971,94,497,123,13,727
SAN ROQUE,2018,6,ANTIOQUIA,2980,4289,621,57,10,11,7968,95,502,123,14,734
SAN ROQUE,2018,7,ANTIOQUIA,2989,4303,620,58,10,11,7991,96,504,123,14,737
SAN ROQUE,2018,8,ANTIOQUIA,3001,4307,621,58,10,11,8008,97,503,123,15,738
SAN ROQUE,2018,9,ANTIOQUIA,3002,4304,614,61,10,11,8002,98,514,123,15,750
SAN ROQUE,2019,1,ANTIOQUIA,3013,4342,609,59,10,11,8044,100,515,122,15,752
SAN ROQUE,2019,10,ANTIOQUIA,3101,4412,605,59,11,11,8199,104,520,124,15,763
SAN ROQUE,2019,11,ANTIOQUIA,3107,4416,604,59,10,11,8207,103,520,124,15,762
SAN ROQUE,2019,12,ANTIOQUIA,3120,4436,605,61,11,11,8244,104,524,125,15,768
SAN ROQUE,2019,2,ANTIOQUIA,3015,4345,610,60,10,11,8051,101,516,122,15,754
SAN ROQUE,2019,3,ANTIOQUIA,3020,4356,608,60,10,11,8065,102,516,122,15,755
SAN ROQUE,2019,4,ANTIOQUIA,3025,4364,605,59,10,11,8074,101,517,122,15,755
SAN ROQUE,2019,5,ANTIOQUIA,3038,4383,605,59,10,11,8106,103,519,122,15,759
SAN ROQUE,2019,6,ANTIOQUIA,3035,4382,605,61,10,11,8104,100,517,122,15,754
SAN ROQUE,2019,7,ANTIOQUIA,3038,4389,605,61,10,11,8114,102,519,122,15,758
SAN ROQUE,2019,8,ANTIOQUIA,3054,4399,600,61,11,11,8136,101,520,122,15,758
SAN ROQUE,2019,9,ANTIOQUIA,3054,4407,602,60,11,11,8145,101,521,123,15,760
SAN ROQUE,2020,1,ANTIOQUIA,3115,4436,602,78,9,11,8251,103,526,125,15,769
SAN ROQUE,2020,10,ANTIOQUIA,3219,4531,592,56,9,10,8417,111,549,125,92,877
SAN ROQUE,2020,11,ANTIOQUIA,3224,4539,590,56,9,10,8428,111,551,125,92,879
SAN ROQUE,2020,12,ANTIOQUIA,3246,4548,594,66,9,11,8474,111,549,125,92,877
SAN ROQUE,2020,2,ANTIOQUIA,3123,4438,600,76,9,11,8257,108,527,137,92,864
SAN ROQUE,2020,3,ANTIOQUIA,3123,4444,599,76,9,11,8262,108,529,137,92,866
SAN ROQUE,2020,4,ANTIOQUIA,3140,4460,602,59,9,11,8281,108,539,125,92,864
SAN ROQUE,2020,5,ANTIOQUIA,3158,4472,604,59,9,11,8313,108,539,125,92,864
SAN ROQUE,2020,6,ANTIOQUIA,3160,4474,603,59,9,11,8316,108,540,125,92,865
SAN ROQUE,2020,7,ANTIOQUIA,3172,4482,603,58,9,11,8335,110,540,126,92,868
SAN ROQUE,2020,8,ANTIOQUIA,3181,4497,594,56,9,11,8348,111,540,125,92,868
SAN ROQUE,2020,9,ANTIOQUIA,3199,4518,594,56,9,11,8387,111,543,125,92,871
SAN ROQUE,2021,1,ANTIOQUIA,3259,4555,592,67,9,10,8492,111,552,125,91,879
SAN ROQUE,2021,10,ANTIOQUIA,3347,4666,589,53,9,9,8673,123,555,125,92,895
SAN ROQUE,2021,11,ANTIOQUIA,3352,4675,588,53,9,9,8686,122,555,125,92,894
SAN ROQUE,2021,12,ANTIOQUIA,3362,4681,588,53,9,9,8702,122,556,125,92,895
SAN ROQUE,2021,2,ANTIOQUIA,3278,4570,593,61,9,9,8520,112,553,125,92,882
SAN ROQUE,2021,3,ANTIOQUIA,3288,4585,593,64,9,9,8548,111,553,125,92,881
SAN ROQUE,2021,4,ANTIOQUIA,3300,4598,593,62,9,9,8571,111,553,125,92,881
SAN ROQUE,2021,5,ANTIOQUIA,3305,4608,593,60,9,9,8584,114,554,125,92,885
SAN ROQUE,2021,6,ANTIOQUIA,3309,4612,591,56,9,9,8586,120,553,125,92,890
SAN ROQUE,2021,7,ANTIOQUIA,3316,4628,592,57,9,9,8611,121,556,125,92,894
SAN ROQUE,2021,8,ANTIOQUIA,3323,4644,590,54,9,9,8629,122,557,125,92,896
SAN ROQUE,2021,9,ANTIOQUIA,3333,4660,590,53,9,9,8654,122,555,125,92,894
SAN ROQUE,2022,1,ANTIOQUIA,3377,4693,588,54,9,9,8730,122,556,125,92,895
SAN ROQUE,2022,10,ANTIOQUIA,3527,4801,582,55,8,9,8982,120,578,127,92,917
SAN ROQUE,2022,11,ANTIOQUIA,3541,4824,582,56,8,9,9020,121,577,127,92,917
SAN ROQUE,2022,12,ANTIOQUIA,3555,4844,581,56,8,9,9053,121,577,127,92,917
SAN ROQUE,2022,2,ANTIOQUIA,3384,4704,592,54,9,9,8752,123,557,125,92,897
SAN ROQUE,2022,3,ANTIOQUIA,3420,4705,589,60,9,9,8792,122,558,126,91,897
SAN ROQUE,2022,4,ANTIOQUIA,3412,4737,589,59,9,9,8815,122,560,126,91,899
SAN ROQUE,2022,5,ANTIOQUIA,3416,4747,588,59,9,9,8828,123,564,126,91,904
SAN ROQUE,2022,6,ANTIOQUIA,3428,4756,588,59,9,9,8849,123,565,126,91,905
SAN ROQUE,2022,7,ANTIOQUIA,3434,4767,585,58,9,9,8862,122,569,126,91,908
SAN ROQUE,2022,8,ANTIOQUIA,3418,4755,578,56,8,9,8824,121,570,127,90,908
SAN ROQUE,2022,9,ANTIOQUIA,3510,4784,579,55,8,9,8945,121,570,127,91,909
SAN ROQUE,2023,1,ANTIOQUIA,3568,4858,582,57,7,9,9081,122,579,128,92,921
SAN ROQUE,2023,2,ANTIOQUIA,3590,4879,578,57,7,9,9120,121,579,128,93,921
SAN ROQUE,2023,3,ANTIOQUIA,3611,4912,576,53,7,9,9168,123,579,128,93,923
SAN ROQUE,2023,4,ANTIOQUIA,3619,4941,576,135,7,9,9287,124,580,128,93,925
SAN ROQUE,2023,5,ANTIOQUIA,3645,4953,577,136,7,9,9327,123,580,128,93,924
SAN ROQUE,2023,6,ANTIOQUIA,3658,4989,578,131,7,9,9372,122,579,128,93,922
SAN ROQUE,2023,7,ANTIOQUIA,3594,5160,572,58,8,9,9401,121,581,128,93,923
SAN ROQUE,2023,8,ANTIOQUIA,3598,5176,569,61,8,9,9421,121,582,127,93,923
SAN ROQUE,2023,9,ANTIOQUIA,3615,5190,570,59,8,9,9451,123,582,128,93,926
SAN VICENTE FERRER,2018,1,ANTIOQUIA,580,4751,2475,50,4,0,7860,44,372,76,4,496
SAN VICENTE FERRER,2018,10,ANTIOQUIA,605,4827,2505,59,5,0,8001,43,381,77,6,507
SAN VICENTE FERRER,2018,11,ANTIOQUIA,607,4833,2509,59,5,0,8013,43,380,77,6,506
SAN VICENTE FERRER,2018,12,ANTIOQUIA,606,4847,2512,60,5,0,8030,43,382,77,6,508
SAN VICENTE FERRER,2018,2,ANTIOQUIA,583,4760,2477,50,3,0,7873,44,371,76,4,495
SAN VICENTE FERRER,2018,3,ANTIOQUIA,584,4765,2476,49,4,0,7878,44,374,76,4,498
SAN VICENTE FERRER,2018,4,ANTIOQUIA,582,4776,2482,49,3,0,7892,44,373,76,4,497
SAN VICENTE FERRER,2018,5,ANTIOQUIA,593,4773,2479,52,3,0,7900,45,372,76,4,497
SAN VICENTE FERRER,2018,6,ANTIOQUIA,594,4793,2479,53,3,0,7922,47,374,76,4,501
SAN VICENTE FERRER,2018,7,ANTIOQUIA,603,4805,2484,53,3,0,7948,47,377,76,6,506
SAN VICENTE FERRER,2018,8,ANTIOQUIA,602,4813,2487,54,3,0,7959,47,377,77,6,507
SAN VICENTE FERRER,2018,9,ANTIOQUIA,603,4815,2494,56,5,0,7973,45,380,77,6,508
SAN VICENTE FERRER,2019,1,ANTIOQUIA,638,4847,2522,62,5,0,8074,44,392,77,6,519
SAN VICENTE FERRER,2019,10,ANTIOQUIA,1959,3361,2569,280,62,12,8243,53,401,79,6,539
SAN VICENTE FERRER,2019,11,ANTIOQUIA,1964,3391,2556,280,62,12,8265,58,401,79,6,544
SAN VICENTE FERRER,2019,12,ANTIOQUIA,1966,3430,2558,277,61,12,8304,60,404,80,6,550
SAN VICENTE FERRER,2019,2,ANTIOQUIA,642,4867,2536,61,5,0,8111,45,392,77,6,520
SAN VICENTE FERRER,2019,3,ANTIOQUIA,645,4868,2533,61,5,0,8112,45,392,78,6,521
SAN VICENTE FERRER,2019,4,ANTIOQUIA,651,4885,2539,61,5,0,8141,45,395,78,6,524
SAN VICENTE FERRER,2019,5,ANTIOQUIA,1342,4194,2513,102,10,3,8164,43,396,78,6,523
SAN VICENTE FERRER,2019,6,ANTIOQUIA,1926,3278,2580,285,73,12,8154,42,395,78,6,521
SAN VICENTE FERRER,2019,7,ANTIOQUIA,1928,3292,2583,285,73,12,8173,42,396,79,6,523
SAN VICENTE FERRER,2019,8,ANTIOQUIA,1934,3304,2585,283,69,11,8186,45,400,79,6,530
SAN VICENTE FERRER,2019,9,ANTIOQUIA,1941,3326,2576,282,67,11,8203,47,401,79,6,533
SAN VICENTE FERRER,2020,1,ANTIOQUIA,1970,3450,2548,279,61,12,8320,62,406,81,6,555
SAN VICENTE FERRER,2020,10,ANTIOQUIA,2002,3592,2573,285,54,12,8518,66,411,81,104,662
SAN VICENTE FERRER,2020,11,ANTIOQUIA,2011,3603,2577,284,54,12,8541,66,409,81,104,660
SAN VICENTE FERRER,2020,12,ANTIOQUIA,2014,3618,2589,282,54,12,8569,70,410,81,104,665
SAN VICENTE FERRER,2020,2,ANTIOQUIA,1972,3465,2554,279,59,12,8341,67,408,81,105,661
SAN VICENTE FERRER,2020,3,ANTIOQUIA,1973,3467,2556,281,59,12,8348,66,414,81,105,666
SAN VICENTE FERRER,2020,4,ANTIOQUIA,1974,3480,2559,277,59,12,8361,67,411,81,104,663
SAN VICENTE FERRER,2020,5,ANTIOQUIA,1982,3512,2566,280,60,12,8412,68,411,81,105,665
SAN VICENTE FERRER,2020,6,ANTIOQUIA,1992,3515,2566,279,60,12,8424,68,412,81,105,666
SAN VICENTE FERRER,2020,7,ANTIOQUIA,1991,3522,2570,280,58,12,8433,68,411,81,105,665
SAN VICENTE FERRER,2020,8,ANTIOQUIA,1999,3541,2575,283,58,12,8468,67,411,81,104,663
SAN VICENTE FERRER,2020,9,ANTIOQUIA,2000,3571,2570,282,54,12,8489,69,409,81,104,663
SAN VICENTE FERRER,2021,1,ANTIOQUIA,2026,3634,2594,282,54,12,8602,70,412,81,104,667
SAN VICENTE FERRER,2021,10,ANTIOQUIA,2077,3771,2637,282,52,12,8831,79,423,81,104,687
SAN VICENTE FERRER,2021,11,ANTIOQUIA,2079,3778,2648,284,52,12,8853,77,424,81,104,686
SAN VICENTE FERRER,2021,12,ANTIOQUIA,2080,3790,2650,283,52,12,8867,79,426,81,104,690
SAN VICENTE FERRER,2021,2,ANTIOQUIA,2030,3647,2598,280,54,12,8621,72,414,81,104,671
SAN VICENTE FERRER,2021,3,ANTIOQUIA,2034,3663,2603,279,54,12,8645,73,414,81,104,672
SAN VICENTE FERRER,2021,4,ANTIOQUIA,2043,3668,2607,280,53,12,8663,74,415,81,104,674
SAN VICENTE FERRER,2021,5,ANTIOQUIA,2048,3700,2615,281,53,13,8710,76,419,81,103,679
SAN VICENTE FERRER,2021,6,ANTIOQUIA,2053,3717,2614,279,53,13,8729,75,420,81,104,680
SAN VICENTE FERRER,2021,7,ANTIOQUIA,2061,3724,2618,281,53,12,8749,74,423,81,104,682
SAN VICENTE FERRER,2021,8,ANTIOQUIA,2070,3727,2622,279,53,12,8763,73,422,81,104,680
SAN VICENTE FERRER,2021,9,ANTIOQUIA,2075,3744,2626,280,52,12,8789,76,422,81,104,683
SAN VICENTE FERRER,2022,1,ANTIOQUIA,2083,3797,2646,286,52,12,8876,82,425,81,104,692
SAN VICENTE FERRER,2022,10,ANTIOQUIA,2108,3904,2724,274,50,12,9072,107,434,88,107,736
SAN VICENTE FERRER,2022,11,ANTIOQUIA,2118,3931,2727,275,50,12,9113,109,434,88,107,738
SAN VICENTE FERRER,2022,12,ANTIOQUIA,2119,3942,2736,274,50,12,9133,109,434,88,107,738
SAN VICENTE FERRER,2022,2,ANTIOQUIA,2083,3800,2651,285,52,12,8883,84,425,81,104,694
SAN VICENTE FERRER,2022,3,ANTIOQUIA,2083,3810,2657,285,52,12,8899,82,426,85,103,696
SAN VICENTE FERRER,2022,4,ANTIOQUIA,2084,3819,2671,284,52,12,8922,86,427,85,103,701
SAN VICENTE FERRER,2022,5,ANTIOQUIA,2082,3830,2687,285,53,12,8949,94,428,85,103,710
SAN VICENTE FERRER,2022,6,ANTIOQUIA,2096,3840,2687,286,52,12,8973,93,429,85,103,710
SAN VICENTE FERRER,2022,7,ANTIOQUIA,2096,3832,2683,286,52,12,8961,92,426,85,104,707
SAN VICENTE FERRER,2022,8,ANTIOQUIA,2101,3859,2693,277,51,12,8993,99,431,85,106,721
SAN VICENTE FERRER,2022,9,ANTIOQUIA,2105,3889,2711,274,51,12,9042,104,435,85,107,731
SAN VICENTE FERRER,2023,1,ANTIOQUIA,2129,3950,2745,274,51,12,9161,110,435,88,108,741
SAN VICENTE FERRER,2023,2,ANTIOQUIA,2132,3964,2762,275,51,13,9197,105,432,88,108,733
SAN VICENTE FERRER,2023,3,ANTIOQUIA,2143,3990,2777,276,51,13,9250,106,434,88,111,739
SAN VICENTE FERRER,2023,4,ANTIOQUIA,2161,4008,2788,275,51,13,9296,114,435,87,112,748
SAN VICENTE FERRER,2023,5,ANTIOQUIA,2170,4038,2865,277,51,13,9414,118,438,87,113,756
SAN VICENTE FERRER,2023,6,ANTIOQUIA,2188,4073,2877,281,51,13,9483,118,439,87,113,757
SAN VICENTE FERRER,2023,7,ANTIOQUIA,2192,4105,2889,282,51,13,9532,119,439,87,111,756
SAN VICENTE FERRER,2023,8,ANTIOQUIA,2199,4115,2893,283,51,13,9554,121,438,87,111,757
SAN VICENTE FERRER,2023,9,ANTIOQUIA,2211,4134,2900,287,52,13,9597,118,439,87,111,755
SANTA BARBARA,2018,1,ANTIOQUIA,1194,5352,2617,84,11,2,9260,34,591,100,17,742
SANTA BARBARA,2018,10,ANTIOQUIA,1221,5459,2637,82,10,2,9411,39,592,100,17,748
SANTA BARBARA,2018,11,ANTIOQUIA,1220,5467,2637,82,10,2,9418,39,592,100,17,748
SANTA BARBARA,2018,12,ANTIOQUIA,1224,5479,2634,81,10,2,9430,38,597,100,17,752
SANTA BARBARA,2018,2,ANTIOQUIA,1197,5369,2623,84,10,2,9285,34,589,101,17,741
SANTA BARBARA,2018,3,ANTIOQUIA,1197,5378,2626,84,10,2,9297,35,588,101,17,741
SANTA BARBARA,2018,4,ANTIOQUIA,1196,5388,2628,85,10,2,9309,36,589,101,17,743
SANTA BARBARA,2018,5,ANTIOQUIA,1192,5390,2634,84,10,2,9312,35,583,101,17,736
SANTA BARBARA,2018,6,ANTIOQUIA,1195,5394,2635,85,10,2,9321,38,580,101,17,736
SANTA BARBARA,2018,7,ANTIOQUIA,1197,5405,2638,87,10,2,9339,39,581,101,17,738
SANTA BARBARA,2018,8,ANTIOQUIA,1198,5416,2638,86,10,2,9350,39,581,101,17,738
SANTA BARBARA,2018,9,ANTIOQUIA,1203,5419,2643,85,10,2,9362,39,583,100,17,739
SANTA BARBARA,2019,1,ANTIOQUIA,1224,5493,2632,80,10,2,9441,40,609,100,17,766
SANTA BARBARA,2019,10,ANTIOQUIA,1251,5577,2669,83,10,2,9592,44,654,100,16,814
SANTA BARBARA,2019,11,ANTIOQUIA,1256,5601,2673,86,10,2,9628,44,661,100,16,821
SANTA BARBARA,2019,12,ANTIOQUIA,1264,5611,2678,86,10,2,9651,45,656,100,16,817
SANTA BARBARA,2019,2,ANTIOQUIA,1223,5502,2637,80,10,2,9454,40,612,100,17,769
SANTA BARBARA,2019,3,ANTIOQUIA,1224,5508,2638,87,10,2,9469,40,613,100,17,770
SANTA BARBARA,2019,4,ANTIOQUIA,1224,5515,2638,87,10,2,9476,42,614,100,17,773
SANTA BARBARA,2019,5,ANTIOQUIA,1226,5528,2662,90,10,2,9518,43,617,100,17,777
SANTA BARBARA,2019,6,ANTIOQUIA,1228,5530,2664,89,10,2,9523,44,615,100,16,775
SANTA BARBARA,2019,7,ANTIOQUIA,1234,5541,2662,89,10,2,9538,44,618,100,16,778
SANTA BARBARA,2019,8,ANTIOQUIA,1234,5551,2666,87,10,2,9550,44,652,100,16,812
SANTA BARBARA,2019,9,ANTIOQUIA,1248,5561,2668,86,10,2,9575,44,653,100,16,813
SANTA BARBARA,2020,1,ANTIOQUIA,1260,5613,2675,88,10,2,9648,45,656,100,16,817
SANTA BARBARA,2020,10,ANTIOQUIA,1280,5683,2683,91,10,1,9748,46,693,100,244,1083
SANTA BARBARA,2020,11,ANTIOQUIA,1285,5692,2684,90,10,1,9762,47,697,100,245,1089
SANTA BARBARA,2020,12,ANTIOQUIA,1291,5709,2683,88,10,1,9782,47,698,100,245,1090
SANTA BARBARA,2020,2,ANTIOQUIA,1259,5626,2676,91,10,2,9664,44,658,112,245,1059
SANTA BARBARA,2020,3,ANTIOQUIA,1264,5634,2676,94,10,2,9680,44,657,112,245,1058
SANTA BARBARA,2020,4,ANTIOQUIA,1268,5633,2665,88,10,2,9666,44,686,100,245,1075
SANTA BARBARA,2020,5,ANTIOQUIA,1269,5633,2667,87,11,2,9669,44,689,101,245,1079
SANTA BARBARA,2020,6,ANTIOQUIA,1270,5632,2681,87,10,2,9682,44,692,101,245,1082
SANTA BARBARA,2020,7,ANTIOQUIA,1274,5643,2682,89,10,2,9700,44,693,100,245,1082
SANTA BARBARA,2020,8,ANTIOQUIA,1277,5651,2682,88,10,2,9710,44,693,100,245,1082
SANTA BARBARA,2020,9,ANTIOQUIA,1281,5674,2681,90,10,1,9737,44,694,100,245,1083
SANTA BARBARA,2021,1,ANTIOQUIA,1291,5734,2678,87,10,1,9801,47,697,100,245,1089
SANTA BARBARA,2021,10,ANTIOQUIA,1308,5857,2682,84,10,1,9942,57,704,101,245,1107
SANTA BARBARA,2021,11,ANTIOQUIA,1309,5874,2719,85,10,1,9998,60,704,101,245,1110
SANTA BARBARA,2021,12,ANTIOQUIA,1319,5893,2716,86,10,1,10025,62,708,101,245,1116
SANTA BARBARA,2021,2,ANTIOQUIA,1292,5750,2684,87,10,1,9824,48,700,100,245,1093
SANTA BARBARA,2021,3,ANTIOQUIA,1295,5765,2686,88,10,1,9845,48,699,100,245,1092
SANTA BARBARA,2021,4,ANTIOQUIA,1299,5778,2681,87,10,1,9856,51,701,100,244,1096
SANTA BARBARA,2021,5,ANTIOQUIA,1297,5798,2680,87,10,1,9873,55,702,100,244,1101
SANTA BARBARA,2021,6,ANTIOQUIA,1298,5808,2675,86,10,1,9878,55,702,100,244,1101
SANTA BARBARA,2021,7,ANTIOQUIA,1299,5822,2675,85,10,1,9892,54,701,100,244,1099
SANTA BARBARA,2021,8,ANTIOQUIA,1304,5831,2672,85,10,1,9903,54,705,100,244,1103
SANTA BARBARA,2021,9,ANTIOQUIA,1308,5838,2678,84,10,1,9919,54,706,100,245,1105
SANTA BARBARA,2022,1,ANTIOQUIA,1323,5911,2710,85,10,1,10040,63,707,101,245,1116
SANTA BARBARA,2022,10,ANTIOQUIA,1344,6020,2745,85,10,1,10205,63,709,102,244,1118
SANTA BARBARA,2022,11,ANTIOQUIA,1347,6033,2743,85,10,1,10219,62,708,102,244,1116
SANTA BARBARA,2022,12,ANTIOQUIA,1349,6041,2743,85,10,1,10229,60,708,102,244,1114
SANTA BARBARA,2022,2,ANTIOQUIA,1323,5935,2714,84,10,1,10067,63,705,101,245,1114
SANTA BARBARA,2022,3,ANTIOQUIA,1334,5989,2719,85,10,1,10138,69,708,101,243,1121
SANTA BARBARA,2022,4,ANTIOQUIA,1344,5999,2720,84,10,1,10158,69,710,101,243,1123
SANTA BARBARA,2022,5,ANTIOQUIA,1336,6024,2732,86,10,1,10189,67,711,101,243,1122
SANTA BARBARA,2022,6,ANTIOQUIA,1349,6029,2738,85,10,1,10212,67,711,101,243,1122
SANTA BARBARA,2022,7,ANTIOQUIA,1351,6039,2735,84,10,1,10220,70,711,101,243,1125
SANTA BARBARA,2022,8,ANTIOQUIA,1331,5994,2742,85,10,1,10163,68,711,101,243,1123
SANTA BARBARA,2022,9,ANTIOQUIA,1338,6009,2745,84,10,1,10187,63,709,101,243,1116
SANTA BARBARA,2023,1,ANTIOQUIA,1352,6053,2746,85,10,1,10247,59,710,102,244,1115
SANTA BARBARA,2023,2,ANTIOQUIA,1352,6071,2742,84,10,1,10260,59,710,103,244,1116
SANTA BARBARA,2023,3,ANTIOQUIA,1354,6093,2748,86,10,1,10292,61,708,103,244,1116
SANTA BARBARA,2023,4,ANTIOQUIA,1361,6101,2749,84,10,1,10306,60,708,103,244,1115
SANTA BARBARA,2023,5,ANTIOQUIA,1360,6123,2751,83,10,1,10328,61,710,103,244,1118
SANTA BARBARA,2023,6,ANTIOQUIA,1358,6136,2764,101,10,1,10370,61,712,103,244,1120
SANTA BARBARA,2023,7,ANTIOQUIA,1359,6137,2761,99,10,1,10367,61,709,103,244,1117
SANTA BARBARA,2023,8,ANTIOQUIA,1360,6140,2762,101,10,1,10374,63,708,103,244,1118
SANTA BARBARA,2023,9,ANTIOQUIA,1361,6166,2756,99,10,1,10393,67,706,104,245,1122
SANTA FE DE ANTIOQUIA,2018,1,ANTIOQUIA,4035,4146,1693,1104,641,177,11796,123,883,97,28,1131
SANTA FE DE ANTIOQUIA,2018,10,ANTIOQUIA,4387,4321,1585,1121,643,186,12243,132,897,101,30,1160
SANTA FE DE ANTIOQUIA,2018,11,ANTIOQUIA,4422,4295,1580,1117,641,180,12235,131,891,99,28,1149
SANTA FE DE ANTIOQUIA,2018,12,ANTIOQUIA,4447,4307,1583,1117,642,181,12277,128,892,99,28,1147
SANTA FE DE ANTIOQUIA,2018,2,ANTIOQUIA,4172,4162,1559,1103,640,177,11813,126,880,97,28,1131
SANTA FE DE ANTIOQUIA,2018,3,ANTIOQUIA,4171,4181,1564,1108,641,177,11842,129,883,97,28,1137
SANTA FE DE ANTIOQUIA,2018,4,ANTIOQUIA,4202,4197,1566,1113,640,178,11896,128,886,97,28,1139
SANTA FE DE ANTIOQUIA,2018,5,ANTIOQUIA,4201,4210,1563,1112,639,178,11903,127,888,102,28,1145
SANTA FE DE ANTIOQUIA,2018,6,ANTIOQUIA,4248,4231,1568,1113,639,179,11978,126,891,102,29,1148
SANTA FE DE ANTIOQUIA,2018,7,ANTIOQUIA,4265,4258,1577,1117,641,179,12037,126,887,102,29,1144
SANTA FE DE ANTIOQUIA,2018,8,ANTIOQUIA,4306,4271,1578,1117,641,179,12092,126,893,102,29,1150
SANTA FE DE ANTIOQUIA,2018,9,ANTIOQUIA,4341,4285,1577,1117,640,180,12140,125,899,101,29,1154
SANTA FE DE ANTIOQUIA,2019,1,ANTIOQUIA,4461,4321,1590,1119,642,180,12313,129,894,99,28,1150
SANTA FE DE ANTIOQUIA,2019,10,ANTIOQUIA,4576,4346,1677,1123,665,183,12570,147,895,103,30,1175
SANTA FE DE ANTIOQUIA,2019,11,ANTIOQUIA,3450,2438,4704,898,951,183,12624,150,892,104,30,1176
SANTA FE DE ANTIOQUIA,2019,12,ANTIOQUIA,3480,2452,4687,918,951,183,12671,153,892,104,30,1179
SANTA FE DE ANTIOQUIA,2019,2,ANTIOQUIA,4460,4327,1595,1121,647,179,12329,128,900,100,28,1156
SANTA FE DE ANTIOQUIA,2019,3,ANTIOQUIA,4481,4339,1593,1120,652,179,12364,132,899,100,29,1160
SANTA FE DE ANTIOQUIA,2019,4,ANTIOQUIA,4530,4355,1596,1123,652,179,12435,134,896,101,29,1160
SANTA FE DE ANTIOQUIA,2019,5,ANTIOQUIA,4568,4365,1600,1124,653,179,12489,137,901,103,29,1170
SANTA FE DE ANTIOQUIA,2019,6,ANTIOQUIA,4560,4372,1603,1127,654,182,12498,135,900,103,30,1168
SANTA FE DE ANTIOQUIA,2019,7,ANTIOQUIA,4575,4380,1601,1127,655,183,12521,139,901,103,30,1173
SANTA FE DE ANTIOQUIA,2019,8,ANTIOQUIA,4583,4390,1608,1122,655,183,12541,140,897,103,30,1170
SANTA FE DE ANTIOQUIA,2019,9,ANTIOQUIA,4587,4388,1611,1127,655,183,12551,139,896,105,29,1169
SANTA FE DE ANTIOQUIA,2020,1,ANTIOQUIA,3917,2765,3969,946,953,183,12733,153,891,104,30,1178
SANTA FE DE ANTIOQUIA,2020,10,ANTIOQUIA,4322,3275,3249,955,889,196,12886,151,934,104,310,1499
SANTA FE DE ANTIOQUIA,2020,11,ANTIOQUIA,4345,3323,3230,956,884,196,12934,149,937,104,311,1501
SANTA FE DE ANTIOQUIA,2020,12,ANTIOQUIA,4377,3387,3191,957,884,197,12993,152,942,104,311,1509
SANTA FE DE ANTIOQUIA,2020,2,ANTIOQUIA,4218,2891,3598,825,1075,189,12796,157,904,123,310,1494
SANTA FE DE ANTIOQUIA,2020,3,ANTIOQUIA,4226,2895,3604,828,1077,190,12820,159,905,124,310,1498
SANTA FE DE ANTIOQUIA,2020,4,ANTIOQUIA,4288,3027,3445,793,1073,191,12817,158,924,105,310,1497
SANTA FE DE ANTIOQUIA,2020,5,ANTIOQUIA,4306,3050,3431,952,915,190,12844,159,929,105,310,1503
SANTA FE DE ANTIOQUIA,2020,6,ANTIOQUIA,4316,3153,3352,983,883,190,12877,163,931,105,310,1509
SANTA FE DE ANTIOQUIA,2020,7,ANTIOQUIA,4277,3134,3322,969,887,197,12786,151,931,103,311,1496
SANTA FE DE ANTIOQUIA,2020,8,ANTIOQUIA,4276,3178,3287,967,884,197,12789,150,931,104,311,1496
SANTA FE DE ANTIOQUIA,2020,9,ANTIOQUIA,4305,3252,3248,957,885,197,12844,149,931,104,311,1495
SANTA FE DE ANTIOQUIA,2021,1,ANTIOQUIA,4396,3409,3194,962,885,197,13043,150,942,104,310,1506
SANTA FE DE ANTIOQUIA,2021,10,ANTIOQUIA,4478,3651,3094,996,862,193,13274,165,970,104,309,1548
SANTA FE DE ANTIOQUIA,2021,11,ANTIOQUIA,4485,3660,3095,997,863,193,13293,169,974,104,309,1556
SANTA FE DE ANTIOQUIA,2021,12,ANTIOQUIA,4496,3693,3115,1000,863,193,13360,174,982,104,309,1569
SANTA FE DE ANTIOQUIA,2021,2,ANTIOQUIA,4414,3447,3167,963,883,197,13071,152,944,104,311,1511
SANTA FE DE ANTIOQUIA,2021,3,ANTIOQUIA,4425,3470,3154,974,880,196,13099,153,944,104,310,1511
SANTA FE DE ANTIOQUIA,2021,4,ANTIOQUIA,4433,3515,3127,975,879,195,13124,156,945,104,310,1515
SANTA FE DE ANTIOQUIA,2021,5,ANTIOQUIA,4442,3537,3124,977,879,196,13155,156,948,104,309,1517
SANTA FE DE ANTIOQUIA,2021,6,ANTIOQUIA,4448,3556,3119,979,879,196,13177,155,949,104,309,1517
SANTA FE DE ANTIOQUIA,2021,7,ANTIOQUIA,4455,3580,3115,983,878,194,13205,159,945,104,309,1517
SANTA FE DE ANTIOQUIA,2021,8,ANTIOQUIA,4461,3585,3116,983,877,193,13215,160,959,104,309,1532
SANTA FE DE ANTIOQUIA,2021,9,ANTIOQUIA,4468,3618,3098,985,875,193,13237,160,963,104,309,1536
SANTA FE DE ANTIOQUIA,2022,1,ANTIOQUIA,4379,3823,3124,1002,863,193,13384,174,983,104,309,1570
SANTA FE DE ANTIOQUIA,2022,10,ANTIOQUIA,4442,3878,3256,1121,769,189,13655,187,991,105,312,1595
SANTA FE DE ANTIOQUIA,2022,11,ANTIOQUIA,4463,3915,3219,1073,875,153,13698,191,994,104,312,1601
SANTA FE DE ANTIOQUIA,2022,12,ANTIOQUIA,4470,3924,3221,1074,880,153,13722,188,994,104,312,1598
SANTA FE DE ANTIOQUIA,2022,2,ANTIOQUIA,4388,3836,3136,1002,864,193,13419,174,984,104,309,1571
SANTA FE DE ANTIOQUIA,2022,3,ANTIOQUIA,4397,3868,3143,1006,866,194,13474,172,983,104,308,1567
SANTA FE DE ANTIOQUIA,2022,4,ANTIOQUIA,4384,3889,3158,1013,866,194,13504,177,982,104,308,1571
SANTA FE DE ANTIOQUIA,2022,5,ANTIOQUIA,4393,3919,3160,1014,865,194,13545,176,981,104,308,1569
SANTA FE DE ANTIOQUIA,2022,6,ANTIOQUIA,4405,3935,3162,1013,863,194,13572,180,986,104,308,1578
SANTA FE DE ANTIOQUIA,2022,7,ANTIOQUIA,4397,3921,3157,1015,863,194,13547,181,984,104,308,1577
SANTA FE DE ANTIOQUIA,2022,8,ANTIOQUIA,4428,3786,3295,1020,860,194,13583,185,987,104,309,1585
SANTA FE DE ANTIOQUIA,2022,9,ANTIOQUIA,4436,3808,3302,1027,852,192,13617,184,989,105,311,1589
SANTA FE DE ANTIOQUIA,2023,1,ANTIOQUIA,4484,4059,3223,1031,1031,55,13883,194,1000,103,314,1611
SANTA FE DE ANTIOQUIA,2023,2,ANTIOQUIA,4490,3944,3232,1153,1027,53,13899,191,1009,103,315,1618
SANTA FE DE ANTIOQUIA,2023,3,ANTIOQUIA,4514,3967,3229,1155,1027,53,13945,191,1011,103,315,1620
SANTA FE DE ANTIOQUIA,2023,4,ANTIOQUIA,4525,3990,3229,1157,1027,53,13981,192,1010,103,316,1621
SANTA FE DE ANTIOQUIA,2023,5,ANTIOQUIA,4545,4002,3225,1165,1027,54,14018,191,1010,105,318,1624
SANTA FE DE ANTIOQUIA,2023,6,ANTIOQUIA,4573,4022,3230,1165,1030,53,14073,202,1011,105,318,1636
SANTA FE DE ANTIOQUIA,2023,7,ANTIOQUIA,4592,4046,3232,1165,1032,53,14120,205,1008,105,319,1637
SANTA FE DE ANTIOQUIA,2023,8,ANTIOQUIA,4610,4074,3229,1171,1033,53,14170,201,1010,106,320,1637
SANTA FE DE ANTIOQUIA,2023,9,ANTIOQUIA,4609,4088,3234,1176,1031,52,14190,200,1001,106,320,1627
SANTA ROSA DE OSOS,2018,1,ANTIOQUIA,1863,8625,2196,213,12,10,12919,553,1150,118,22,1843
SANTA ROSA DE OSOS,2018,10,ANTIOQUIA,1889,8833,2257,216,13,9,13217,585,1212,119,22,1938
SANTA ROSA DE OSOS,2018,11,ANTIOQUIA,1890,8847,2259,217,13,9,13235,587,1213,118,22,1940
SANTA ROSA DE OSOS,2018,12,ANTIOQUIA,1894,8861,2286,216,13,9,13279,588,1224,118,22,1952
SANTA ROSA DE OSOS,2018,2,ANTIOQUIA,1867,8651,2212,215,12,10,12967,563,1153,117,22,1855
SANTA ROSA DE OSOS,2018,3,ANTIOQUIA,1869,8682,2226,213,13,10,13013,570,1159,118,22,1869
SANTA ROSA DE OSOS,2018,4,ANTIOQUIA,1873,8709,2240,213,13,10,13058,578,1163,118,22,1881
SANTA ROSA DE OSOS,2018,5,ANTIOQUIA,1875,8720,2240,213,13,10,13071,574,1168,118,22,1882
SANTA ROSA DE OSOS,2018,6,ANTIOQUIA,1877,8794,2255,214,13,10,13163,577,1177,118,22,1894
SANTA ROSA DE OSOS,2018,7,ANTIOQUIA,1881,8796,2245,215,13,9,13159,579,1210,118,22,1929
SANTA ROSA DE OSOS,2018,8,ANTIOQUIA,1884,8809,2252,215,13,9,13182,583,1212,119,22,1936
SANTA ROSA DE OSOS,2018,9,ANTIOQUIA,1885,8816,2251,215,13,9,13189,584,1206,119,22,1931
SANTA ROSA DE OSOS,2019,1,ANTIOQUIA,1900,8887,2288,217,13,9,13314,589,1221,118,22,1950
SANTA ROSA DE OSOS,2019,10,ANTIOQUIA,1963,9079,2339,219,13,8,13621,673,1231,120,23,2047
SANTA ROSA DE OSOS,2019,11,ANTIOQUIA,1967,9092,2343,216,13,8,13639,677,1232,120,23,2052
SANTA ROSA DE OSOS,2019,12,ANTIOQUIA,1975,9120,2353,222,13,8,13691,684,1233,120,23,2060
SANTA ROSA DE OSOS,2019,2,ANTIOQUIA,1906,8903,2291,217,13,9,13339,597,1223,118,22,1960
SANTA ROSA DE OSOS,2019,3,ANTIOQUIA,1912,8911,2288,218,13,9,13351,602,1223,118,22,1965
SANTA ROSA DE OSOS,2019,4,ANTIOQUIA,1946,8922,2289,217,13,9,13396,611,1216,118,22,1967
SANTA ROSA DE OSOS,2019,5,ANTIOQUIA,1955,8954,2296,217,13,9,13444,622,1222,118,22,1984
SANTA ROSA DE OSOS,2019,6,ANTIOQUIA,1951,8957,2307,216,13,9,13453,625,1224,119,23,1991
SANTA ROSA DE OSOS,2019,7,ANTIOQUIA,1960,8981,2311,216,13,9,13490,637,1222,119,23,2001
SANTA ROSA DE OSOS,2019,8,ANTIOQUIA,1956,9034,2330,218,13,8,13559,648,1223,119,23,2013
SANTA ROSA DE OSOS,2019,9,ANTIOQUIA,1958,9070,2336,218,13,8,13603,661,1224,121,22,2028
SANTA ROSA DE OSOS,2020,1,ANTIOQUIA,1975,9115,2358,234,13,8,13703,697,1237,120,23,2077
SANTA ROSA DE OSOS,2020,10,ANTIOQUIA,2042,9287,2402,264,13,8,14016,758,1265,119,383,2525
SANTA ROSA DE OSOS,2020,11,ANTIOQUIA,2049,9310,2406,276,13,8,14062,777,1271,120,383,2551
SANTA ROSA DE OSOS,2020,12,ANTIOQUIA,2052,9327,2409,309,13,8,14118,787,1273,120,383,2563
SANTA ROSA DE OSOS,2020,2,ANTIOQUIA,1977,9134,2362,241,13,8,13735,704,1237,140,383,2464
SANTA ROSA DE OSOS,2020,3,ANTIOQUIA,1981,9152,2367,246,13,8,13767,714,1240,140,383,2477
SANTA ROSA DE OSOS,2020,4,ANTIOQUIA,1986,9175,2373,232,13,8,13787,723,1262,120,383,2488
SANTA ROSA DE OSOS,2020,5,ANTIOQUIA,2008,9191,2379,238,13,8,13837,724,1280,120,383,2507
SANTA ROSA DE OSOS,2020,6,ANTIOQUIA,2009,9192,2370,241,13,9,13834,732,1272,120,383,2507
SANTA ROSA DE OSOS,2020,7,ANTIOQUIA,2025,9226,2381,248,13,9,13902,736,1273,120,383,2512
SANTA ROSA DE OSOS,2020,8,ANTIOQUIA,2027,9250,2390,253,13,9,13942,734,1272,120,383,2509
SANTA ROSA DE OSOS,2020,9,ANTIOQUIA,2036,9270,2399,255,13,9,13982,750,1268,120,383,2521
SANTA ROSA DE OSOS,2021,1,ANTIOQUIA,2055,9341,2411,313,13,7,14140,799,1271,118,383,2571
SANTA ROSA DE OSOS,2021,10,ANTIOQUIA,2118,9561,2541,341,14,7,14582,843,1276,120,383,2622
SANTA ROSA DE OSOS,2021,11,ANTIOQUIA,2126,9581,2545,342,14,7,14615,851,1276,120,383,2630
SANTA ROSA DE OSOS,2021,12,ANTIOQUIA,2128,9602,2565,342,15,7,14659,865,1273,120,383,2641
SANTA ROSA DE OSOS,2021,2,ANTIOQUIA,2059,9378,2418,322,13,7,14197,798,1273,118,383,2572
SANTA ROSA DE OSOS,2021,3,ANTIOQUIA,2065,9412,2422,325,14,7,14245,799,1275,118,383,2575
SANTA ROSA DE OSOS,2021,4,ANTIOQUIA,2073,9426,2425,326,14,7,14271,807,1280,118,383,2588
SANTA ROSA DE OSOS,2021,5,ANTIOQUIA,2078,9440,2460,327,14,7,14326,813,1280,118,383,2594
SANTA ROSA DE OSOS,2021,6,ANTIOQUIA,2081,9452,2466,325,14,7,14345,816,1279,118,383,2596
SANTA ROSA DE OSOS,2021,7,ANTIOQUIA,2090,9486,2508,332,14,7,14437,821,1279,119,383,2602
SANTA ROSA DE OSOS,2021,8,ANTIOQUIA,2101,9500,2518,333,14,7,14473,831,1278,120,384,2613
SANTA ROSA DE OSOS,2021,9,ANTIOQUIA,2111,9520,2528,336,14,7,14516,838,1275,120,384,2617
SANTA ROSA DE OSOS,2022,1,ANTIOQUIA,2130,9614,2565,359,15,7,14690,878,1271,120,383,2652
SANTA ROSA DE OSOS,2022,10,ANTIOQUIA,2171,9827,2663,435,15,7,15118,935,1280,120,383,2718
SANTA ROSA DE OSOS,2022,11,ANTIOQUIA,2176,9840,2663,438,14,7,15138,942,1280,120,384,2726
SANTA ROSA DE OSOS,2022,12,ANTIOQUIA,2187,9856,2660,441,14,7,15165,945,1278,120,384,2727
SANTA ROSA DE OSOS,2022,2,ANTIOQUIA,2142,9624,2571,361,15,7,14720,882,1271,120,383,2656
SANTA ROSA DE OSOS,2022,3,ANTIOQUIA,2154,9660,2574,367,15,7,14777,888,1273,121,383,2665
SANTA ROSA DE OSOS,2022,4,ANTIOQUIA,2161,9683,2587,368,15,7,14821,899,1270,121,383,2673
SANTA ROSA DE OSOS,2022,5,ANTIOQUIA,2151,9741,2598,369,15,7,14881,907,1266,121,383,2677
SANTA ROSA DE OSOS,2022,6,ANTIOQUIA,2164,9765,2600,371,15,7,14922,917,1268,121,383,2689
SANTA ROSA DE OSOS,2022,7,ANTIOQUIA,2148,9765,2607,430,15,7,14972,919,1268,121,383,2691
SANTA ROSA DE OSOS,2022,8,ANTIOQUIA,2159,9789,2618,428,15,7,15016,924,1266,120,383,2693
SANTA ROSA DE OSOS,2022,9,ANTIOQUIA,2168,9811,2621,431,15,7,15053,933,1266,120,383,2702
SANTA ROSA DE OSOS,2023,1,ANTIOQUIA,2194,9874,2664,448,14,8,15202,947,1278,120,383,2728
SANTA ROSA DE OSOS,2023,2,ANTIOQUIA,2198,9888,2665,453,14,7,15225,950,1275,120,384,2729
SANTA ROSA DE OSOS,2023,3,ANTIOQUIA,2209,9906,2665,453,14,7,15254,954,1280,120,384,2738
SANTA ROSA DE OSOS,2023,4,ANTIOQUIA,2214,9922,2677,457,14,7,15291,955,1283,120,384,2742
SANTA ROSA DE OSOS,2023,5,ANTIOQUIA,2216,9948,2678,464,13,7,15326,958,1283,120,384,2745
SANTA ROSA DE OSOS,2023,6,ANTIOQUIA,2220,9958,2678,474,13,7,15350,965,1285,120,384,2754
SANTA ROSA DE OSOS,2023,7,ANTIOQUIA,2220,9969,2668,477,13,7,15354,981,1279,120,383,2763
SANTA ROSA DE OSOS,2023,8,ANTIOQUIA,2220,9977,2670,481,13,7,15368,988,1285,121,383,2777
SANTA ROSA DE OSOS,2023,9,ANTIOQUIA,2230,9994,2666,490,13,7,15400,986,1286,121,384,2777
SANTO DOMINGO,2018,1,ANTIOQUIA,1758,2784,668,89,8,5,5312,73,279,91,9,452
SANTO DOMINGO,2018,10,ANTIOQUIA,1778,2861,682,89,7,5,5422,74,278,91,10,453
SANTO DOMINGO,2018,11,ANTIOQUIA,1764,2853,682,89,7,5,5400,74,278,91,9,452
SANTO DOMINGO,2018,12,ANTIOQUIA,1765,2873,682,89,8,5,5422,73,277,91,9,450
SANTO DOMINGO,2018,2,ANTIOQUIA,1758,2788,668,89,8,5,5316,73,279,90,9,451
SANTO DOMINGO,2018,3,ANTIOQUIA,1755,2794,669,88,8,5,5319,73,279,90,9,451
SANTO DOMINGO,2018,4,ANTIOQUIA,1759,2805,676,90,8,5,5343,75,277,90,9,451
SANTO DOMINGO,2018,5,ANTIOQUIA,1756,2806,672,90,8,5,5337,74,279,90,9,452
SANTO DOMINGO,2018,6,ANTIOQUIA,1758,2819,675,88,8,5,5353,74,280,91,9,454
SANTO DOMINGO,2018,7,ANTIOQUIA,1763,2834,676,88,8,5,5374,74,279,91,9,453
SANTO DOMINGO,2018,8,ANTIOQUIA,1766,2848,678,88,8,5,5393,74,278,91,9,452
SANTO DOMINGO,2018,9,ANTIOQUIA,1766,2853,681,88,7,5,5400,74,278,91,9,452
SANTO DOMINGO,2019,1,ANTIOQUIA,1773,2876,682,88,8,5,5432,74,278,92,9,453
SANTO DOMINGO,2019,10,ANTIOQUIA,1790,2913,680,97,8,5,5493,79,285,92,9,465
SANTO DOMINGO,2019,11,ANTIOQUIA,1817,2916,681,97,8,5,5524,81,285,92,9,467
SANTO DOMINGO,2019,12,ANTIOQUIA,1827,2919,683,99,7,5,5540,80,287,92,9,468
SANTO DOMINGO,2019,2,ANTIOQUIA,1777,2883,682,90,8,5,5445,76,278,92,9,455
SANTO DOMINGO,2019,3,ANTIOQUIA,1776,2883,683,90,8,5,5445,76,280,92,9,457
SANTO DOMINGO,2019,4,ANTIOQUIA,1775,2887,683,90,8,5,5448,77,280,92,9,458
SANTO DOMINGO,2019,5,ANTIOQUIA,1782,2899,684,90,8,5,5468,77,279,92,9,457
SANTO DOMINGO,2019,6,ANTIOQUIA,1779,2897,684,93,8,5,5466,79,279,92,9,459
SANTO DOMINGO,2019,7,ANTIOQUIA,1782,2900,681,92,8,5,5468,76,282,91,9,458
SANTO DOMINGO,2019,8,ANTIOQUIA,1783,2904,683,92,8,5,5475,78,283,91,9,461
SANTO DOMINGO,2019,9,ANTIOQUIA,1786,2910,680,96,8,5,5485,77,285,92,9,463
SANTO DOMINGO,2020,1,ANTIOQUIA,1817,2919,680,98,7,5,5526,81,286,92,9,468
SANTO DOMINGO,2020,10,ANTIOQUIA,1842,2962,689,99,7,5,5604,86,294,91,68,539
SANTO DOMINGO,2020,11,ANTIOQUIA,1843,2971,686,99,7,5,5611,86,295,91,68,540
SANTO DOMINGO,2020,12,ANTIOQUIA,1845,2979,687,99,7,5,5622,86,293,91,68,538
SANTO DOMINGO,2020,2,ANTIOQUIA,1807,2911,680,99,8,5,5510,86,286,97,67,536
SANTO DOMINGO,2020,3,ANTIOQUIA,1806,2910,680,100,8,5,5509,84,287,96,67,534
SANTO DOMINGO,2020,4,ANTIOQUIA,1822,2932,681,98,7,5,5545,85,294,91,67,537
SANTO DOMINGO,2020,5,ANTIOQUIA,1830,2942,683,98,7,5,5565,85,295,92,67,539
SANTO DOMINGO,2020,6,ANTIOQUIA,1828,2942,683,99,7,5,5564,85,294,91,67,537
SANTO DOMINGO,2020,7,ANTIOQUIA,1832,2945,683,100,7,5,5572,85,294,91,67,537
SANTO DOMINGO,2020,8,ANTIOQUIA,1838,2947,685,99,7,5,5581,85,294,91,68,538
SANTO DOMINGO,2020,9,ANTIOQUIA,1840,2952,687,99,7,5,5590,85,293,91,68,537
SANTO DOMINGO,2021,1,ANTIOQUIA,1848,2984,688,99,7,5,5631,86,294,91,68,539
SANTO DOMINGO,2021,10,ANTIOQUIA,1884,3051,695,103,8,5,5746,85,293,89,67,534
SANTO DOMINGO,2021,11,ANTIOQUIA,1888,3052,696,103,8,5,5752,86,293,89,67,535
SANTO DOMINGO,2021,12,ANTIOQUIA,1896,3055,698,103,8,5,5765,86,293,89,67,535
SANTO DOMINGO,2021,2,ANTIOQUIA,1855,2992,687,104,7,5,5650,86,292,91,67,536
SANTO DOMINGO,2021,3,ANTIOQUIA,1863,3002,688,102,7,5,5667,86,291,92,67,536
SANTO DOMINGO,2021,4,ANTIOQUIA,1867,3015,690,102,7,5,5686,87,291,91,67,536
SANTO DOMINGO,2021,5,ANTIOQUIA,1870,3016,692,102,7,5,5692,87,290,91,67,535
SANTO DOMINGO,2021,6,ANTIOQUIA,1871,3015,693,102,7,5,5693,87,290,90,67,534
SANTO DOMINGO,2021,7,ANTIOQUIA,1875,3027,692,101,7,5,5707,86,290,90,67,533
SANTO DOMINGO,2021,8,ANTIOQUIA,1877,3032,692,101,7,5,5714,86,290,89,67,532
SANTO DOMINGO,2021,9,ANTIOQUIA,1882,3041,693,102,8,5,5731,88,293,89,67,537
SANTO DOMINGO,2022,1,ANTIOQUIA,1898,3062,698,105,8,5,5776,86,294,89,67,536
SANTO DOMINGO,2022,10,ANTIOQUIA,1935,3127,688,110,8,5,5873,81,297,91,65,534
SANTO DOMINGO,2022,11,ANTIOQUIA,1938,3142,690,114,8,5,5897,81,297,91,65,534
SANTO DOMINGO,2022,12,ANTIOQUIA,1937,3144,693,114,8,5,5901,81,298,91,65,535
SANTO DOMINGO,2022,2,ANTIOQUIA,1906,3074,698,106,8,5,5797,85,297,89,67,538
SANTO DOMINGO,2022,3,ANTIOQUIA,1910,3088,699,109,8,5,5819,83,298,92,66,539
SANTO DOMINGO,2022,4,ANTIOQUIA,1920,3095,699,109,8,5,5836,83,296,92,66,537
SANTO DOMINGO,2022,5,ANTIOQUIA,1923,3107,699,108,8,5,5850,84,298,92,65,539
SANTO DOMINGO,2022,6,ANTIOQUIA,1931,3109,697,108,8,5,5858,86,298,92,65,541
SANTO DOMINGO,2022,7,ANTIOQUIA,1932,3107,690,108,8,5,5850,84,297,92,65,538
SANTO DOMINGO,2022,8,ANTIOQUIA,1930,3109,684,107,8,5,5843,82,295,91,65,533
SANTO DOMINGO,2022,9,ANTIOQUIA,1932,3114,686,108,8,5,5853,82,297,91,65,535
SANTO DOMINGO,2023,1,ANTIOQUIA,1948,3160,693,115,8,5,5929,81,298,91,65,535
SANTO DOMINGO,2023,2,ANTIOQUIA,1953,3168,697,115,8,5,5946,80,297,91,65,533
SANTO DOMINGO,2023,3,ANTIOQUIA,1970,3182,696,117,8,5,5978,78,297,91,65,531
SANTO DOMINGO,2023,4,ANTIOQUIA,1978,3191,699,119,8,5,6000,80,297,91,65,533
SANTO DOMINGO,2023,5,ANTIOQUIA,1985,3198,701,121,8,5,6018,79,297,92,65,533
SANTO DOMINGO,2023,6,ANTIOQUIA,1992,3203,703,121,8,5,6032,77,296,92,65,530
SANTO DOMINGO,2023,7,ANTIOQUIA,1998,3206,703,121,8,5,6041,81,295,92,65,533
SANTO DOMINGO,2023,8,ANTIOQUIA,2002,3213,701,120,8,5,6049,81,296,92,66,535
SANTO DOMINGO,2023,9,ANTIOQUIA,2008,3221,704,120,8,5,6066,83,299,92,67,541
SEGOVIA,2018,1,ANTIOQUIA,5092,4281,1586,34,3,0,10996,207,965,59,7,1238
SEGOVIA,2018,10,ANTIOQUIA,5490,4334,1588,31,3,0,11446,196,967,64,7,1234
SEGOVIA,2018,11,ANTIOQUIA,5487,4332,1582,31,3,0,11435,194,966,64,7,1231
SEGOVIA,2018,12,ANTIOQUIA,5495,4337,1580,29,3,0,11444,192,967,64,7,1230
SEGOVIA,2018,2,ANTIOQUIA,5249,4277,1585,34,3,0,11148,202,959,60,7,1228
SEGOVIA,2018,3,ANTIOQUIA,5338,4286,1584,33,3,0,11244,203,960,61,7,1231
SEGOVIA,2018,4,ANTIOQUIA,5387,4293,1594,34,3,0,11311,203,963,62,7,1235
SEGOVIA,2018,5,ANTIOQUIA,5389,4288,1595,34,3,0,11309,200,958,63,7,1228
SEGOVIA,2018,6,ANTIOQUIA,5444,4303,1596,29,3,0,11375,198,956,64,7,1225
SEGOVIA,2018,7,ANTIOQUIA,5475,4311,1592,29,3,0,11410,198,959,64,7,1228
SEGOVIA,2018,8,ANTIOQUIA,5485,4316,1592,29,3,0,11425,198,958,64,7,1227
SEGOVIA,2018,9,ANTIOQUIA,5471,4314,1587,31,3,0,11406,195,963,63,7,1228
SEGOVIA,2019,1,ANTIOQUIA,5546,4342,1585,28,3,0,11504,191,977,66,8,1242
SEGOVIA,2019,10,ANTIOQUIA,6064,4405,1578,35,3,0,12085,195,975,74,9,1253
SEGOVIA,2019,11,ANTIOQUIA,6072,4409,1576,34,3,0,12094,195,979,74,9,1257
SEGOVIA,2019,12,ANTIOQUIA,6128,4432,1584,34,3,0,12181,198,983,75,9,1265
SEGOVIA,2019,2,ANTIOQUIA,5657,4349,1586,28,3,0,11623,192,976,67,9,1244
SEGOVIA,2019,3,ANTIOQUIA,5687,4357,1586,27,3,0,11660,195,976,65,9,1245
SEGOVIA,2019,4,ANTIOQUIA,5990,4369,1588,28,3,0,11978,196,975,72,9,1252
SEGOVIA,2019,5,ANTIOQUIA,6021,4371,1586,27,3,0,12008,196,980,73,9,1258
SEGOVIA,2019,6,ANTIOQUIA,6005,4376,1582,29,3,0,11995,194,980,73,9,1256
SEGOVIA,2019,7,ANTIOQUIA,6021,4386,1580,29,3,0,12019,193,979,73,9,1254
SEGOVIA,2019,8,ANTIOQUIA,6039,4389,1576,29,3,0,12036,194,979,73,9,1255
SEGOVIA,2019,9,ANTIOQUIA,6055,4398,1576,29,3,0,12061,194,974,73,9,1250
SEGOVIA,2020,1,ANTIOQUIA,6118,4418,1578,45,3,0,12162,195,975,75,9,1254
SEGOVIA,2020,10,ANTIOQUIA,6209,4483,1577,43,3,0,12315,210,973,74,243,1500
SEGOVIA,2020,11,ANTIOQUIA,6316,4497,1575,39,3,0,12430,210,981,74,243,1508
SEGOVIA,2020,12,ANTIOQUIA,6587,4507,1575,61,3,0,12733,210,982,74,243,1509
SEGOVIA,2020,2,ANTIOQUIA,6121,4423,1575,50,3,0,12172,197,977,80,243,1497
SEGOVIA,2020,3,ANTIOQUIA,6131,4429,1579,50,3,0,12192,207,980,80,243,1510
SEGOVIA,2020,4,ANTIOQUIA,6135,4440,1577,34,3,0,12189,205,983,74,243,1505
SEGOVIA,2020,5,ANTIOQUIA,6236,4449,1579,34,3,0,12301,210,983,76,243,1512
SEGOVIA,2020,6,ANTIOQUIA,6175,4456,1580,38,3,0,12252,209,983,74,243,1509
SEGOVIA,2020,7,ANTIOQUIA,6188,4460,1580,39,3,0,12270,206,978,76,243,1503
SEGOVIA,2020,8,ANTIOQUIA,6196,4469,1578,39,3,0,12285,207,976,74,243,1500
SEGOVIA,2020,9,ANTIOQUIA,6201,4471,1576,40,3,0,12291,207,973,74,243,1497
SEGOVIA,2021,1,ANTIOQUIA,6661,4510,1577,64,3,0,12815,210,981,73,243,1507
SEGOVIA,2021,10,ANTIOQUIA,6805,4604,1587,45,3,0,13044,212,998,73,243,1526
SEGOVIA,2021,11,ANTIOQUIA,6802,4617,1589,46,3,0,13057,209,1001,73,243,1526
SEGOVIA,2021,12,ANTIOQUIA,6842,4632,1587,45,3,0,13109,212,1002,74,243,1531
SEGOVIA,2021,2,ANTIOQUIA,6680,4519,1580,70,3,0,12852,209,983,73,243,1508
SEGOVIA,2021,3,ANTIOQUIA,6690,4533,1580,69,3,0,12875,209,993,72,243,1517
SEGOVIA,2021,4,ANTIOQUIA,6701,4537,1593,64,3,0,12898,211,997,72,243,1523
SEGOVIA,2021,5,ANTIOQUIA,6736,4547,1597,43,3,0,12926,209,998,72,242,1521
SEGOVIA,2021,6,ANTIOQUIA,6738,4552,1593,43,3,0,12929,207,998,72,243,1520
SEGOVIA,2021,7,ANTIOQUIA,6763,4571,1592,45,3,0,12974,209,997,73,243,1522
SEGOVIA,2021,8,ANTIOQUIA,6767,4574,1589,45,3,0,12978,210,1000,73,243,1526
SEGOVIA,2021,9,ANTIOQUIA,6777,4590,1588,44,3,0,13002,211,996,73,243,1523
SEGOVIA,2022,1,ANTIOQUIA,6838,4641,1590,45,3,0,13117,212,1002,73,243,1530
SEGOVIA,2022,10,ANTIOQUIA,7031,4757,1589,47,2,0,13426,206,1004,72,241,1523
SEGOVIA,2022,11,ANTIOQUIA,7056,4777,1586,48,2,0,13469,209,1002,71,241,1523
SEGOVIA,2022,12,ANTIOQUIA,7069,4787,1588,47,2,0,13493,208,1000,72,241,1521
SEGOVIA,2022,2,ANTIOQUIA,6856,4645,1592,46,3,0,13142,214,1002,73,243,1532
SEGOVIA,2022,3,ANTIOQUIA,6889,4654,1592,45,3,0,13183,213,1003,73,243,1532
SEGOVIA,2022,4,ANTIOQUIA,6905,4676,1597,44,3,0,13225,212,1005,73,242,1532
SEGOVIA,2022,5,ANTIOQUIA,6922,4685,1593,44,3,0,13247,209,1005,73,242,1529
SEGOVIA,2022,6,ANTIOQUIA,6937,4698,1589,43,3,0,13270,210,1003,73,242,1528
SEGOVIA,2022,7,ANTIOQUIA,6995,4715,1583,45,2,0,13340,208,1002,73,242,1525
SEGOVIA,2022,8,ANTIOQUIA,7021,4730,1587,44,2,0,13384,207,1002,73,239,1521
SEGOVIA,2022,9,ANTIOQUIA,7030,4749,1591,45,2,0,13417,206,1001,72,241,1520
SEGOVIA,2023,1,ANTIOQUIA,7107,4808,1589,55,2,0,13561,207,1000,72,241,1520
SEGOVIA,2023,2,ANTIOQUIA,7130,4829,1588,58,2,0,13607,209,1005,72,241,1527
SEGOVIA,2023,3,ANTIOQUIA,7136,4830,1586,56,2,0,13610,208,1004,72,242,1526
SEGOVIA,2023,4,ANTIOQUIA,7163,4851,1589,57,3,0,13663,206,1006,73,242,1527
SEGOVIA,2023,5,ANTIOQUIA,7169,4862,1589,60,3,0,13683,208,1011,72,243,1534
SEGOVIA,2023,6,ANTIOQUIA,7200,4887,1591,61,3,0,13742,209,1015,72,243,1539
SEGOVIA,2023,7,ANTIOQUIA,7228,4896,1590,62,3,0,13779,209,1015,73,244,1541
SEGOVIA,2023,8,ANTIOQUIA,7246,4910,1596,62,3,0,13817,210,1016,73,245,1544
SEGOVIA,2023,9,ANTIOQUIA,7256,4926,1600,62,3,0,13847,210,1015,74,245,1544
SONSON,2018,1,ANTIOQUIA,2653,5928,3226,117,22,9,11955,56,914,197,24,1191
SONSON,2018,10,ANTIOQUIA,2701,6030,3247,118,22,9,12127,63,921,197,24,1205
SONSON,2018,11,ANTIOQUIA,2717,6032,3244,117,22,9,12141,63,922,197,24,1206
SONSON,2018,12,ANTIOQUIA,2724,6046,3239,116,22,9,12156,64,924,197,24,1209
SONSON,2018,2,ANTIOQUIA,2653,5935,3226,117,22,9,11962,57,909,198,24,1188
SONSON,2018,3,ANTIOQUIA,2671,5954,3226,118,22,9,12000,57,912,198,24,1191
SONSON,2018,4,ANTIOQUIA,2672,5963,3229,118,23,9,12014,59,909,198,24,1190
SONSON,2018,5,ANTIOQUIA,2668,5974,3220,118,23,9,12012,61,911,198,24,1194
SONSON,2018,6,ANTIOQUIA,2671,5990,3229,116,23,9,12038,62,918,197,24,1201
SONSON,2018,7,ANTIOQUIA,2679,5999,3234,116,23,9,12060,62,920,197,24,1203
SONSON,2018,8,ANTIOQUIA,2685,6013,3233,116,22,9,12078,62,923,197,24,1206
SONSON,2018,9,ANTIOQUIA,2684,6017,3234,116,22,9,12082,62,921,197,24,1204
SONSON,2019,1,ANTIOQUIA,2730,6066,3242,117,22,9,12186,66,924,198,24,1212
SONSON,2019,10,ANTIOQUIA,2851,6162,3272,129,22,9,12445,67,940,199,24,1230
SONSON,2019,11,ANTIOQUIA,2863,6169,3273,131,22,9,12467,67,939,199,24,1229
SONSON,2019,12,ANTIOQUIA,2881,6192,3276,129,22,9,12509,67,939,199,24,1229
SONSON,2019,2,ANTIOQUIA,2731,6070,3244,116,22,9,12192,65,926,198,24,1213
SONSON,2019,3,ANTIOQUIA,2744,6087,3252,117,22,9,12231,65,926,198,24,1213
SONSON,2019,4,ANTIOQUIA,2745,6084,3258,118,22,9,12236,65,928,198,24,1215
SONSON,2019,5,ANTIOQUIA,2766,6116,3262,121,22,9,12296,65,933,198,24,1220
SONSON,2019,6,ANTIOQUIA,2783,6109,3264,122,22,9,12309,65,934,198,24,1221
SONSON,2019,7,ANTIOQUIA,2794,6128,3266,122,22,9,12341,66,936,198,24,1224
SONSON,2019,8,ANTIOQUIA,2820,6128,3266,129,22,9,12374,67,940,198,24,1229
SONSON,2019,9,ANTIOQUIA,2841,6147,3264,128,22,9,12411,67,941,199,24,1231
SONSON,2020,1,ANTIOQUIA,2879,6184,3278,137,22,9,12509,67,942,199,24,1232
SONSON,2020,10,ANTIOQUIA,2953,6303,3327,127,23,9,12742,70,970,198,180,1418
SONSON,2020,11,ANTIOQUIA,2955,6312,3327,131,23,9,12757,69,973,198,180,1420
SONSON,2020,12,ANTIOQUIA,2961,6328,3323,127,23,9,12771,69,977,198,180,1424
SONSON,2020,2,ANTIOQUIA,2885,6187,3280,138,22,9,12521,70,945,219,180,1414
SONSON,2020,3,ANTIOQUIA,2886,6201,3295,139,22,9,12552,70,947,219,180,1416
SONSON,2020,4,ANTIOQUIA,2891,6206,3306,125,22,9,12559,69,965,199,180,1413
SONSON,2020,5,ANTIOQUIA,2954,6244,3316,136,29,10,12689,66,965,200,180,1411
SONSON,2020,6,ANTIOQUIA,2908,6227,3319,129,23,10,12616,70,963,198,180,1411
SONSON,2020,7,ANTIOQUIA,2913,6250,3324,127,23,9,12646,71,967,199,180,1417
SONSON,2020,8,ANTIOQUIA,2932,6266,3327,127,23,9,12684,71,969,198,180,1418
SONSON,2020,9,ANTIOQUIA,2928,6285,3330,127,23,9,12702,71,968,198,180,1417
SONSON,2021,1,ANTIOQUIA,2969,6339,3323,129,23,9,12792,70,974,198,180,1422
SONSON,2021,10,ANTIOQUIA,3010,6432,3359,132,22,10,12965,70,984,199,180,1433
SONSON,2021,11,ANTIOQUIA,3011,6440,3359,132,22,10,12974,70,984,199,180,1433
SONSON,2021,12,ANTIOQUIA,3015,6443,3359,132,22,10,12981,71,984,199,180,1434
SONSON,2021,2,ANTIOQUIA,2975,6357,3337,127,22,9,12827,71,974,198,180,1423
SONSON,2021,3,ANTIOQUIA,2982,6369,3339,128,22,9,12849,70,976,198,180,1424
SONSON,2021,4,ANTIOQUIA,2988,6388,3338,130,22,9,12875,70,979,198,180,1427
SONSON,2021,5,ANTIOQUIA,2990,6394,3342,130,22,10,12888,69,982,199,180,1430
SONSON,2021,6,ANTIOQUIA,2994,6408,3358,130,22,10,12922,68,983,199,180,1430
SONSON,2021,7,ANTIOQUIA,2999,6414,3357,132,22,10,12934,69,985,199,180,1433
SONSON,2021,8,ANTIOQUIA,3003,6426,3353,132,22,10,12946,70,983,199,180,1432
SONSON,2021,9,ANTIOQUIA,3003,6428,3357,132,22,10,12952,70,984,199,180,1433
SONSON,2022,1,ANTIOQUIA,3014,6451,3363,130,22,10,12990,71,986,200,180,1437
SONSON,2022,10,ANTIOQUIA,3043,6502,3374,119,22,10,13070,66,996,205,180,1447
SONSON,2022,11,ANTIOQUIA,3050,6517,3382,119,22,10,13100,66,1001,205,180,1452
SONSON,2022,12,ANTIOQUIA,3054,6527,3382,118,22,10,13113,66,1003,205,180,1454
SONSON,2022,2,ANTIOQUIA,3017,6462,3369,129,22,10,13009,71,988,200,180,1439
SONSON,2022,3,ANTIOQUIA,3020,6476,3369,129,22,10,13026,68,989,203,179,1439
SONSON,2022,4,ANTIOQUIA,3024,6486,3368,128,22,10,13038,68,988,203,179,1438
SONSON,2022,5,ANTIOQUIA,3018,6507,3386,124,22,10,13067,67,986,203,180,1436
SONSON,2022,6,ANTIOQUIA,3023,6515,3389,119,22,10,13078,67,989,204,180,1440
SONSON,2022,7,ANTIOQUIA,3008,6461,3363,119,22,10,12983,66,992,203,180,1441
SONSON,2022,8,ANTIOQUIA,3026,6485,3362,118,22,10,13023,66,991,203,180,1440
SONSON,2022,9,ANTIOQUIA,3039,6495,3363,119,22,10,13048,67,991,205,180,1443
SONSON,2023,1,ANTIOQUIA,3059,6542,3383,122,22,10,13138,66,1002,205,180,1453
SONSON,2023,2,ANTIOQUIA,3065,6563,3385,124,22,10,13169,67,1004,204,180,1455
SONSON,2023,3,ANTIOQUIA,3075,6579,3392,123,22,10,13201,66,1007,204,181,1458
SONSON,2023,4,ANTIOQUIA,3087,6600,3394,122,22,10,13235,66,1006,204,181,1457
SONSON,2023,5,ANTIOQUIA,3099,6618,3416,120,22,10,13285,65,1007,204,181,1457
SONSON,2023,6,ANTIOQUIA,3105,6639,3420,119,21,10,13314,65,1009,204,181,1459
SONSON,2023,7,ANTIOQUIA,3117,6656,3420,122,21,10,13346,65,1010,204,181,1460
SONSON,2023,8,ANTIOQUIA,3132,6673,3422,122,21,10,13380,66,1009,204,182,1461
SONSON,2023,9,ANTIOQUIA,3139,6688,3435,122,21,10,13415,67,1016,204,182,1469
SOPETRAN,2018,1,ANTIOQUIA,1905,3558,1069,294,185,22,7033,92,347,74,13,526
SOPETRAN,2018,10,ANTIOQUIA,1958,3613,1087,301,186,24,7169,101,351,73,13,538
SOPETRAN,2018,11,ANTIOQUIA,1963,3612,1092,314,184,24,7189,106,349,73,13,541
SOPETRAN,2018,12,ANTIOQUIA,1988,3620,1096,317,183,24,7228,112,353,73,13,551
SOPETRAN,2018,2,ANTIOQUIA,1907,3570,1068,293,185,22,7045,92,346,74,13,525
SOPETRAN,2018,3,ANTIOQUIA,1914,3560,1070,297,186,23,7050,93,349,74,13,529
SOPETRAN,2018,4,ANTIOQUIA,1920,3573,1076,293,186,24,7072,93,351,74,13,531
SOPETRAN,2018,5,ANTIOQUIA,1917,3582,1074,288,184,23,7068,92,351,74,13,530
SOPETRAN,2018,6,ANTIOQUIA,1928,3591,1077,289,184,22,7091,90,350,74,13,527
SOPETRAN,2018,7,ANTIOQUIA,1941,3603,1082,298,185,24,7133,95,351,74,13,533
SOPETRAN,2018,8,ANTIOQUIA,1948,3593,1084,297,185,24,7131,100,353,74,13,540
SOPETRAN,2018,9,ANTIOQUIA,1950,3598,1083,299,185,24,7139,99,350,73,13,535
SOPETRAN,2019,1,ANTIOQUIA,1994,3627,1100,324,181,25,7251,113,352,73,13,551
SOPETRAN,2019,10,ANTIOQUIA,2045,3739,1136,367,195,28,7510,121,358,73,13,565
SOPETRAN,2019,11,ANTIOQUIA,2049,3750,1124,363,178,26,7490,126,358,73,13,570
SOPETRAN,2019,12,ANTIOQUIA,2062,3774,1138,374,196,28,7572,129,359,73,13,574
SOPETRAN,2019,2,ANTIOQUIA,2008,3651,1116,331,197,26,7329,118,350,73,13,554
SOPETRAN,2019,3,ANTIOQUIA,1999,3646,1107,327,180,25,7284,113,351,72,13,549
SOPETRAN,2019,4,ANTIOQUIA,2019,3667,1123,334,195,27,7365,112,351,72,13,548
SOPETRAN,2019,5,ANTIOQUIA,2011,3674,1107,336,179,25,7332,110,355,72,13,550
SOPETRAN,2019,6,ANTIOQUIA,2029,3700,1125,346,195,27,7422,111,356,72,13,552
SOPETRAN,2019,7,ANTIOQUIA,2031,3694,1118,348,178,25,7394,107,358,73,13,551
SOPETRAN,2019,8,ANTIOQUIA,2043,3732,1133,360,195,27,7490,108,357,73,13,551
SOPETRAN,2019,9,ANTIOQUIA,2039,3734,1134,362,194,28,7491,113,359,73,13,558
SOPETRAN,2020,1,ANTIOQUIA,2064,3770,1136,386,196,28,7580,135,358,73,13,579
SOPETRAN,2020,10,ANTIOQUIA,2052,3803,1160,401,205,38,7659,177,379,73,245,874
SOPETRAN,2020,11,ANTIOQUIA,2054,3811,1167,404,205,36,7677,180,380,73,245,878
SOPETRAN,2020,12,ANTIOQUIA,2064,3837,1168,406,204,35,7714,187,383,73,245,888
SOPETRAN,2020,2,ANTIOQUIA,2063,3776,1140,392,196,28,7595,141,357,84,245,827
SOPETRAN,2020,3,ANTIOQUIA,2069,3788,1150,395,196,28,7626,151,358,84,245,838
SOPETRAN,2020,4,ANTIOQUIA,2082,3796,1149,381,197,28,7633,150,370,73,245,838
SOPETRAN,2020,5,ANTIOQUIA,2098,3809,1151,390,198,28,7674,152,372,73,245,842
SOPETRAN,2020,6,ANTIOQUIA,2097,3810,1153,385,197,28,7670,155,371,73,245,844
SOPETRAN,2020,7,ANTIOQUIA,2093,3833,1165,403,202,31,7727,168,381,74,245,868
SOPETRAN,2020,8,ANTIOQUIA,2039,3790,1158,394,206,37,7624,169,378,73,245,865
SOPETRAN,2020,9,ANTIOQUIA,2046,3797,1158,398,206,37,7642,174,379,73,245,871
SOPETRAN,2021,1,ANTIOQUIA,2073,3850,1170,407,203,34,7737,189,386,73,245,893
SOPETRAN,2021,10,ANTIOQUIA,2174,3960,1192,443,206,37,8012,217,397,75,245,934
SOPETRAN,2021,11,ANTIOQUIA,2177,3968,1196,446,205,36,8028,223,398,75,245,941
SOPETRAN,2021,12,ANTIOQUIA,2185,3986,1202,451,208,36,8068,233,411,75,245,964
SOPETRAN,2021,2,ANTIOQUIA,2080,3868,1176,409,205,34,7772,190,389,74,245,898
SOPETRAN,2021,3,ANTIOQUIA,2092,3887,1172,415,204,33,7803,188,390,74,245,897
SOPETRAN,2021,4,ANTIOQUIA,2097,3892,1173,419,204,34,7819,192,390,74,245,901
SOPETRAN,2021,5,ANTIOQUIA,2123,3909,1182,423,205,33,7875,198,391,74,243,906
SOPETRAN,2021,6,ANTIOQUIA,2123,3909,1185,432,204,33,7886,200,390,74,245,909
SOPETRAN,2021,7,ANTIOQUIA,2138,3932,1184,430,205,35,7924,208,389,75,245,917
SOPETRAN,2021,8,ANTIOQUIA,2146,3939,1184,429,207,37,7942,210,392,75,245,922
SOPETRAN,2021,9,ANTIOQUIA,2161,3947,1192,435,205,36,7976,213,393,75,245,926
SOPETRAN,2022,1,ANTIOQUIA,2192,3997,1206,452,208,34,8089,240,413,75,245,973
SOPETRAN,2022,10,ANTIOQUIA,2256,4132,1245,479,208,33,8353,261,435,78,245,1019
SOPETRAN,2022,11,ANTIOQUIA,2260,4151,1235,479,235,33,8393,264,435,78,246,1023
SOPETRAN,2022,12,ANTIOQUIA,2255,4124,1147,411,460,30,8427,263,433,78,246,1020
SOPETRAN,2022,2,ANTIOQUIA,2200,4005,1212,457,208,34,8116,239,412,75,245,971
SOPETRAN,2022,3,ANTIOQUIA,2205,4022,1220,459,207,34,8147,245,415,75,245,980
SOPETRAN,2022,4,ANTIOQUIA,2211,4044,1222,463,206,33,8179,244,416,75,245,980
SOPETRAN,2022,5,ANTIOQUIA,2213,4061,1225,464,207,34,8204,249,416,75,245,985
SOPETRAN,2022,6,ANTIOQUIA,2221,4070,1235,467,207,34,8234,250,430,74,245,999
SOPETRAN,2022,7,ANTIOQUIA,2232,4083,1236,464,207,34,8256,247,427,75,245,994
SOPETRAN,2022,8,ANTIOQUIA,2243,4102,1240,472,207,33,8297,253,430,75,245,1003
SOPETRAN,2022,9,ANTIOQUIA,2245,4117,1243,476,207,33,8321,254,432,77,245,1008
SOPETRAN,2023,1,ANTIOQUIA,2233,4052,1053,262,824,30,8454,266,433,78,247,1024
SOPETRAN,2023,2,ANTIOQUIA,2241,4075,1057,264,818,32,8487,271,436,78,247,1032
SOPETRAN,2023,3,ANTIOQUIA,2260,4093,1059,272,805,32,8521,273,437,78,247,1035
SOPETRAN,2023,4,ANTIOQUIA,2269,4130,1068,280,797,31,8575,279,437,78,247,1041
SOPETRAN,2023,5,ANTIOQUIA,2271,4156,1095,261,797,31,8611,287,439,77,248,1051
SOPETRAN,2023,6,ANTIOQUIA,2290,4180,1103,264,796,31,8664,294,437,76,248,1055
SOPETRAN,2023,7,ANTIOQUIA,2294,4198,1103,267,793,31,8686,299,434,76,249,1058
SOPETRAN,2023,8,ANTIOQUIA,2299,4214,1107,268,793,31,8712,301,435,76,249,1061
SOPETRAN,2023,9,ANTIOQUIA,2307,4230,1111,269,797,31,8745,301,433,80,249,1063
TAMESIS,2018,1,ANTIOQUIA,2144,2053,2028,117,32,50,6424,56,450,96,7,609
TAMESIS,2018,10,ANTIOQUIA,2179,2100,2076,120,31,49,6555,58,452,96,8,614
TAMESIS,2018,11,ANTIOQUIA,2183,2104,2079,121,31,49,6567,60,451,97,7,615
TAMESIS,2018,12,ANTIOQUIA,2187,2111,2081,121,31,49,6580,60,451,97,7,615
TAMESIS,2018,2,ANTIOQUIA,2145,2060,2038,117,32,50,6442,56,449,96,7,608
TAMESIS,2018,3,ANTIOQUIA,2148,2064,2040,117,32,50,6451,57,449,96,7,609
TAMESIS,2018,4,ANTIOQUIA,2150,2071,2044,116,32,50,6463,57,449,96,7,609
TAMESIS,2018,5,ANTIOQUIA,2150,2071,2044,116,32,50,6463,57,449,96,7,609
TAMESIS,2018,6,ANTIOQUIA,2151,2071,2053,116,31,50,6472,58,448,96,7,609
TAMESIS,2018,7,ANTIOQUIA,2157,2075,2057,118,31,50,6488,58,451,96,7,612
TAMESIS,2018,8,ANTIOQUIA,2162,2078,2061,118,31,50,6500,59,450,96,7,612
TAMESIS,2018,9,ANTIOQUIA,2165,2088,2071,120,31,50,6525,57,450,96,7,610
TAMESIS,2019,1,ANTIOQUIA,2189,2115,2089,121,31,49,6594,60,451,97,7,615
TAMESIS,2019,10,ANTIOQUIA,2204,2168,2167,124,31,48,6742,61,471,99,6,637
TAMESIS,2019,11,ANTIOQUIA,2210,2172,2184,125,31,48,6770,61,473,99,6,639
TAMESIS,2019,12,ANTIOQUIA,2218,2180,2187,124,31,48,6788,62,474,99,6,641
TAMESIS,2019,2,ANTIOQUIA,2188,2119,2094,119,31,49,6600,61,454,97,7,619
TAMESIS,2019,3,ANTIOQUIA,2190,2124,2115,118,31,49,6627,60,460,97,7,624
TAMESIS,2019,4,ANTIOQUIA,2190,2132,2121,120,31,49,6643,58,460,97,7,622
TAMESIS,2019,5,ANTIOQUIA,2195,2138,2122,121,31,49,6656,58,463,97,7,625
TAMESIS,2019,6,ANTIOQUIA,2191,2140,2130,121,31,49,6662,59,463,97,7,626
TAMESIS,2019,7,ANTIOQUIA,2191,2141,2135,121,31,48,6667,60,464,98,7,629
TAMESIS,2019,8,ANTIOQUIA,2197,2150,2146,122,31,48,6694,61,470,98,7,636
TAMESIS,2019,9,ANTIOQUIA,2200,2156,2158,124,31,48,6717,61,470,99,6,636
TAMESIS,2020,1,ANTIOQUIA,2214,2178,2193,132,31,48,6796,62,475,99,6,642
TAMESIS,2020,10,ANTIOQUIA,2236,2213,2222,126,31,48,6876,66,489,100,148,803
TAMESIS,2020,11,ANTIOQUIA,2238,2213,2223,126,31,48,6879,66,489,100,148,803
TAMESIS,2020,12,ANTIOQUIA,2244,2222,2226,126,31,48,6897,67,490,101,148,806
TAMESIS,2020,2,ANTIOQUIA,2215,2180,2194,133,31,48,6801,62,472,102,148,784
TAMESIS,2020,3,ANTIOQUIA,2218,2187,2199,133,31,48,6816,64,472,102,148,786
TAMESIS,2020,4,ANTIOQUIA,2221,2191,2206,126,31,48,6823,63,481,99,148,791
TAMESIS,2020,5,ANTIOQUIA,2222,2194,2206,126,31,48,6827,63,481,99,148,791
TAMESIS,2020,6,ANTIOQUIA,2223,2198,2207,126,31,48,6833,63,481,99,148,791
TAMESIS,2020,7,ANTIOQUIA,2225,2202,2214,128,31,48,6848,63,481,99,148,791
TAMESIS,2020,8,ANTIOQUIA,2229,2204,2217,126,31,48,6855,63,481,99,148,791
TAMESIS,2020,9,ANTIOQUIA,2233,2208,2217,126,31,48,6863,66,487,100,148,801
TAMESIS,2021,1,ANTIOQUIA,2247,2224,2219,126,31,48,6895,68,495,101,148,812
TAMESIS,2021,10,ANTIOQUIA,2265,2237,2281,132,31,48,6994,68,498,100,148,814
TAMESIS,2021,11,ANTIOQUIA,2268,2239,2286,131,31,48,7003,69,498,101,148,816
TAMESIS,2021,12,ANTIOQUIA,2271,2246,2288,134,31,48,7018,68,501,101,148,818
TAMESIS,2021,2,ANTIOQUIA,2248,2226,2230,127,31,48,6910,69,495,101,148,813
TAMESIS,2021,3,ANTIOQUIA,2255,2229,2230,131,31,48,6924,69,499,100,148,816
TAMESIS,2021,4,ANTIOQUIA,2258,2228,2234,131,31,48,6930,68,500,101,148,817
TAMESIS,2021,5,ANTIOQUIA,2262,2236,2242,133,31,48,6952,68,498,100,148,814
TAMESIS,2021,6,ANTIOQUIA,2260,2229,2258,132,31,48,6958,68,497,100,148,813
TAMESIS,2021,7,ANTIOQUIA,2261,2232,2263,132,31,48,6967,68,498,100,148,814
TAMESIS,2021,8,ANTIOQUIA,2262,2234,2269,132,31,48,6976,69,497,100,148,814
TAMESIS,2021,9,ANTIOQUIA,2264,2235,2275,134,31,48,6987,67,497,100,148,812
TAMESIS,2022,1,ANTIOQUIA,2274,2248,2290,137,31,48,7028,68,502,101,148,819
TAMESIS,2022,10,ANTIOQUIA,2254,2277,2331,134,33,48,7077,70,505,105,147,827
TAMESIS,2022,11,ANTIOQUIA,2263,2282,2337,132,33,48,7095,69,503,105,147,824
TAMESIS,2022,12,ANTIOQUIA,2270,2287,2341,132,33,48,7111,68,504,105,147,824
TAMESIS,2022,2,ANTIOQUIA,2276,2252,2296,139,31,48,7042,68,502,102,148,820
TAMESIS,2022,3,ANTIOQUIA,2282,2265,2301,140,31,48,7067,65,503,104,147,819
TAMESIS,2022,4,ANTIOQUIA,2283,2269,2310,137,31,48,7078,67,502,105,147,821
TAMESIS,2022,5,ANTIOQUIA,2287,2272,2312,137,31,48,7087,66,502,105,147,820
TAMESIS,2022,6,ANTIOQUIA,2291,2275,2320,135,31,48,7100,66,502,105,147,820
TAMESIS,2022,7,ANTIOQUIA,2295,2278,2328,137,31,48,7117,67,502,105,147,821
TAMESIS,2022,8,ANTIOQUIA,2247,2267,2328,136,33,48,7059,69,501,105,147,822
TAMESIS,2022,9,ANTIOQUIA,2248,2269,2333,137,33,48,7068,69,504,105,147,825
TAMESIS,2023,1,ANTIOQUIA,2271,2289,2345,132,33,48,7118,69,503,106,147,825
TAMESIS,2023,2,ANTIOQUIA,2275,2299,2346,132,33,48,7133,68,505,106,149,828
TAMESIS,2023,3,ANTIOQUIA,2283,2304,2348,133,33,48,7149,68,504,106,149,827
TAMESIS,2023,4,ANTIOQUIA,2285,2308,2359,134,33,48,7167,68,505,107,150,830
TAMESIS,2023,5,ANTIOQUIA,2294,2319,2362,135,33,48,7191,67,507,107,150,831
TAMESIS,2023,6,ANTIOQUIA,2299,2325,2367,136,33,48,7208,66,507,107,150,830
TAMESIS,2023,7,ANTIOQUIA,2301,2328,2368,136,33,48,7214,66,506,107,150,829
TAMESIS,2023,8,ANTIOQUIA,2306,2330,2371,133,35,48,7223,67,506,107,150,830
TAMESIS,2023,9,ANTIOQUIA,2315,2335,2376,133,35,48,7242,69,505,107,152,833
TARAZA,2018,1,ANTIOQUIA,6757,2985,84,42,0,0,9868,37,690,103,24,854
TARAZA,2018,10,ANTIOQUIA,6835,3122,81,53,0,0,10091,36,693,102,22,853
TARAZA,2018,11,ANTIOQUIA,6820,3120,81,54,0,0,10075,36,692,102,23,853
TARAZA,2018,12,ANTIOQUIA,6854,3129,80,57,0,0,10120,36,696,102,23,857
TARAZA,2018,2,ANTIOQUIA,6768,2991,85,42,0,0,9886,36,687,103,23,849
TARAZA,2018,3,ANTIOQUIA,6742,3077,85,42,0,0,9946,37,689,103,23,852
TARAZA,2018,4,ANTIOQUIA,6816,3120,85,43,0,0,10064,37,691,103,23,854
TARAZA,2018,5,ANTIOQUIA,6747,3114,85,45,0,0,9991,36,686,102,22,846
TARAZA,2018,6,ANTIOQUIA,6791,3112,83,45,0,0,10031,36,689,103,23,851
TARAZA,2018,7,ANTIOQUIA,6802,3116,83,46,0,0,10047,36,694,103,23,856
TARAZA,2018,8,ANTIOQUIA,6830,3129,82,50,0,0,10091,36,693,103,23,855
TARAZA,2018,9,ANTIOQUIA,6775,3119,81,50,0,0,10025,36,688,101,22,847
TARAZA,2019,1,ANTIOQUIA,6868,3134,80,57,0,0,10139,35,692,102,23,852
TARAZA,2019,10,ANTIOQUIA,7005,3167,79,62,0,0,10313,34,705,106,24,869
TARAZA,2019,11,ANTIOQUIA,7019,3165,78,62,0,0,10324,34,703,106,24,867
TARAZA,2019,12,ANTIOQUIA,7170,3221,78,62,0,0,10531,35,723,106,24,888
TARAZA,2019,2,ANTIOQUIA,6922,3146,80,57,0,0,10205,35,694,102,23,854
TARAZA,2019,3,ANTIOQUIA,6948,3151,80,56,0,0,10235,34,695,103,23,855
TARAZA,2019,4,ANTIOQUIA,6966,3154,80,57,0,0,10257,34,698,104,23,859
TARAZA,2019,5,ANTIOQUIA,6996,3158,80,57,0,0,10291,34,708,104,24,870
TARAZA,2019,6,ANTIOQUIA,6974,3153,79,57,0,0,10263,34,702,104,24,864
TARAZA,2019,7,ANTIOQUIA,6992,3160,79,57,0,0,10288,34,705,104,24,867
TARAZA,2019,8,ANTIOQUIA,6993,3162,79,57,0,0,10291,34,703,105,24,866
TARAZA,2019,9,ANTIOQUIA,7000,3163,79,60,0,0,10302,34,705,107,23,869
TARAZA,2020,1,ANTIOQUIA,7055,3173,78,61,0,0,10367,33,705,106,24,868
TARAZA,2020,10,ANTIOQUIA,7486,3214,78,64,0,0,10842,34,737,108,233,1112
TARAZA,2020,11,ANTIOQUIA,7526,3216,77,63,0,0,10882,34,741,108,233,1116
TARAZA,2020,12,ANTIOQUIA,7579,3223,77,66,0,0,10945,36,737,110,235,1118
TARAZA,2020,2,ANTIOQUIA,7054,3171,79,61,0,0,10365,33,705,130,235,1103
TARAZA,2020,3,ANTIOQUIA,7064,3172,78,61,0,0,10375,33,705,130,235,1103
TARAZA,2020,4,ANTIOQUIA,7062,3170,78,61,0,0,10371,33,730,107,233,1103
TARAZA,2020,5,ANTIOQUIA,7281,3206,78,61,0,0,10626,34,741,110,232,1117
TARAZA,2020,6,ANTIOQUIA,7335,3200,78,61,0,0,10674,33,735,107,235,1110
TARAZA,2020,7,ANTIOQUIA,7384,3201,78,61,0,0,10724,33,736,107,235,1111
TARAZA,2020,8,ANTIOQUIA,7440,3207,78,62,0,0,10787,33,738,107,233,1111
TARAZA,2020,9,ANTIOQUIA,7433,3208,78,63,0,0,10782,33,736,107,235,1111
TARAZA,2021,1,ANTIOQUIA,7595,3222,79,65,0,0,10961,37,739,110,235,1121
TARAZA,2021,10,ANTIOQUIA,7643,3243,75,69,0,1,11031,39,728,96,236,1099
TARAZA,2021,11,ANTIOQUIA,7462,3203,74,70,0,1,10810,39,717,95,234,1085
TARAZA,2021,12,ANTIOQUIA,7510,3217,74,71,0,1,10873,39,717,95,236,1087
TARAZA,2021,2,ANTIOQUIA,7607,3225,78,66,0,0,10976,38,737,110,233,1118
TARAZA,2021,3,ANTIOQUIA,7624,3230,78,67,0,0,10999,38,734,110,234,1116
TARAZA,2021,4,ANTIOQUIA,7642,3234,77,69,0,0,11022,38,732,110,233,1113
TARAZA,2021,5,ANTIOQUIA,7644,3236,77,69,0,0,11026,38,730,107,233,1108
TARAZA,2021,6,ANTIOQUIA,7643,3245,76,68,0,0,11032,38,733,108,233,1112
TARAZA,2021,7,ANTIOQUIA,7644,3245,75,68,0,0,11032,38,731,100,235,1104
TARAZA,2021,8,ANTIOQUIA,7654,3247,75,68,0,0,11044,38,734,99,234,1105
TARAZA,2021,9,ANTIOQUIA,7626,3242,74,68,0,0,11010,38,731,97,236,1102
TARAZA,2022,1,ANTIOQUIA,7504,3221,74,70,0,1,10870,38,718,95,236,1087
TARAZA,2022,10,ANTIOQUIA,7605,3233,78,71,0,1,10988,37,722,99,233,1091
TARAZA,2022,11,ANTIOQUIA,7616,3233,78,69,0,1,10997,37,727,99,233,1096
TARAZA,2022,12,ANTIOQUIA,7619,3236,77,70,0,1,11003,37,727,99,233,1096
TARAZA,2022,2,ANTIOQUIA,7527,3227,74,71,0,1,10900,37,721,96,235,1089
TARAZA,2022,3,ANTIOQUIA,7544,3227,74,71,0,1,10917,37,721,98,234,1090
TARAZA,2022,4,ANTIOQUIA,7556,3226,74,70,0,1,10927,37,718,98,234,1087
TARAZA,2022,5,ANTIOQUIA,7555,3222,77,71,0,1,10926,37,714,98,233,1082
TARAZA,2022,6,ANTIOQUIA,7559,3222,77,70,0,1,10929,37,715,98,233,1083
TARAZA,2022,7,ANTIOQUIA,7564,3225,77,69,0,1,10936,37,718,98,233,1086
TARAZA,2022,8,ANTIOQUIA,7579,3225,77,71,0,1,10953,37,717,98,233,1085
TARAZA,2022,9,ANTIOQUIA,7592,3228,77,73,0,1,10971,37,718,98,233,1086
TARAZA,2023,1,ANTIOQUIA,7629,3240,77,70,0,1,11017,37,734,99,233,1103
TARAZA,2023,2,ANTIOQUIA,7633,3246,77,71,0,1,11028,37,733,99,233,1102
TARAZA,2023,3,ANTIOQUIA,7632,3244,77,70,0,1,11024,37,735,99,233,1104
TARAZA,2023,4,ANTIOQUIA,7639,3245,77,71,0,1,11033,37,736,99,233,1105
TARAZA,2023,5,ANTIOQUIA,7634,3239,77,71,0,1,11022,37,735,100,233,1105
TARAZA,2023,6,ANTIOQUIA,7486,3225,76,71,0,1,10859,37,724,100,233,1094
TARAZA,2023,7,ANTIOQUIA,7507,3215,74,70,0,1,10867,37,724,99,233,1093
TARAZA,2023,8,ANTIOQUIA,7494,3211,74,67,0,1,10847,37,744,99,233,1113
TARAZA,2023,9,ANTIOQUIA,7443,3206,73,68,0,1,10791,37,746,99,233,1115
TARSO,2018,1,ANTIOQUIA,642,1056,309,88,36,16,2147,36,138,40,3,217
TARSO,2018,10,ANTIOQUIA,653,1076,308,92,36,17,2182,40,137,40,3,220
TARSO,2018,11,ANTIOQUIA,655,1074,307,92,36,17,2181,40,138,40,3,221
TARSO,2018,12,ANTIOQUIA,654,1076,309,92,36,17,2184,40,137,40,3,220
TARSO,2018,2,ANTIOQUIA,641,1059,308,88,36,16,2148,37,138,40,3,218
TARSO,2018,3,ANTIOQUIA,641,1060,308,88,36,16,2149,38,138,40,3,219
TARSO,2018,4,ANTIOQUIA,640,1064,307,89,36,16,2152,39,138,40,3,220
TARSO,2018,5,ANTIOQUIA,641,1062,307,89,36,16,2151,39,136,40,3,218
TARSO,2018,6,ANTIOQUIA,647,1070,307,89,36,17,2166,39,137,40,3,219
TARSO,2018,7,ANTIOQUIA,649,1070,307,89,36,17,2168,40,137,40,3,220
TARSO,2018,8,ANTIOQUIA,652,1072,307,90,36,17,2174,41,137,40,3,221
TARSO,2018,9,ANTIOQUIA,653,1074,307,91,36,17,2178,41,137,40,3,221
TARSO,2019,1,ANTIOQUIA,658,1077,309,93,36,17,2190,40,136,40,3,219
TARSO,2019,10,ANTIOQUIA,671,1091,310,105,36,17,2230,40,137,40,3,220
TARSO,2019,11,ANTIOQUIA,675,1092,310,105,36,17,2235,40,138,40,3,221
TARSO,2019,12,ANTIOQUIA,678,1096,311,105,36,17,2243,40,138,40,3,221
TARSO,2019,2,ANTIOQUIA,659,1079,309,93,36,17,2193,40,136,40,3,219
TARSO,2019,3,ANTIOQUIA,658,1082,309,94,36,17,2196,40,136,40,3,219
TARSO,2019,4,ANTIOQUIA,659,1083,309,94,36,17,2198,40,135,40,3,218
TARSO,2019,5,ANTIOQUIA,663,1083,309,95,36,17,2203,40,136,40,3,219
TARSO,2019,6,ANTIOQUIA,662,1084,309,102,36,17,2210,40,135,40,3,218
TARSO,2019,7,ANTIOQUIA,664,1085,309,103,36,17,2214,41,135,40,3,219
TARSO,2019,8,ANTIOQUIA,667,1084,311,104,36,17,2219,40,135,40,3,218
TARSO,2019,9,ANTIOQUIA,670,1085,310,105,36,17,2223,39,137,40,3,219
TARSO,2020,1,ANTIOQUIA,677,1095,310,105,36,17,2240,40,138,40,3,221
TARSO,2020,10,ANTIOQUIA,687,1105,308,106,37,18,2261,45,146,41,50,282
TARSO,2020,11,ANTIOQUIA,688,1109,307,106,37,18,2265,45,149,41,50,285
TARSO,2020,12,ANTIOQUIA,689,1109,307,106,37,18,2266,45,149,41,50,285
TARSO,2020,2,ANTIOQUIA,679,1095,310,107,37,17,2245,44,137,41,50,272
TARSO,2020,3,ANTIOQUIA,680,1097,310,107,37,17,2248,44,138,41,50,273
TARSO,2020,4,ANTIOQUIA,683,1099,310,105,37,17,2251,42,138,41,50,271
TARSO,2020,5,ANTIOQUIA,684,1098,310,105,37,17,2251,45,138,41,50,274
TARSO,2020,6,ANTIOQUIA,683,1101,312,105,37,18,2256,45,138,41,50,274
TARSO,2020,7,ANTIOQUIA,685,1101,312,105,37,18,2258,45,138,41,50,274
TARSO,2020,8,ANTIOQUIA,686,1101,312,106,37,18,2260,45,138,41,50,274
TARSO,2020,9,ANTIOQUIA,686,1101,308,106,37,18,2256,45,145,41,50,281
TARSO,2021,1,ANTIOQUIA,689,1112,306,106,37,18,2268,45,149,41,50,285
TARSO,2021,10,ANTIOQUIA,703,1124,305,112,37,18,2299,45,154,42,50,291
TARSO,2021,11,ANTIOQUIA,704,1145,306,113,37,18,2323,45,154,42,50,291
TARSO,2021,12,ANTIOQUIA,705,1149,307,113,37,18,2329,45,154,42,50,291
TARSO,2021,2,ANTIOQUIA,691,1115,305,106,37,18,2272,44,149,41,50,284
TARSO,2021,3,ANTIOQUIA,692,1116,305,106,37,18,2274,45,149,41,50,285
TARSO,2021,4,ANTIOQUIA,694,1116,305,106,37,18,2276,45,149,41,50,285
TARSO,2021,5,ANTIOQUIA,696,1118,305,107,37,18,2281,45,150,41,50,286
TARSO,2021,6,ANTIOQUIA,695,1120,306,106,37,18,2282,45,150,41,50,286
TARSO,2021,7,ANTIOQUIA,695,1124,306,106,37,18,2286,45,150,42,50,287
TARSO,2021,8,ANTIOQUIA,697,1123,306,111,37,18,2292,45,153,42,50,290
TARSO,2021,9,ANTIOQUIA,701,1122,305,112,37,18,2295,45,154,42,50,291
TARSO,2022,1,ANTIOQUIA,705,1151,308,113,37,18,2332,46,154,42,50,292
TARSO,2022,10,ANTIOQUIA,704,1151,314,111,37,18,2335,41,154,45,50,290
TARSO,2022,11,ANTIOQUIA,704,1152,314,111,37,18,2336,41,154,45,50,290
TARSO,2022,12,ANTIOQUIA,704,1153,314,111,37,18,2337,41,154,45,50,290
TARSO,2022,2,ANTIOQUIA,705,1153,308,114,37,18,2335,46,155,42,50,293
TARSO,2022,3,ANTIOQUIA,706,1154,311,115,37,18,2341,43,153,44,50,290
TARSO,2022,4,ANTIOQUIA,705,1159,310,116,37,18,2345,42,153,44,50,289
TARSO,2022,5,ANTIOQUIA,706,1162,310,116,37,18,2349,42,153,44,50,289
TARSO,2022,6,ANTIOQUIA,707,1163,310,116,37,18,2351,42,154,45,50,291
TARSO,2022,7,ANTIOQUIA,710,1168,310,117,37,18,2360,42,154,45,50,291
TARSO,2022,8,ANTIOQUIA,703,1144,307,118,37,18,2327,42,153,45,50,290
TARSO,2022,9,ANTIOQUIA,703,1147,308,117,37,18,2330,41,153,45,50,289
TARSO,2023,1,ANTIOQUIA,705,1156,314,111,37,18,2341,41,154,45,50,290
TARSO,2023,2,ANTIOQUIA,706,1160,315,111,37,18,2347,42,154,45,50,291
TARSO,2023,3,ANTIOQUIA,706,1163,315,111,37,18,2350,42,154,45,50,291
TARSO,2023,4,ANTIOQUIA,711,1163,315,111,37,18,2355,42,154,45,50,291
TARSO,2023,5,ANTIOQUIA,711,1163,316,111,37,18,2356,41,154,45,51,291
TARSO,2023,6,ANTIOQUIA,711,1169,317,111,37,18,2363,43,153,45,51,292
TARSO,2023,7,ANTIOQUIA,711,1171,317,110,37,18,2364,43,153,45,51,292
TARSO,2023,8,ANTIOQUIA,713,1175,317,110,37,18,2370,43,153,45,51,292
TARSO,2023,9,ANTIOQUIA,712,1174,317,111,37,18,2369,43,153,45,51,292
TITIRIBI,2018,1,ANTIOQUIA,977,2119,397,101,38,73,3705,56,249,51,4,360
TITIRIBI,2018,10,ANTIOQUIA,984,2140,397,101,39,75,3736,57,247,51,5,360
TITIRIBI,2018,11,ANTIOQUIA,984,2138,398,101,39,75,3735,55,247,51,4,357
TITIRIBI,2018,12,ANTIOQUIA,984,2140,397,104,38,75,3738,55,248,51,4,358
TITIRIBI,2018,2,ANTIOQUIA,976,2120,397,101,38,72,3704,57,248,51,4,360
TITIRIBI,2018,3,ANTIOQUIA,975,2124,397,101,38,73,3708,56,247,51,4,358
TITIRIBI,2018,4,ANTIOQUIA,977,2125,397,101,38,73,3711,56,247,51,4,358
TITIRIBI,2018,5,ANTIOQUIA,975,2128,395,101,38,74,3711,56,247,51,4,358
TITIRIBI,2018,6,ANTIOQUIA,976,2128,396,101,38,74,3713,55,247,51,4,357
TITIRIBI,2018,7,ANTIOQUIA,981,2128,396,101,38,74,3718,55,247,51,4,357
TITIRIBI,2018,8,ANTIOQUIA,982,2133,397,101,39,74,3726,57,247,51,4,359
TITIRIBI,2018,9,ANTIOQUIA,982,2137,396,101,39,74,3729,57,247,51,4,359
TITIRIBI,2019,1,ANTIOQUIA,986,2137,397,104,38,75,3737,54,249,51,4,358
TITIRIBI,2019,10,ANTIOQUIA,996,2166,395,105,39,75,3776,55,246,50,4,355
TITIRIBI,2019,11,ANTIOQUIA,996,2167,395,105,39,76,3778,56,245,50,4,355
TITIRIBI,2019,12,ANTIOQUIA,999,2174,395,106,39,76,3789,56,245,50,4,355
TITIRIBI,2019,2,ANTIOQUIA,986,2140,396,105,38,75,3740,54,248,51,4,357
TITIRIBI,2019,3,ANTIOQUIA,987,2140,396,105,38,75,3741,54,248,51,4,357
TITIRIBI,2019,4,ANTIOQUIA,988,2141,396,105,38,75,3743,54,248,51,4,357
TITIRIBI,2019,5,ANTIOQUIA,991,2143,396,107,38,75,3750,53,247,51,4,355
TITIRIBI,2019,6,ANTIOQUIA,988,2149,395,106,38,75,3751,53,247,50,4,354
TITIRIBI,2019,7,ANTIOQUIA,989,2148,395,105,39,75,3751,54,247,50,4,355
TITIRIBI,2019,8,ANTIOQUIA,988,2152,396,105,39,75,3755,55,248,50,4,357
TITIRIBI,2019,9,ANTIOQUIA,991,2157,396,105,39,75,3763,56,247,50,4,357
TITIRIBI,2020,1,ANTIOQUIA,998,2171,395,106,39,76,3785,56,245,50,4,355
TITIRIBI,2020,10,ANTIOQUIA,1009,2195,399,105,38,76,3822,61,248,50,159,518
TITIRIBI,2020,11,ANTIOQUIA,1010,2198,398,106,38,76,3826,63,250,50,159,522
TITIRIBI,2020,12,ANTIOQUIA,1012,2207,402,105,38,76,3840,62,251,50,159,522
TITIRIBI,2020,2,ANTIOQUIA,999,2173,395,110,39,76,3792,61,245,52,159,517
TITIRIBI,2020,3,ANTIOQUIA,1000,2173,396,110,39,76,3794,61,245,52,159,517
TITIRIBI,2020,4,ANTIOQUIA,1003,2176,395,103,39,76,3792,61,248,50,159,518
TITIRIBI,2020,5,ANTIOQUIA,1004,2178,395,103,39,76,3795,60,248,50,159,517
TITIRIBI,2020,6,ANTIOQUIA,1004,2179,395,104,39,76,3797,60,248,50,159,517
TITIRIBI,2020,7,ANTIOQUIA,1005,2177,401,104,38,76,3801,60,247,50,159,516
TITIRIBI,2020,8,ANTIOQUIA,1012,2196,400,104,38,76,3826,61,246,50,159,516
TITIRIBI,2020,9,ANTIOQUIA,1008,2195,399,105,38,76,3821,61,247,50,159,517
TITIRIBI,2021,1,ANTIOQUIA,1014,2207,401,104,38,76,3840,63,250,50,159,522
TITIRIBI,2021,10,ANTIOQUIA,1086,1981,583,117,38,77,3882,69,244,51,159,523
TITIRIBI,2021,11,ANTIOQUIA,1087,1987,583,117,38,77,3889,70,244,51,159,524
TITIRIBI,2021,12,ANTIOQUIA,1091,1998,579,116,38,77,3899,74,244,51,159,528
TITIRIBI,2021,2,ANTIOQUIA,1017,2215,401,105,38,77,3853,64,249,50,159,522
TITIRIBI,2021,3,ANTIOQUIA,1018,2217,401,106,38,77,3857,64,248,50,159,521
TITIRIBI,2021,4,ANTIOQUIA,1027,2215,399,106,38,77,3862,65,247,50,159,521
TITIRIBI,2021,5,ANTIOQUIA,1080,1946,602,123,38,77,3866,65,247,50,158,520
TITIRIBI,2021,6,ANTIOQUIA,1081,1952,597,121,38,77,3866,65,246,50,159,520
TITIRIBI,2021,7,ANTIOQUIA,1083,1957,595,121,38,77,3871,65,245,50,159,519
TITIRIBI,2021,8,ANTIOQUIA,1083,1962,594,119,38,77,3873,65,246,50,159,520
TITIRIBI,2021,9,ANTIOQUIA,1084,1972,587,118,38,77,3876,64,245,51,159,519
TITIRIBI,2022,1,ANTIOQUIA,1093,2003,573,118,38,77,3902,74,245,50,159,528
TITIRIBI,2022,10,ANTIOQUIA,1114,2033,565,117,38,77,3944,74,267,50,159,550
TITIRIBI,2022,11,ANTIOQUIA,1115,2035,565,118,38,77,3948,74,266,50,159,549
TITIRIBI,2022,12,ANTIOQUIA,1114,2037,565,118,38,77,3949,74,266,50,159,549
TITIRIBI,2022,2,ANTIOQUIA,1095,2004,571,118,38,77,3903,74,245,50,159,528
TITIRIBI,2022,3,ANTIOQUIA,1100,2010,571,118,38,77,3914,74,248,49,158,529
TITIRIBI,2022,4,ANTIOQUIA,1102,2017,568,116,38,77,3918,74,272,49,158,553
TITIRIBI,2022,5,ANTIOQUIA,1103,2019,568,115,38,77,3920,74,272,49,158,553
TITIRIBI,2022,6,ANTIOQUIA,1107,2017,567,116,38,77,3922,75,274,49,159,557
TITIRIBI,2022,7,ANTIOQUIA,1109,2018,570,116,38,77,3928,75,270,50,159,554
TITIRIBI,2022,8,ANTIOQUIA,1109,2019,569,117,38,77,3929,76,266,50,159,551
TITIRIBI,2022,9,ANTIOQUIA,1109,2025,569,117,38,77,3935,75,266,50,159,550
TITIRIBI,2023,1,ANTIOQUIA,1113,2039,563,118,38,76,3947,74,266,50,159,549
TITIRIBI,2023,2,ANTIOQUIA,1116,2041,561,118,38,76,3950,74,266,50,159,549
TITIRIBI,2023,3,ANTIOQUIA,1118,2045,560,119,38,76,3956,73,267,50,159,549
TITIRIBI,2023,4,ANTIOQUIA,1120,2051,560,119,38,76,3964,82,267,50,159,558
TITIRIBI,2023,5,ANTIOQUIA,1126,2052,560,121,38,76,3973,75,266,50,159,550
TITIRIBI,2023,6,ANTIOQUIA,1122,2053,559,117,38,76,3965,75,264,50,159,548
TITIRIBI,2023,7,ANTIOQUIA,1127,2058,559,117,39,76,3976,72,263,50,159,544
TITIRIBI,2023,8,ANTIOQUIA,1127,2067,559,116,39,76,3984,79,264,50,159,552
TITIRIBI,2023,9,ANTIOQUIA,1127,2071,560,116,39,76,3989,75,263,50,159,547
TOLEDO,2018,1,ANTIOQUIA,1135,813,213,25,0,0,2186,13,188,44,4,249
TOLEDO,2018,10,ANTIOQUIA,1145,835,210,25,0,0,2215,14,190,47,3,254
TOLEDO,2018,11,ANTIOQUIA,1148,835,210,25,0,0,2218,14,193,47,2,256
TOLEDO,2018,12,ANTIOQUIA,1149,838,210,24,0,0,2221,14,193,47,2,256
TOLEDO,2018,2,ANTIOQUIA,1136,813,213,25,0,0,2187,14,188,44,3,249
TOLEDO,2018,3,ANTIOQUIA,1139,812,212,25,0,0,2188,14,189,44,3,250
TOLEDO,2018,4,ANTIOQUIA,1139,816,212,25,0,0,2192,14,190,44,3,251
TOLEDO,2018,5,ANTIOQUIA,1138,810,212,24,0,0,2184,14,191,47,3,255
TOLEDO,2018,6,ANTIOQUIA,1139,815,212,23,0,0,2189,14,191,47,3,255
TOLEDO,2018,7,ANTIOQUIA,1140,818,211,23,0,0,2192,14,191,47,3,255
TOLEDO,2018,8,ANTIOQUIA,1142,825,212,23,0,0,2202,14,190,47,3,254
TOLEDO,2018,9,ANTIOQUIA,1140,832,211,25,0,0,2208,14,189,47,3,253
TOLEDO,2019,1,ANTIOQUIA,1150,841,210,24,0,0,2225,14,192,47,2,255
TOLEDO,2019,10,ANTIOQUIA,1189,867,210,33,0,0,2299,12,193,49,2,256
TOLEDO,2019,11,ANTIOQUIA,1195,872,211,33,0,0,2311,12,193,49,2,256
TOLEDO,2019,12,ANTIOQUIA,1201,873,212,33,0,0,2319,12,195,50,2,259
TOLEDO,2019,2,ANTIOQUIA,1154,846,211,24,0,0,2235,14,192,47,2,255
TOLEDO,2019,3,ANTIOQUIA,1156,849,211,24,0,0,2240,13,193,47,2,255
TOLEDO,2019,4,ANTIOQUIA,1157,851,212,25,0,0,2245,14,193,47,2,256
TOLEDO,2019,5,ANTIOQUIA,1186,863,213,25,0,0,2287,15,193,47,2,257
TOLEDO,2019,6,ANTIOQUIA,1162,853,211,26,0,0,2252,14,192,47,2,255
TOLEDO,2019,7,ANTIOQUIA,1161,860,212,25,0,0,2258,13,193,47,2,255
TOLEDO,2019,8,ANTIOQUIA,1161,862,212,25,0,0,2260,13,193,47,2,255
TOLEDO,2019,9,ANTIOQUIA,1163,866,211,29,0,0,2269,12,193,49,2,256
TOLEDO,2020,1,ANTIOQUIA,1198,872,210,33,0,0,2313,12,194,50,2,258
TOLEDO,2020,10,ANTIOQUIA,1234,878,211,29,0,0,2352,13,192,50,23,278
TOLEDO,2020,11,ANTIOQUIA,1236,882,211,30,0,0,2359,13,192,50,23,278
TOLEDO,2020,12,ANTIOQUIA,1242,885,211,28,0,0,2366,13,191,50,23,277
TOLEDO,2020,2,ANTIOQUIA,1202,871,209,33,0,0,2315,14,194,50,23,281
TOLEDO,2020,3,ANTIOQUIA,1204,871,209,33,0,0,2317,14,194,50,23,281
TOLEDO,2020,4,ANTIOQUIA,1212,869,209,29,0,0,2319,12,194,50,23,279
TOLEDO,2020,5,ANTIOQUIA,1224,872,210,28,0,0,2334,12,194,50,23,279
TOLEDO,2020,6,ANTIOQUIA,1226,872,211,28,0,0,2337,12,194,50,23,279
TOLEDO,2020,7,ANTIOQUIA,1229,874,211,28,0,0,2342,14,194,50,23,281
TOLEDO,2020,8,ANTIOQUIA,1232,874,211,28,0,0,2345,13,194,50,23,280
TOLEDO,2020,9,ANTIOQUIA,1230,875,211,29,0,0,2345,13,192,50,23,278
TOLEDO,2021,1,ANTIOQUIA,1245,886,211,26,0,0,2368,13,192,50,23,278
TOLEDO,2021,10,ANTIOQUIA,1270,909,205,25,0,0,2409,13,186,50,23,272
TOLEDO,2021,11,ANTIOQUIA,1273,914,205,23,0,0,2415,13,186,50,1,250
TOLEDO,2021,12,ANTIOQUIA,1281,919,206,23,0,0,2429,13,190,50,2,255
TOLEDO,2021,2,ANTIOQUIA,1247,888,211,27,0,0,2373,13,192,50,23,278
TOLEDO,2021,3,ANTIOQUIA,1253,890,209,27,0,0,2379,13,191,50,23,277
TOLEDO,2021,4,ANTIOQUIA,1256,890,209,26,0,0,2381,13,191,50,23,277
TOLEDO,2021,5,ANTIOQUIA,1258,894,209,26,0,0,2387,13,189,50,23,275
TOLEDO,2021,6,ANTIOQUIA,1256,900,207,26,0,0,2389,13,188,50,23,274
TOLEDO,2021,7,ANTIOQUIA,1261,902,208,26,0,0,2397,13,187,50,23,273
TOLEDO,2021,8,ANTIOQUIA,1266,905,207,25,0,0,2403,13,188,50,23,274
TOLEDO,2021,9,ANTIOQUIA,1267,910,205,24,0,0,2406,13,188,50,23,274
TOLEDO,2022,1,ANTIOQUIA,1287,922,206,22,0,0,2437,13,190,50,23,276
TOLEDO,2022,10,ANTIOQUIA,1323,928,188,21,0,0,2460,12,189,50,23,274
TOLEDO,2022,11,ANTIOQUIA,1325,929,187,21,0,0,2462,12,189,50,23,274
TOLEDO,2022,12,ANTIOQUIA,1328,929,187,20,0,0,2464,13,192,50,23,278
TOLEDO,2022,2,ANTIOQUIA,1293,922,207,22,0,0,2444,13,192,50,23,278
TOLEDO,2022,3,ANTIOQUIA,1300,925,207,21,0,0,2453,12,193,51,23,279
TOLEDO,2022,4,ANTIOQUIA,1304,926,204,21,0,0,2455,12,193,51,23,279
TOLEDO,2022,5,ANTIOQUIA,1303,925,205,22,0,0,2455,12,191,51,23,277
TOLEDO,2022,6,ANTIOQUIA,1312,929,201,22,0,0,2464,12,191,51,23,277
TOLEDO,2022,7,ANTIOQUIA,1301,919,191,22,0,0,2433,12,190,50,23,275
TOLEDO,2022,8,ANTIOQUIA,1310,922,191,21,0,0,2444,12,190,50,23,275
TOLEDO,2022,9,ANTIOQUIA,1318,924,190,21,0,0,2453,12,190,50,23,275
TOLEDO,2023,1,ANTIOQUIA,1333,930,187,20,0,0,2470,12,192,50,23,277
TOLEDO,2023,2,ANTIOQUIA,1335,932,187,20,0,0,2474,12,192,49,23,276
TOLEDO,2023,3,ANTIOQUIA,1338,933,186,20,0,0,2477,13,193,49,23,278
TOLEDO,2023,4,ANTIOQUIA,1338,933,186,20,0,0,2477,13,193,49,23,278
TOLEDO,2023,5,ANTIOQUIA,1339,935,186,21,0,0,2481,13,193,50,23,279
TOLEDO,2023,6,ANTIOQUIA,1337,935,186,20,0,0,2478,13,193,49,23,278
TOLEDO,2023,7,ANTIOQUIA,1338,936,184,20,0,0,2478,13,192,49,23,277
TOLEDO,2023,8,ANTIOQUIA,1336,936,184,19,0,0,2475,12,195,49,23,279
TOLEDO,2023,9,ANTIOQUIA,1339,937,184,19,0,0,2479,13,194,49,23,279
TURBO,2018,1,ANTIOQUIA,27338,8593,2419,110,0,1,38461,188,2259,293,34,2774
TURBO,2018,10,ANTIOQUIA,28113,8780,2470,127,0,1,39491,196,2243,285,36,2760
TURBO,2018,11,ANTIOQUIA,28031,8762,2469,125,0,1,39388,196,2247,284,36,2763
TURBO,2018,12,ANTIOQUIA,28196,8775,2472,127,0,1,39571,196,2251,285,37,2769
TURBO,2018,2,ANTIOQUIA,27424,8604,2425,120,0,1,38574,185,2235,292,36,2748
TURBO,2018,3,ANTIOQUIA,27440,8619,2420,118,0,1,38598,184,2249,292,36,2761
TURBO,2018,4,ANTIOQUIA,27675,8671,2441,120,0,1,38908,187,2257,293,37,2774
TURBO,2018,5,ANTIOQUIA,27491,8641,2430,122,0,1,38685,185,2232,288,36,2741
TURBO,2018,6,ANTIOQUIA,27640,8672,2435,124,0,1,38872,188,2230,289,36,2743
TURBO,2018,7,ANTIOQUIA,27781,8707,2450,125,0,1,39064,189,2245,290,37,2761
TURBO,2018,8,ANTIOQUIA,27933,8744,2466,127,0,1,39271,189,2255,290,37,2771
TURBO,2018,9,ANTIOQUIA,27842,8738,2465,126,0,1,39172,190,2236,285,36,2747
TURBO,2019,1,ANTIOQUIA,28217,8793,2474,133,0,1,39618,198,2258,286,36,2778
TURBO,2019,10,ANTIOQUIA,29650,9033,2517,143,0,1,41344,201,2338,283,39,2861
TURBO,2019,11,ANTIOQUIA,29761,9054,2534,162,0,1,41512,203,2362,277,40,2882
TURBO,2019,12,ANTIOQUIA,30174,9142,2560,175,0,1,42052,208,2429,278,40,2955
TURBO,2019,2,ANTIOQUIA,28409,8855,2480,133,0,1,39878,198,2259,285,36,2778
TURBO,2019,3,ANTIOQUIA,28509,8885,2479,136,0,1,40010,200,2260,286,36,2782
TURBO,2019,4,ANTIOQUIA,28656,8896,2479,137,0,1,40169,201,2269,288,37,2795
TURBO,2019,5,ANTIOQUIA,28780,8919,2477,138,0,1,40315,202,2272,286,38,2798
TURBO,2019,6,ANTIOQUIA,28860,8929,2474,141,0,1,40405,200,2280,288,37,2805
TURBO,2019,7,ANTIOQUIA,29064,8955,2482,136,0,1,40638,201,2294,288,37,2820
TURBO,2019,8,ANTIOQUIA,29272,8975,2499,138,0,1,40885,202,2310,288,37,2837
TURBO,2019,9,ANTIOQUIA,29478,9011,2509,138,0,1,41137,203,2329,286,38,2856
TURBO,2020,1,ANTIOQUIA,29994,9078,2541,339,0,1,41953,206,2383,276,38,2903
TURBO,2020,10,ANTIOQUIA,31188,9247,2540,242,0,1,43218,211,2550,275,966,4002
TURBO,2020,11,ANTIOQUIA,31351,9266,2540,243,0,1,43401,212,2579,278,966,4035
TURBO,2020,12,ANTIOQUIA,31786,9326,2546,207,0,1,43866,213,2591,277,966,4047
TURBO,2020,2,ANTIOQUIA,30063,9058,2497,350,0,1,41969,206,2381,312,966,3865
TURBO,2020,3,ANTIOQUIA,30198,9084,2499,362,0,1,42144,207,2389,302,966,3864
TURBO,2020,4,ANTIOQUIA,30442,9137,2511,165,0,1,42256,204,2490,264,966,3924
TURBO,2020,5,ANTIOQUIA,30705,9166,2514,173,0,1,42559,204,2511,270,966,3951
TURBO,2020,6,ANTIOQUIA,30774,9185,2516,172,0,1,42648,205,2506,269,966,3946
TURBO,2020,7,ANTIOQUIA,30799,9194,2523,180,0,1,42697,207,2518,271,966,3962
TURBO,2020,8,ANTIOQUIA,31016,9215,2530,246,0,1,43008,208,2514,273,966,3961
TURBO,2020,9,ANTIOQUIA,31122,9229,2535,240,0,1,43127,208,2531,275,966,3980
TURBO,2021,1,ANTIOQUIA,32029,9365,2562,206,0,1,44163,214,2601,279,966,4060
TURBO,2021,10,ANTIOQUIA,33010,9705,2605,279,0,1,45600,209,2734,281,966,4190
TURBO,2021,11,ANTIOQUIA,33138,9754,2602,273,0,1,45768,209,2759,281,966,4215
TURBO,2021,12,ANTIOQUIA,33517,9803,2612,265,0,1,46198,208,2794,282,965,4249
TURBO,2021,2,ANTIOQUIA,32159,9392,2564,206,0,1,44322,214,2620,288,966,4088
TURBO,2021,3,ANTIOQUIA,32357,9427,2567,220,0,1,44572,215,2640,288,966,4109
TURBO,2021,4,ANTIOQUIA,32515,9457,2571,278,0,1,44822,212,2656,289,966,4123
TURBO,2021,5,ANTIOQUIA,32467,9481,2573,308,0,1,44830,211,2661,284,964,4120
TURBO,2021,6,ANTIOQUIA,32494,9490,2572,309,0,1,44866,211,2672,281,966,4130
TURBO,2021,7,ANTIOQUIA,32617,9563,2587,324,0,1,45092,210,2675,283,966,4134
TURBO,2021,8,ANTIOQUIA,32717,9605,2592,316,0,1,45231,211,2700,284,965,4160
TURBO,2021,9,ANTIOQUIA,32810,9655,2596,287,0,1,45349,210,2709,282,966,4167
TURBO,2022,1,ANTIOQUIA,33697,9830,2631,264,0,1,46423,208,2822,279,965,4274
TURBO,2022,10,ANTIOQUIA,34989,10075,2649,251,0,1,47965,215,2963,279,970,4427
TURBO,2022,11,ANTIOQUIA,35109,10107,2652,251,0,1,48120,214,2971,281,971,4437
TURBO,2022,12,ANTIOQUIA,35280,10137,2653,253,0,1,48324,215,2981,281,971,4448
TURBO,2022,2,ANTIOQUIA,33858,9870,2637,251,0,1,46617,208,2845,279,965,4297
TURBO,2022,3,ANTIOQUIA,34005,9901,2647,240,0,1,46794,205,2854,279,964,4302
TURBO,2022,4,ANTIOQUIA,34131,9936,2656,243,0,1,46967,208,2875,279,964,4326
TURBO,2022,5,ANTIOQUIA,34233,9938,2649,239,0,1,47060,208,2868,279,968,4323
TURBO,2022,6,ANTIOQUIA,34403,9968,2652,243,0,1,47267,208,2888,280,968,4344
TURBO,2022,7,ANTIOQUIA,34548,10006,2658,244,0,1,47457,211,2906,280,968,4365
TURBO,2022,8,ANTIOQUIA,34744,10022,2644,245,0,1,47656,211,2925,280,968,4384
TURBO,2022,9,ANTIOQUIA,34874,10051,2644,251,0,1,47821,214,2946,280,967,4407
TURBO,2023,1,ANTIOQUIA,35526,10178,2655,254,0,1,48614,214,2993,281,971,4459
TURBO,2023,2,ANTIOQUIA,35770,10228,2656,253,0,1,48908,215,3016,281,971,4483
TURBO,2023,3,ANTIOQUIA,36019,10220,2658,268,0,1,49166,214,3034,281,971,4500
TURBO,2023,4,ANTIOQUIA,36162,10244,2662,298,0,1,49367,217,3051,281,971,4520
TURBO,2023,5,ANTIOQUIA,36333,10265,2663,310,0,1,49572,215,3061,282,972,4530
TURBO,2023,6,ANTIOQUIA,36462,10282,2665,296,0,1,49706,217,3059,282,972,4530
TURBO,2023,7,ANTIOQUIA,36670,10292,2660,265,0,1,49888,217,3052,282,973,4524
TURBO,2023,8,ANTIOQUIA,36860,10304,2658,251,0,1,50074,219,3074,283,976,4552
TURBO,2023,9,ANTIOQUIA,36920,10298,2651,260,0,1,50130,218,3076,283,977,4554
URAMITA,2018,1,ANTIOQUIA,1262,1242,56,1,1,1,2563,12,98,61,8,179
URAMITA,2018,10,ANTIOQUIA,1350,1250,55,1,1,1,2658,13,100,62,8,183
URAMITA,2018,11,ANTIOQUIA,1351,1252,55,1,1,1,2661,13,100,62,8,183
URAMITA,2018,12,ANTIOQUIA,1351,1253,55,1,1,1,2662,13,100,62,8,183
URAMITA,2018,2,ANTIOQUIA,1265,1243,56,1,1,1,2567,12,98,61,8,179
URAMITA,2018,3,ANTIOQUIA,1288,1242,56,1,1,1,2589,12,98,61,8,179
URAMITA,2018,4,ANTIOQUIA,1321,1246,55,1,1,1,2625,12,98,61,8,179
URAMITA,2018,5,ANTIOQUIA,1320,1245,55,1,1,1,2623,12,98,61,8,179
URAMITA,2018,6,ANTIOQUIA,1337,1244,55,1,1,1,2639,12,98,62,8,180
URAMITA,2018,7,ANTIOQUIA,1339,1247,55,1,1,1,2644,12,98,62,8,180
URAMITA,2018,8,ANTIOQUIA,1345,1249,55,1,1,1,2652,12,100,62,8,182
URAMITA,2018,9,ANTIOQUIA,1345,1249,55,1,1,1,2652,12,100,62,7,181
URAMITA,2019,1,ANTIOQUIA,1356,1252,56,1,1,1,2667,13,100,63,8,184
URAMITA,2019,10,ANTIOQUIA,1392,1264,52,1,1,1,2711,17,103,63,8,191
URAMITA,2019,11,ANTIOQUIA,1394,1271,53,1,1,1,2721,17,104,63,8,192
URAMITA,2019,12,ANTIOQUIA,1395,1273,53,1,1,1,2724,17,103,62,8,190
URAMITA,2019,2,ANTIOQUIA,1359,1251,55,1,1,1,2668,13,100,63,8,184
URAMITA,2019,3,ANTIOQUIA,1360,1253,54,1,1,1,2670,13,100,62,8,183
URAMITA,2019,4,ANTIOQUIA,1377,1255,55,1,1,1,2690,13,100,63,8,184
URAMITA,2019,5,ANTIOQUIA,1387,1260,56,2,1,1,2707,13,100,63,8,184
URAMITA,2019,6,ANTIOQUIA,1381,1258,54,2,1,1,2697,13,100,62,8,183
URAMITA,2019,7,ANTIOQUIA,1386,1259,54,1,1,1,2702,16,102,63,8,189
URAMITA,2019,8,ANTIOQUIA,1387,1262,53,1,1,1,2705,17,103,63,8,191
URAMITA,2019,9,ANTIOQUIA,1390,1263,54,1,1,1,2710,17,103,63,8,191
URAMITA,2020,1,ANTIOQUIA,1392,1272,53,5,1,1,2724,17,103,63,8,191
URAMITA,2020,10,ANTIOQUIA,1415,1294,53,1,1,0,2764,18,110,63,33,224
URAMITA,2020,11,ANTIOQUIA,1414,1303,53,1,1,0,2772,18,110,63,33,224
URAMITA,2020,12,ANTIOQUIA,1419,1302,53,2,1,0,2777,18,110,63,33,224
URAMITA,2020,2,ANTIOQUIA,1393,1273,52,6,1,1,2726,18,103,68,33,222
URAMITA,2020,3,ANTIOQUIA,1402,1275,52,6,1,1,2737,18,103,68,33,222
URAMITA,2020,4,ANTIOQUIA,1409,1273,53,1,1,0,2737,18,109,63,33,223
URAMITA,2020,5,ANTIOQUIA,1408,1275,54,1,1,0,2739,18,109,63,33,223
URAMITA,2020,6,ANTIOQUIA,1409,1279,54,1,1,0,2744,18,109,64,33,224
URAMITA,2020,7,ANTIOQUIA,1413,1278,54,1,1,0,2747,18,109,64,33,224
URAMITA,2020,8,ANTIOQUIA,1410,1282,52,1,1,1,2747,18,109,63,33,223
URAMITA,2020,9,ANTIOQUIA,1412,1287,53,1,1,0,2754,18,110,63,33,224
URAMITA,2021,1,ANTIOQUIA,1415,1304,53,2,1,0,2775,18,109,63,33,223
URAMITA,2021,10,ANTIOQUIA,1445,1324,48,4,1,0,2822,19,112,63,33,227
URAMITA,2021,11,ANTIOQUIA,1447,1324,49,2,1,0,2823,19,113,63,33,228
URAMITA,2021,12,ANTIOQUIA,1450,1323,48,2,1,0,2824,19,113,63,33,228
URAMITA,2021,2,ANTIOQUIA,1417,1309,52,2,1,0,2781,18,109,63,33,223
URAMITA,2021,3,ANTIOQUIA,1420,1312,52,2,1,0,2787,18,110,64,33,225
URAMITA,2021,4,ANTIOQUIA,1427,1312,52,2,1,0,2794,18,110,64,33,225
URAMITA,2021,5,ANTIOQUIA,1431,1317,52,4,1,0,2805,18,110,64,33,225
URAMITA,2021,6,ANTIOQUIA,1432,1318,52,5,1,0,2808,19,107,64,33,223
URAMITA,2021,7,ANTIOQUIA,1436,1321,52,5,1,0,2815,19,107,64,33,223
URAMITA,2021,8,ANTIOQUIA,1439,1324,50,5,1,0,2819,19,108,64,33,224
URAMITA,2021,9,ANTIOQUIA,1442,1326,49,4,1,0,2822,19,110,64,33,226
URAMITA,2022,1,ANTIOQUIA,1454,1321,48,2,1,0,2826,19,113,63,33,228
URAMITA,2022,10,ANTIOQUIA,1485,1322,48,2,1,0,2858,18,116,63,33,230
URAMITA,2022,11,ANTIOQUIA,1486,1330,48,2,1,0,2867,16,116,63,33,228
URAMITA,2022,12,ANTIOQUIA,1487,1333,48,2,1,0,2871,16,116,63,33,228
URAMITA,2022,2,ANTIOQUIA,1461,1321,48,3,1,0,2834,19,114,63,33,229
URAMITA,2022,3,ANTIOQUIA,1463,1325,48,3,1,0,2840,18,114,64,33,229
URAMITA,2022,4,ANTIOQUIA,1464,1328,48,3,1,0,2844,18,114,64,33,229
URAMITA,2022,5,ANTIOQUIA,1470,1331,48,3,1,0,2853,18,114,64,33,229
URAMITA,2022,6,ANTIOQUIA,1473,1332,48,3,1,0,2857,18,115,64,33,230
URAMITA,2022,7,ANTIOQUIA,1467,1311,48,3,1,0,2830,18,115,63,33,229
URAMITA,2022,8,ANTIOQUIA,1472,1317,48,2,1,0,2840,18,116,63,33,230
URAMITA,2022,9,ANTIOQUIA,1476,1320,48,2,1,0,2847,18,116,63,33,230
URAMITA,2023,1,ANTIOQUIA,1494,1331,48,3,1,0,2877,16,115,63,33,227
URAMITA,2023,2,ANTIOQUIA,1494,1334,48,2,1,0,2879,16,115,63,33,227
URAMITA,2023,3,ANTIOQUIA,1497,1335,48,2,1,0,2883,16,115,63,33,227
URAMITA,2023,4,ANTIOQUIA,1505,1337,48,2,1,0,2893,16,115,63,33,227
URAMITA,2023,5,ANTIOQUIA,1509,1341,48,2,1,0,2901,16,115,66,33,230
URAMITA,2023,6,ANTIOQUIA,1516,1343,48,2,1,0,2910,16,115,65,33,229
URAMITA,2023,7,ANTIOQUIA,1521,1348,48,2,1,0,2920,15,114,65,33,227
URAMITA,2023,8,ANTIOQUIA,1522,1351,47,3,1,0,2924,15,112,65,33,225
URAMITA,2023,9,ANTIOQUIA,1523,1350,47,3,1,0,2924,15,112,65,33,225
URRAO,2018,1,ANTIOQUIA,2883,4451,2448,89,5,0,9876,53,675,138,24,890
URRAO,2018,10,ANTIOQUIA,2985,4537,2496,92,5,0,10115,53,683,139,24,899
URRAO,2018,11,ANTIOQUIA,2984,4509,2477,92,5,0,10067,53,678,139,24,894
URRAO,2018,12,ANTIOQUIA,2990,4513,2477,94,5,0,10079,53,678,139,24,894
URRAO,2018,2,ANTIOQUIA,2966,4453,2451,89,5,0,9964,53,672,142,24,891
URRAO,2018,3,ANTIOQUIA,2940,4457,2450,90,5,0,9942,53,676,142,24,895
URRAO,2018,4,ANTIOQUIA,3026,4465,2456,90,5,0,10042,53,677,143,24,897
URRAO,2018,5,ANTIOQUIA,2970,4467,2456,90,5,0,9988,53,677,139,24,893
URRAO,2018,6,ANTIOQUIA,2971,4480,2463,90,5,0,10009,53,678,139,24,894
URRAO,2018,7,ANTIOQUIA,2978,4484,2467,90,5,0,10024,53,680,139,24,896
URRAO,2018,8,ANTIOQUIA,2979,4493,2465,90,5,0,10032,53,681,139,24,897
URRAO,2018,9,ANTIOQUIA,2979,4499,2472,91,5,0,10046,53,679,139,24,895
URRAO,2019,1,ANTIOQUIA,2996,4520,2479,94,5,0,10094,53,679,139,24,895
URRAO,2019,10,ANTIOQUIA,3027,4601,2496,94,5,0,10223,55,703,139,24,921
URRAO,2019,11,ANTIOQUIA,3053,4612,2497,94,5,0,10261,55,706,139,24,924
URRAO,2019,12,ANTIOQUIA,3062,4645,2499,93,5,0,10304,56,707,139,24,926
URRAO,2019,2,ANTIOQUIA,2992,4527,2483,94,5,0,10101,53,680,139,24,896
URRAO,2019,3,ANTIOQUIA,2995,4542,2489,94,5,0,10125,53,681,139,24,897
URRAO,2019,4,ANTIOQUIA,3002,4565,2487,94,5,0,10153,54,687,139,24,904
URRAO,2019,5,ANTIOQUIA,3003,4578,2494,94,5,0,10174,55,688,139,24,906
URRAO,2019,6,ANTIOQUIA,3006,4578,2497,94,5,0,10180,55,689,139,24,907
URRAO,2019,7,ANTIOQUIA,3013,4584,2498,96,5,0,10196,55,688,139,24,906
URRAO,2019,8,ANTIOQUIA,3015,4591,2491,95,5,0,10197,55,700,139,24,918
URRAO,2019,9,ANTIOQUIA,3021,4596,2493,96,5,0,10211,55,702,139,24,920
URRAO,2020,1,ANTIOQUIA,3068,4647,2495,109,5,0,10324,55,706,139,24,924
URRAO,2020,10,ANTIOQUIA,3122,4697,2514,97,5,0,10435,55,736,139,161,1091
URRAO,2020,11,ANTIOQUIA,3122,4701,2493,97,5,0,10418,55,763,139,161,1118
URRAO,2020,12,ANTIOQUIA,3130,4706,2500,98,5,0,10439,55,763,139,161,1118
URRAO,2020,2,ANTIOQUIA,3069,4654,2497,114,5,0,10339,58,707,161,161,1087
URRAO,2020,3,ANTIOQUIA,3074,4658,2497,115,5,0,10349,58,708,161,161,1088
URRAO,2020,4,ANTIOQUIA,3084,4663,2504,93,5,0,10349,56,731,139,161,1087
URRAO,2020,5,ANTIOQUIA,3205,4684,2509,93,5,0,10496,57,731,139,161,1088
URRAO,2020,6,ANTIOQUIA,3094,4671,2509,93,5,0,10372,56,732,139,161,1088
URRAO,2020,7,ANTIOQUIA,3103,4681,2511,98,5,0,10398,56,733,139,161,1089
URRAO,2020,8,ANTIOQUIA,3170,4694,2512,96,5,0,10477,56,734,139,161,1090
URRAO,2020,9,ANTIOQUIA,3188,4699,2514,95,5,0,10501,55,734,139,161,1089
URRAO,2021,1,ANTIOQUIA,3145,4711,2501,99,5,0,10461,55,764,140,161,1120
URRAO,2021,10,ANTIOQUIA,3190,4808,2521,103,5,0,10627,56,781,140,161,1138
URRAO,2021,11,ANTIOQUIA,3190,4816,2521,103,5,0,10635,56,783,140,161,1140
URRAO,2021,12,ANTIOQUIA,3202,4823,2521,106,5,0,10657,56,783,140,161,1140
URRAO,2021,2,ANTIOQUIA,3152,4741,2500,95,5,0,10493,56,764,140,161,1121
URRAO,2021,3,ANTIOQUIA,3158,4749,2499,95,5,0,10506,56,766,140,161,1123
URRAO,2021,4,ANTIOQUIA,3156,4758,2506,96,5,0,10521,56,769,140,161,1126
URRAO,2021,5,ANTIOQUIA,3156,4765,2512,95,5,0,10533,56,770,140,160,1126
URRAO,2021,6,ANTIOQUIA,3160,4771,2516,95,5,0,10547,56,770,140,161,1127
URRAO,2021,7,ANTIOQUIA,3162,4778,2520,96,5,0,10561,56,772,140,161,1129
URRAO,2021,8,ANTIOQUIA,3174,4789,2516,97,5,0,10581,56,775,140,161,1132
URRAO,2021,9,ANTIOQUIA,3184,4801,2515,103,5,0,10608,56,778,140,161,1135
URRAO,2022,1,ANTIOQUIA,3206,4840,2521,108,5,0,10680,56,782,140,161,1139
URRAO,2022,10,ANTIOQUIA,3255,4988,2564,115,5,0,10927,57,796,142,163,1158
URRAO,2022,11,ANTIOQUIA,3258,5014,2568,146,5,0,10991,57,796,142,163,1158
URRAO,2022,12,ANTIOQUIA,3265,5031,2568,147,5,0,11016,56,798,142,163,1159
URRAO,2022,2,ANTIOQUIA,3210,4853,2522,107,5,0,10697,56,785,140,161,1142
URRAO,2022,3,ANTIOQUIA,3214,4883,2527,109,5,0,10738,55,786,141,161,1143
URRAO,2022,4,ANTIOQUIA,3171,4923,2549,109,5,0,10757,55,786,141,161,1143
URRAO,2022,5,ANTIOQUIA,3186,4943,2560,108,5,0,10802,55,787,141,161,1144
URRAO,2022,6,ANTIOQUIA,3181,4968,2567,108,5,0,10829,56,788,141,161,1146
URRAO,2022,7,ANTIOQUIA,3210,4968,2559,109,5,0,10851,57,791,142,161,1151
URRAO,2022,8,ANTIOQUIA,3213,4964,2565,110,5,0,10857,57,790,142,162,1151
URRAO,2022,9,ANTIOQUIA,3248,4972,2562,112,5,0,10899,57,794,142,162,1155
URRAO,2023,1,ANTIOQUIA,3261,5057,2569,148,5,0,11040,56,801,142,163,1162
URRAO,2023,2,ANTIOQUIA,3279,5062,2569,148,5,0,11063,57,801,142,163,1163
URRAO,2023,3,ANTIOQUIA,3287,5083,2570,151,5,0,11096,58,806,142,163,1169
URRAO,2023,4,ANTIOQUIA,3299,5098,2582,150,5,0,11134,58,809,142,163,1172
URRAO,2023,5,ANTIOQUIA,3301,5116,2581,151,5,0,11154,58,809,143,164,1174
URRAO,2023,6,ANTIOQUIA,3328,5128,2587,149,5,0,11197,59,812,143,164,1178
URRAO,2023,7,ANTIOQUIA,3295,5136,2588,149,5,0,11173,60,812,143,164,1179
URRAO,2023,8,ANTIOQUIA,3328,5148,2590,149,5,0,11220,59,814,143,164,1180
URRAO,2023,9,ANTIOQUIA,3310,5159,2594,148,5,0,11216,59,815,143,164,1181
VALDIVIA,2018,1,ANTIOQUIA,2960,2086,193,15,0,0,5254,34,321,82,5,442
VALDIVIA,2018,10,ANTIOQUIA,2974,2089,186,16,0,0,5265,35,351,79,5,470
VALDIVIA,2018,11,ANTIOQUIA,2949,2083,187,16,0,0,5235,35,351,79,5,470
VALDIVIA,2018,12,ANTIOQUIA,2954,2083,187,16,0,0,5240,35,351,79,5,470
VALDIVIA,2018,2,ANTIOQUIA,2963,2085,193,15,0,0,5256,34,322,82,5,443
VALDIVIA,2018,3,ANTIOQUIA,2961,2089,191,15,0,0,5256,33,322,79,5,439
VALDIVIA,2018,4,ANTIOQUIA,2974,2094,192,15,0,0,5275,34,322,82,5,443
VALDIVIA,2018,5,ANTIOQUIA,2939,2084,191,15,0,0,5229,34,321,79,5,439
VALDIVIA,2018,6,ANTIOQUIA,2969,2073,186,16,0,0,5244,34,350,79,5,468
VALDIVIA,2018,7,ANTIOQUIA,2971,2079,186,16,0,0,5252,35,350,79,5,469
VALDIVIA,2018,8,ANTIOQUIA,2973,2083,187,16,0,0,5259,35,351,79,5,470
VALDIVIA,2018,9,ANTIOQUIA,2940,2080,186,16,0,0,5222,35,348,79,5,467
VALDIVIA,2019,1,ANTIOQUIA,2933,2086,188,17,0,0,5224,35,350,79,5,469
VALDIVIA,2019,10,ANTIOQUIA,3020,2112,191,22,0,0,5345,34,355,80,5,474
VALDIVIA,2019,11,ANTIOQUIA,3033,2117,191,23,0,0,5364,34,354,80,5,473
VALDIVIA,2019,12,ANTIOQUIA,3040,2118,191,23,0,0,5372,34,355,80,5,474
VALDIVIA,2019,2,ANTIOQUIA,2928,2088,188,18,0,0,5222,35,348,80,5,468
VALDIVIA,2019,3,ANTIOQUIA,2930,2090,190,20,0,0,5230,32,346,79,5,462
VALDIVIA,2019,4,ANTIOQUIA,2958,2092,190,20,0,0,5260,32,348,79,5,464
VALDIVIA,2019,5,ANTIOQUIA,3006,2108,190,20,0,0,5324,34,350,79,5,468
VALDIVIA,2019,6,ANTIOQUIA,2983,2095,190,20,0,0,5288,34,352,79,5,470
VALDIVIA,2019,7,ANTIOQUIA,2994,2094,191,20,0,0,5299,34,352,79,5,470
VALDIVIA,2019,8,ANTIOQUIA,3002,2100,192,20,0,0,5314,34,353,79,5,471
VALDIVIA,2019,9,ANTIOQUIA,3012,2101,190,22,0,0,5325,34,353,80,5,472
VALDIVIA,2020,1,ANTIOQUIA,3032,2116,190,23,0,0,5361,35,356,80,5,476
VALDIVIA,2020,10,ANTIOQUIA,3085,2160,189,20,0,0,5454,37,357,80,128,602
VALDIVIA,2020,11,ANTIOQUIA,3102,2160,188,20,0,0,5470,38,357,80,128,603
VALDIVIA,2020,12,ANTIOQUIA,3113,2167,186,21,0,0,5487,39,356,80,128,603
VALDIVIA,2020,2,ANTIOQUIA,3039,2118,192,24,0,0,5373,37,356,82,128,603
VALDIVIA,2020,3,ANTIOQUIA,3045,2122,191,24,0,0,5382,37,356,82,128,603
VALDIVIA,2020,4,ANTIOQUIA,3049,2126,189,21,0,0,5385,37,357,80,128,602
VALDIVIA,2020,5,ANTIOQUIA,3076,2153,191,21,0,0,5441,37,358,80,128,603
VALDIVIA,2020,6,ANTIOQUIA,3055,2135,189,19,0,0,5398,37,357,80,128,602
VALDIVIA,2020,7,ANTIOQUIA,3060,2142,189,19,0,0,5410,37,356,81,128,602
VALDIVIA,2020,8,ANTIOQUIA,3119,2157,189,19,0,0,5484,37,357,80,128,602
VALDIVIA,2020,9,ANTIOQUIA,3084,2146,189,20,0,0,5439,37,355,80,128,600
VALDIVIA,2021,1,ANTIOQUIA,3113,2174,187,21,0,0,5495,39,355,80,128,602
VALDIVIA,2021,10,ANTIOQUIA,3180,2204,188,26,0,0,5598,43,352,80,128,603
VALDIVIA,2021,11,ANTIOQUIA,3185,2207,188,26,0,0,5606,43,352,80,128,603
VALDIVIA,2021,12,ANTIOQUIA,3203,2215,189,26,0,0,5633,43,353,80,128,604
VALDIVIA,2021,2,ANTIOQUIA,3129,2179,187,22,0,0,5517,39,357,80,128,604
VALDIVIA,2021,3,ANTIOQUIA,3148,2180,186,22,0,0,5536,39,357,80,128,604
VALDIVIA,2021,4,ANTIOQUIA,3150,2176,186,22,0,0,5534,39,356,80,128,603
VALDIVIA,2021,5,ANTIOQUIA,3162,2175,186,23,0,0,5546,39,355,80,128,602
VALDIVIA,2021,6,ANTIOQUIA,3163,2178,186,25,0,0,5552,39,356,80,128,603
VALDIVIA,2021,7,ANTIOQUIA,3171,2185,187,26,0,0,5569,39,355,80,128,602
VALDIVIA,2021,8,ANTIOQUIA,3171,2189,187,26,0,0,5573,40,355,80,127,602
VALDIVIA,2021,9,ANTIOQUIA,3178,2196,188,26,0,0,5588,42,355,80,128,605
VALDIVIA,2022,1,ANTIOQUIA,3203,2215,189,27,0,0,5634,43,352,80,128,603
VALDIVIA,2022,10,ANTIOQUIA,3267,2228,190,43,0,0,5728,41,355,82,128,606
VALDIVIA,2022,11,ANTIOQUIA,3274,2234,190,43,0,0,5741,41,354,82,128,605
VALDIVIA,2022,12,ANTIOQUIA,3279,2236,190,43,0,0,5748,41,354,82,128,605
VALDIVIA,2022,2,ANTIOQUIA,3211,2216,189,34,0,0,5650,43,355,80,127,605
VALDIVIA,2022,3,ANTIOQUIA,3213,2221,188,34,0,0,5656,41,355,82,128,606
VALDIVIA,2022,4,ANTIOQUIA,3224,2227,188,39,0,0,5678,41,355,82,128,606
VALDIVIA,2022,5,ANTIOQUIA,3219,2224,188,41,0,0,5672,41,354,82,128,605
VALDIVIA,2022,6,ANTIOQUIA,3227,2228,189,42,0,0,5686,41,355,82,128,606
VALDIVIA,2022,7,ANTIOQUIA,3218,2220,189,41,0,0,5668,40,355,82,128,605
VALDIVIA,2022,8,ANTIOQUIA,3231,2222,190,41,0,0,5684,41,356,82,127,606
VALDIVIA,2022,9,ANTIOQUIA,3254,2226,190,42,0,0,5712,41,355,82,128,606
VALDIVIA,2023,1,ANTIOQUIA,3285,2237,190,43,0,0,5755,41,355,82,128,606
VALDIVIA,2023,2,ANTIOQUIA,3288,2241,190,43,0,0,5762,41,354,82,128,605
VALDIVIA,2023,3,ANTIOQUIA,3287,2243,190,43,0,0,5763,40,354,82,128,604
VALDIVIA,2023,4,ANTIOQUIA,3289,2246,190,43,0,0,5768,41,354,82,128,605
VALDIVIA,2023,5,ANTIOQUIA,3291,2245,189,43,0,0,5768,41,353,82,128,604
VALDIVIA,2023,6,ANTIOQUIA,3291,2245,188,44,0,0,5768,40,352,82,128,602
VALDIVIA,2023,7,ANTIOQUIA,3286,2246,188,43,0,0,5763,40,348,82,128,598
VALDIVIA,2023,8,ANTIOQUIA,3287,2241,187,45,0,0,5760,40,346,82,128,596
VALDIVIA,2023,9,ANTIOQUIA,3284,2237,187,45,0,0,5753,40,346,82,129,597
VALPARAISO,2018,1,ANTIOQUIA,837,1091,262,52,8,27,2277,16,148,42,2,208
VALPARAISO,2018,10,ANTIOQUIA,855,1147,271,52,8,27,2360,15,145,42,2,204
VALPARAISO,2018,11,ANTIOQUIA,856,1150,271,52,8,27,2364,15,146,42,2,205
VALPARAISO,2018,12,ANTIOQUIA,857,1152,271,52,8,27,2367,15,145,42,2,204
VALPARAISO,2018,2,ANTIOQUIA,846,1097,264,52,8,27,2294,15,147,42,2,206
VALPARAISO,2018,3,ANTIOQUIA,846,1099,265,52,8,27,2297,15,149,42,2,208
VALPARAISO,2018,4,ANTIOQUIA,847,1103,265,52,8,27,2302,15,148,42,2,207
VALPARAISO,2018,5,ANTIOQUIA,843,1102,264,52,8,27,2296,15,145,42,2,204
VALPARAISO,2018,6,ANTIOQUIA,844,1106,266,52,8,27,2303,15,144,42,2,203
VALPARAISO,2018,7,ANTIOQUIA,845,1134,270,52,8,27,2336,15,144,42,2,203
VALPARAISO,2018,8,ANTIOQUIA,850,1137,270,52,8,27,2344,15,144,42,2,203
VALPARAISO,2018,9,ANTIOQUIA,852,1147,270,52,8,27,2356,15,145,42,2,204
VALPARAISO,2019,1,ANTIOQUIA,856,1160,270,52,8,27,2373,15,145,42,2,204
VALPARAISO,2019,10,ANTIOQUIA,867,1174,267,53,8,27,2396,15,153,41,2,211
VALPARAISO,2019,11,ANTIOQUIA,869,1173,267,53,8,27,2397,15,151,41,2,209
VALPARAISO,2019,12,ANTIOQUIA,873,1176,267,54,8,27,2405,15,153,41,2,211
VALPARAISO,2019,2,ANTIOQUIA,857,1162,270,52,8,27,2376,15,145,42,2,204
VALPARAISO,2019,3,ANTIOQUIA,858,1162,270,52,8,27,2377,15,147,42,2,206
VALPARAISO,2019,4,ANTIOQUIA,859,1164,270,52,8,27,2380,15,147,42,2,206
VALPARAISO,2019,5,ANTIOQUIA,862,1164,268,53,8,27,2382,16,151,42,2,211
VALPARAISO,2019,6,ANTIOQUIA,860,1161,269,54,8,27,2379,15,150,42,2,209
VALPARAISO,2019,7,ANTIOQUIA,862,1168,268,54,8,27,2387,15,150,42,2,209
VALPARAISO,2019,8,ANTIOQUIA,864,1173,266,54,8,27,2392,15,150,42,2,209
VALPARAISO,2019,9,ANTIOQUIA,866,1173,267,53,8,27,2394,15,151,42,2,210
VALPARAISO,2020,1,ANTIOQUIA,869,1176,266,54,8,27,2400,15,152,41,2,210
VALPARAISO,2020,10,ANTIOQUIA,876,1203,269,61,8,26,2443,16,150,42,99,307
VALPARAISO,2020,11,ANTIOQUIA,878,1202,270,60,8,26,2444,16,150,42,99,307
VALPARAISO,2020,12,ANTIOQUIA,875,1203,268,60,8,26,2440,16,152,42,99,309
VALPARAISO,2020,2,ANTIOQUIA,870,1176,266,56,8,27,2403,15,152,43,99,309
VALPARAISO,2020,3,ANTIOQUIA,871,1176,266,56,8,28,2405,15,152,43,99,309
VALPARAISO,2020,4,ANTIOQUIA,872,1177,266,57,8,28,2408,15,153,42,99,309
VALPARAISO,2020,5,ANTIOQUIA,874,1201,266,57,8,28,2434,15,153,42,99,309
VALPARAISO,2020,6,ANTIOQUIA,870,1200,267,57,8,28,2430,15,153,42,99,309
VALPARAISO,2020,7,ANTIOQUIA,875,1200,267,57,8,28,2435,15,153,42,99,309
VALPARAISO,2020,8,ANTIOQUIA,874,1200,269,60,8,26,2437,16,152,42,99,309
VALPARAISO,2020,9,ANTIOQUIA,875,1202,269,61,8,26,2441,16,150,42,99,307
VALPARAISO,2021,1,ANTIOQUIA,872,1200,267,60,8,26,2433,16,159,42,99,316
VALPARAISO,2021,10,ANTIOQUIA,874,1256,271,59,7,26,2493,17,162,43,99,321
VALPARAISO,2021,11,ANTIOQUIA,874,1261,270,59,7,26,2497,18,163,43,99,323
VALPARAISO,2021,12,ANTIOQUIA,876,1262,270,62,6,26,2502,17,162,43,99,321
VALPARAISO,2021,2,ANTIOQUIA,872,1201,268,64,8,26,2439,17,161,42,99,319
VALPARAISO,2021,3,ANTIOQUIA,876,1201,268,63,8,26,2442,17,159,43,99,318
VALPARAISO,2021,4,ANTIOQUIA,877,1205,268,63,7,26,2446,17,158,43,99,317
VALPARAISO,2021,5,ANTIOQUIA,877,1207,268,64,7,26,2449,17,159,43,99,318
VALPARAISO,2021,6,ANTIOQUIA,877,1249,269,63,7,26,2491,16,160,43,99,318
VALPARAISO,2021,7,ANTIOQUIA,879,1251,272,59,7,26,2494,16,161,43,99,319
VALPARAISO,2021,8,ANTIOQUIA,878,1252,272,59,7,26,2494,16,161,43,99,319
VALPARAISO,2021,9,ANTIOQUIA,875,1257,271,59,7,26,2495,16,162,43,99,320
VALPARAISO,2022,1,ANTIOQUIA,876,1265,272,60,6,26,2505,17,163,43,99,322
VALPARAISO,2022,10,ANTIOQUIA,879,1290,270,59,6,24,2528,19,166,42,98,325
VALPARAISO,2022,11,ANTIOQUIA,879,1290,270,59,6,24,2528,19,167,42,98,326
VALPARAISO,2022,12,ANTIOQUIA,881,1334,277,59,6,24,2581,19,168,42,98,327
VALPARAISO,2022,2,ANTIOQUIA,878,1267,270,60,6,26,2507,17,163,43,99,322
VALPARAISO,2022,3,ANTIOQUIA,881,1279,269,60,6,26,2521,17,163,43,99,322
VALPARAISO,2022,4,ANTIOQUIA,879,1284,268,60,6,26,2523,17,163,43,99,322
VALPARAISO,2022,5,ANTIOQUIA,880,1285,268,59,6,26,2524,18,164,43,99,324
VALPARAISO,2022,6,ANTIOQUIA,880,1284,268,59,6,26,2523,18,167,43,99,327
VALPARAISO,2022,7,ANTIOQUIA,882,1285,268,59,6,26,2526,19,167,43,99,328
VALPARAISO,2022,8,ANTIOQUIA,877,1283,269,59,6,24,2518,19,167,42,99,327
VALPARAISO,2022,9,ANTIOQUIA,878,1289,269,59,6,24,2525,19,167,42,99,327
VALPARAISO,2023,1,ANTIOQUIA,882,1336,277,59,6,24,2584,19,167,42,98,326
VALPARAISO,2023,2,ANTIOQUIA,884,1338,277,59,6,24,2588,19,166,42,98,325
VALPARAISO,2023,3,ANTIOQUIA,888,1340,277,59,6,24,2594,19,167,42,98,326
VALPARAISO,2023,4,ANTIOQUIA,890,1380,277,59,6,24,2636,22,170,42,98,332
VALPARAISO,2023,5,ANTIOQUIA,892,1385,278,59,6,24,2644,21,169,42,98,330
VALPARAISO,2023,6,ANTIOQUIA,896,1385,278,59,6,24,2648,21,169,42,98,330
VALPARAISO,2023,7,ANTIOQUIA,891,1388,277,59,6,24,2645,21,169,42,98,330
VALPARAISO,2023,8,ANTIOQUIA,896,1390,277,59,6,24,2652,21,169,42,98,330
VALPARAISO,2023,9,ANTIOQUIA,897,1387,277,59,6,24,2650,22,168,42,98,330
VEGACHI,2018,1,ANTIOQUIA,1639,2933,120,19,0,0,4711,46,414,71,9,540
VEGACHI,2018,10,ANTIOQUIA,1669,2992,114,23,0,0,4798,45,419,71,9,544
VEGACHI,2018,11,ANTIOQUIA,1668,2995,114,23,0,0,4800,44,421,71,9,545
VEGACHI,2018,12,ANTIOQUIA,1687,3005,115,23,0,0,4830,44,422,71,9,546
VEGACHI,2018,2,ANTIOQUIA,1640,2941,120,20,0,0,4721,46,414,71,9,540
VEGACHI,2018,3,ANTIOQUIA,1641,2946,120,20,0,0,4727,46,416,71,9,542
VEGACHI,2018,4,ANTIOQUIA,1643,2953,120,20,0,0,4736,46,418,71,9,544
VEGACHI,2018,5,ANTIOQUIA,1634,2951,119,20,0,0,4724,45,415,71,9,540
VEGACHI,2018,6,ANTIOQUIA,1646,2963,118,21,0,0,4748,45,416,71,9,541
VEGACHI,2018,7,ANTIOQUIA,1653,2977,118,22,0,0,4770,46,416,71,9,542
VEGACHI,2018,8,ANTIOQUIA,1658,2988,119,24,0,0,4789,46,418,71,9,544
VEGACHI,2018,9,ANTIOQUIA,1660,2986,116,23,0,0,4785,44,418,71,9,542
VEGACHI,2019,1,ANTIOQUIA,1693,3010,116,23,0,0,4842,43,423,71,9,546
VEGACHI,2019,10,ANTIOQUIA,1747,3072,121,31,0,0,4971,43,433,72,9,557
VEGACHI,2019,11,ANTIOQUIA,1754,3087,121,31,0,0,4993,43,431,73,9,556
VEGACHI,2019,12,ANTIOQUIA,1767,3095,121,29,0,0,5012,43,433,74,9,559
VEGACHI,2019,2,ANTIOQUIA,1699,3014,116,23,0,0,4852,43,424,71,9,547
VEGACHI,2019,3,ANTIOQUIA,1711,3019,117,23,0,0,4870,43,423,71,9,546
VEGACHI,2019,4,ANTIOQUIA,1712,3024,117,26,0,0,4879,43,428,71,9,551
VEGACHI,2019,5,ANTIOQUIA,1719,3034,118,27,0,0,4898,43,431,72,9,555
VEGACHI,2019,6,ANTIOQUIA,1718,3030,117,28,0,0,4893,43,431,72,9,555
VEGACHI,2019,7,ANTIOQUIA,1726,3034,118,28,0,0,4906,43,434,72,9,558
VEGACHI,2019,8,ANTIOQUIA,1728,3043,119,29,0,0,4919,43,432,72,9,556
VEGACHI,2019,9,ANTIOQUIA,1741,3060,121,30,0,0,4952,43,433,72,9,557
VEGACHI,2020,1,ANTIOQUIA,1760,3095,121,33,0,0,5009,43,429,74,9,555
VEGACHI,2020,10,ANTIOQUIA,1814,3135,128,25,0,0,5102,44,444,74,75,637
VEGACHI,2020,11,ANTIOQUIA,1825,3143,128,25,0,0,5121,44,443,74,75,636
VEGACHI,2020,12,ANTIOQUIA,1832,3155,128,25,0,0,5140,44,445,74,75,638
VEGACHI,2020,2,ANTIOQUIA,1756,3100,121,35,0,0,5012,44,426,81,75,626
VEGACHI,2020,3,ANTIOQUIA,1759,3102,122,36,0,0,5019,44,428,81,75,628
VEGACHI,2020,4,ANTIOQUIA,1766,3111,123,24,0,0,5024,44,434,74,75,627
VEGACHI,2020,5,ANTIOQUIA,1775,3118,125,24,0,0,5042,45,435,74,75,629
VEGACHI,2020,6,ANTIOQUIA,1777,3120,125,24,0,0,5046,44,433,74,75,626
VEGACHI,2020,7,ANTIOQUIA,1783,3123,125,25,0,0,5056,44,432,74,75,625
VEGACHI,2020,8,ANTIOQUIA,1793,3126,125,25,0,0,5069,44,432,74,75,625
VEGACHI,2020,9,ANTIOQUIA,1807,3130,127,26,0,0,5090,44,429,74,75,622
VEGACHI,2021,1,ANTIOQUIA,1839,3163,129,25,0,0,5156,43,444,74,75,636
VEGACHI,2021,10,ANTIOQUIA,1907,3248,127,35,0,0,5317,42,449,74,75,640
VEGACHI,2021,11,ANTIOQUIA,1914,3257,127,33,0,0,5331,42,449,74,75,640
VEGACHI,2021,12,ANTIOQUIA,1917,3277,127,32,0,0,5353,43,450,74,75,642
VEGACHI,2021,2,ANTIOQUIA,1846,3170,127,26,0,0,5169,43,445,74,75,637
VEGACHI,2021,3,ANTIOQUIA,1861,3183,128,27,0,0,5199,43,445,74,75,637
VEGACHI,2021,4,ANTIOQUIA,1872,3199,127,28,0,0,5226,43,445,74,75,637
VEGACHI,2021,5,ANTIOQUIA,1877,3207,128,28,0,0,5240,43,448,74,75,640
VEGACHI,2021,6,ANTIOQUIA,1880,3214,127,29,0,0,5250,43,448,74,75,640
VEGACHI,2021,7,ANTIOQUIA,1885,3227,127,33,0,0,5272,43,448,74,75,640
VEGACHI,2021,8,ANTIOQUIA,1894,3235,128,33,0,0,5290,43,447,74,74,638
VEGACHI,2021,9,ANTIOQUIA,1899,3236,127,35,0,0,5297,42,448,74,75,639
VEGACHI,2022,1,ANTIOQUIA,1926,3288,127,33,0,0,5374,43,449,74,75,641
VEGACHI,2022,10,ANTIOQUIA,1980,3343,122,33,0,0,5478,42,455,75,75,647
VEGACHI,2022,11,ANTIOQUIA,1997,3363,123,32,0,0,5515,44,455,75,75,649
VEGACHI,2022,12,ANTIOQUIA,2006,3372,121,32,0,0,5531,44,455,75,75,649
VEGACHI,2022,2,ANTIOQUIA,1931,3298,127,34,0,0,5390,43,450,73,75,641
VEGACHI,2022,3,ANTIOQUIA,1939,3315,127,34,0,0,5415,42,451,74,75,642
VEGACHI,2022,4,ANTIOQUIA,1951,3323,128,34,0,0,5436,42,449,74,75,640
VEGACHI,2022,5,ANTIOQUIA,1946,3343,128,35,0,0,5452,42,450,74,75,641
VEGACHI,2022,6,ANTIOQUIA,1962,3352,128,33,0,0,5475,42,450,74,75,641
VEGACHI,2022,7,ANTIOQUIA,1959,3326,122,31,0,0,5438,42,450,73,75,640
VEGACHI,2022,8,ANTIOQUIA,1967,3332,124,32,0,0,5455,42,452,73,75,642
VEGACHI,2022,9,ANTIOQUIA,1973,3342,124,32,0,0,5471,42,454,73,75,644
VEGACHI,2023,1,ANTIOQUIA,2012,3391,121,35,0,0,5559,44,455,75,75,649
VEGACHI,2023,2,ANTIOQUIA,2025,3406,122,33,0,0,5586,43,457,75,75,650
VEGACHI,2023,3,ANTIOQUIA,2032,3418,122,32,0,0,5604,42,456,75,75,648
VEGACHI,2023,4,ANTIOQUIA,2042,3432,122,31,0,0,5627,42,456,75,76,649
VEGACHI,2023,5,ANTIOQUIA,2052,3442,121,31,0,0,5646,42,456,75,76,649
VEGACHI,2023,6,ANTIOQUIA,2057,3450,120,31,0,0,5658,42,456,75,76,649
VEGACHI,2023,7,ANTIOQUIA,2067,3454,121,32,0,0,5674,42,456,75,76,649
VEGACHI,2023,8,ANTIOQUIA,2122,3462,120,31,0,0,5735,42,456,75,76,649
VEGACHI,2023,9,ANTIOQUIA,2143,3474,121,29,0,0,5767,42,456,75,76,649
VENECIA,2018,1,ANTIOQUIA,1226,2014,1101,255,157,107,4860,66,395,48,5,514
VENECIA,2018,10,ANTIOQUIA,1229,2055,1215,264,158,107,5028,66,403,49,5,523
VENECIA,2018,11,ANTIOQUIA,1229,2062,1213,265,158,107,5034,67,403,49,5,524
VENECIA,2018,12,ANTIOQUIA,1229,2065,1213,265,158,107,5037,67,400,49,5,521
VENECIA,2018,2,ANTIOQUIA,1227,2026,1204,255,156,107,4975,66,396,48,5,515
VENECIA,2018,3,ANTIOQUIA,1228,2033,1205,261,156,107,4990,66,396,48,5,515
VENECIA,2018,4,ANTIOQUIA,1231,2038,1205,261,156,107,4998,67,397,48,5,517
VENECIA,2018,5,ANTIOQUIA,1230,2038,1206,260,156,107,4997,68,395,48,5,516
VENECIA,2018,6,ANTIOQUIA,1229,2040,1207,262,156,107,5001,68,397,48,5,518
VENECIA,2018,7,ANTIOQUIA,1228,2043,1206,262,156,107,5002,68,399,48,5,520
VENECIA,2018,8,ANTIOQUIA,1229,2049,1213,263,156,107,5017,68,402,48,5,523
VENECIA,2018,9,ANTIOQUIA,1229,2051,1213,263,156,107,5019,66,402,48,5,521
VENECIA,2019,1,ANTIOQUIA,1236,2069,1211,267,157,107,5047,67,403,49,5,524
VENECIA,2019,10,ANTIOQUIA,1244,2104,1223,269,157,107,5104,69,414,49,5,537
VENECIA,2019,11,ANTIOQUIA,1248,2108,1222,270,157,107,5112,69,414,49,5,537
VENECIA,2019,12,ANTIOQUIA,1258,2113,1228,272,157,109,5137,69,419,49,5,542
VENECIA,2019,2,ANTIOQUIA,1236,2071,1215,267,157,107,5053,67,404,49,5,525
VENECIA,2019,3,ANTIOQUIA,1238,2078,1215,268,157,107,5063,67,404,49,5,525
VENECIA,2019,4,ANTIOQUIA,1238,2083,1215,268,157,107,5068,67,405,49,5,526
VENECIA,2019,5,ANTIOQUIA,1248,2090,1215,268,157,108,5086,69,405,49,5,528
VENECIA,2019,6,ANTIOQUIA,1241,2089,1217,267,157,107,5078,68,405,49,5,527
VENECIA,2019,7,ANTIOQUIA,1243,2091,1225,268,157,107,5091,67,406,49,5,527
VENECIA,2019,8,ANTIOQUIA,1243,2092,1223,268,157,107,5090,68,408,49,5,530
VENECIA,2019,9,ANTIOQUIA,1243,2099,1221,268,157,107,5095,68,413,49,5,535
VENECIA,2020,1,ANTIOQUIA,1244,2112,1224,275,159,106,5120,68,415,49,5,537
VENECIA,2020,10,ANTIOQUIA,1247,2147,1226,276,163,106,5165,68,424,49,145,686
VENECIA,2020,11,ANTIOQUIA,1248,2148,1228,278,162,106,5170,66,428,49,145,688
VENECIA,2020,12,ANTIOQUIA,1248,2151,1226,279,163,106,5173,66,448,49,145,708
VENECIA,2020,2,ANTIOQUIA,1244,2114,1224,277,159,106,5124,69,418,52,146,685
VENECIA,2020,3,ANTIOQUIA,1244,2120,1224,278,159,106,5131,69,418,52,146,685
VENECIA,2020,4,ANTIOQUIA,1244,2125,1226,273,159,106,5133,71,422,49,146,688
VENECIA,2020,5,ANTIOQUIA,1248,2134,1225,275,161,107,5150,71,425,49,145,690
VENECIA,2020,6,ANTIOQUIA,1246,2131,1225,273,160,106,5141,71,424,49,145,689
VENECIA,2020,7,ANTIOQUIA,1246,2137,1226,273,161,106,5149,70,424,49,145,688
VENECIA,2020,8,ANTIOQUIA,1248,2141,1225,275,160,106,5155,70,424,49,145,688
VENECIA,2020,9,ANTIOQUIA,1248,2143,1227,275,160,106,5159,71,423,49,145,688
VENECIA,2021,1,ANTIOQUIA,1251,2158,1226,279,162,107,5183,69,444,49,145,707
VENECIA,2021,10,ANTIOQUIA,1254,2201,1270,279,163,106,5273,75,445,49,145,714
VENECIA,2021,11,ANTIOQUIA,1254,2204,1268,279,163,106,5274,76,447,49,145,717
VENECIA,2021,12,ANTIOQUIA,1254,2210,1270,286,186,106,5312,77,446,49,145,717
VENECIA,2021,2,ANTIOQUIA,1252,2166,1229,279,163,106,5195,69,445,49,145,708
VENECIA,2021,3,ANTIOQUIA,1254,2170,1229,279,163,106,5201,69,445,49,145,708
VENECIA,2021,4,ANTIOQUIA,1255,2171,1237,279,162,107,5211,71,446,49,145,711
VENECIA,2021,5,ANTIOQUIA,1255,2177,1260,280,163,106,5241,72,447,49,145,713
VENECIA,2021,6,ANTIOQUIA,1255,2178,1263,280,163,106,5245,72,446,49,145,712
VENECIA,2021,7,ANTIOQUIA,1254,2184,1270,280,162,107,5257,73,446,49,145,713
VENECIA,2021,8,ANTIOQUIA,1254,2187,1271,281,163,106,5262,74,445,49,145,713
VENECIA,2021,9,ANTIOQUIA,1254,2189,1270,280,163,106,5262,74,446,49,145,714
VENECIA,2022,1,ANTIOQUIA,1258,2217,1274,287,186,106,5328,78,446,49,145,718
VENECIA,2022,10,ANTIOQUIA,1261,2317,1279,284,186,104,5431,84,457,52,146,739
VENECIA,2022,11,ANTIOQUIA,1261,2327,1289,283,186,104,5450,84,458,52,146,740
VENECIA,2022,12,ANTIOQUIA,1261,2329,1289,283,186,104,5452,85,457,52,146,740
VENECIA,2022,2,ANTIOQUIA,1259,2279,1273,287,187,106,5391,77,449,49,145,720
VENECIA,2022,3,ANTIOQUIA,1261,2293,1273,285,187,106,5405,79,450,53,145,727
VENECIA,2022,4,ANTIOQUIA,1263,2301,1275,286,188,106,5419,79,452,53,145,729
VENECIA,2022,5,ANTIOQUIA,1262,2306,1275,285,187,106,5421,82,453,53,145,733
VENECIA,2022,6,ANTIOQUIA,1263,2309,1275,285,187,106,5425,81,455,53,145,734
VENECIA,2022,7,ANTIOQUIA,1264,2312,1277,285,188,106,5432,81,456,53,145,735
VENECIA,2022,8,ANTIOQUIA,1249,2308,1275,282,186,104,5404,81,456,52,145,734
VENECIA,2022,9,ANTIOQUIA,1254,2312,1275,285,186,104,5416,81,457,52,146,736
VENECIA,2023,1,ANTIOQUIA,1261,2331,1296,283,187,104,5462,83,458,52,147,740
VENECIA,2023,2,ANTIOQUIA,1263,2333,1295,283,187,104,5465,83,456,52,147,738
VENECIA,2023,3,ANTIOQUIA,1269,2341,1299,285,187,104,5485,83,458,52,147,740
VENECIA,2023,4,ANTIOQUIA,1269,2342,1301,287,187,105,5491,84,457,52,147,740
VENECIA,2023,5,ANTIOQUIA,1268,2343,1300,288,186,105,5490,89,452,52,147,740
VENECIA,2023,6,ANTIOQUIA,1266,2348,1301,287,186,105,5493,90,451,50,147,738
VENECIA,2023,7,ANTIOQUIA,1265,2355,1296,289,186,104,5495,89,449,50,147,735
VENECIA,2023,8,ANTIOQUIA,1266,2363,1296,292,186,103,5506,91,449,50,147,737
VENECIA,2023,9,ANTIOQUIA,1268,2363,1296,294,186,101,5508,89,449,50,147,735
YALI,2018,1,ANTIOQUIA,1226,907,200,14,7,1,2355,44,125,51,4,224
YALI,2018,10,ANTIOQUIA,1278,918,197,16,7,1,2417,43,123,51,4,221
YALI,2018,11,ANTIOQUIA,1282,919,196,14,7,1,2419,43,123,51,4,221
YALI,2018,12,ANTIOQUIA,1286,921,196,14,7,1,2425,42,123,51,4,220
YALI,2018,2,ANTIOQUIA,1228,913,200,14,7,3,2365,43,124,51,4,222
YALI,2018,3,ANTIOQUIA,1232,913,199,15,7,3,2369,44,124,51,4,223
YALI,2018,4,ANTIOQUIA,1248,914,199,15,7,3,2386,43,124,51,4,222
YALI,2018,5,ANTIOQUIA,1257,912,199,16,7,3,2394,43,124,51,4,222
YALI,2018,6,ANTIOQUIA,1268,915,199,16,7,3,2408,43,124,51,4,222
YALI,2018,7,ANTIOQUIA,1274,916,200,16,7,1,2414,43,124,51,4,222
YALI,2018,8,ANTIOQUIA,1277,916,200,16,7,1,2417,43,124,51,4,222
YALI,2018,9,ANTIOQUIA,1276,915,198,16,7,1,2413,42,123,51,4,220
YALI,2019,1,ANTIOQUIA,1287,925,196,14,7,1,2430,42,125,51,4,222
YALI,2019,10,ANTIOQUIA,1340,936,198,11,5,1,2491,42,127,52,4,225
YALI,2019,11,ANTIOQUIA,1339,936,198,11,5,1,2490,43,127,52,4,226
YALI,2019,12,ANTIOQUIA,1342,938,199,11,5,1,2496,42,127,52,4,225
YALI,2019,2,ANTIOQUIA,1288,926,198,14,7,1,2434,42,125,51,4,222
YALI,2019,3,ANTIOQUIA,1289,926,197,14,7,1,2434,42,126,51,4,223
YALI,2019,4,ANTIOQUIA,1292,929,197,14,5,1,2438,42,126,51,4,223
YALI,2019,5,ANTIOQUIA,1294,933,198,13,5,1,2444,43,126,51,4,224
YALI,2019,6,ANTIOQUIA,1293,932,197,12,5,1,2440,42,126,51,4,223
YALI,2019,7,ANTIOQUIA,1324,934,197,12,5,1,2473,42,126,51,4,223
YALI,2019,8,ANTIOQUIA,1327,935,197,11,5,1,2476,42,127,51,4,224
YALI,2019,9,ANTIOQUIA,1339,935,198,11,5,1,2489,42,127,51,4,224
YALI,2020,1,ANTIOQUIA,1340,938,199,13,5,1,2496,42,127,52,4,225
YALI,2020,10,ANTIOQUIA,1374,949,197,18,5,2,2545,46,134,52,36,268
YALI,2020,11,ANTIOQUIA,1377,952,196,18,5,2,2550,46,136,52,36,270
YALI,2020,12,ANTIOQUIA,1378,950,196,18,5,2,2549,46,135,52,36,269
YALI,2020,2,ANTIOQUIA,1348,939,198,12,5,1,2503,44,127,53,36,260
YALI,2020,3,ANTIOQUIA,1349,941,198,12,5,2,2507,44,127,53,36,260
YALI,2020,4,ANTIOQUIA,1349,941,198,11,5,2,2506,44,127,52,36,259
YALI,2020,5,ANTIOQUIA,1352,944,198,11,5,2,2512,45,127,52,36,260
YALI,2020,6,ANTIOQUIA,1359,944,199,13,5,2,2522,45,127,52,36,260
YALI,2020,7,ANTIOQUIA,1364,948,200,13,5,2,2532,45,128,52,36,261
YALI,2020,8,ANTIOQUIA,1373,952,199,18,5,2,2549,45,128,52,36,261
YALI,2020,9,ANTIOQUIA,1372,951,197,18,5,2,2545,46,128,52,36,262
YALI,2021,1,ANTIOQUIA,1379,952,195,18,5,2,2551,46,137,52,36,271
YALI,2021,10,ANTIOQUIA,1421,984,197,15,5,3,2625,44,153,51,36,284
YALI,2021,11,ANTIOQUIA,1423,987,197,15,5,3,2630,44,153,51,36,284
YALI,2021,12,ANTIOQUIA,1425,987,197,14,5,3,2631,44,153,51,36,284
YALI,2021,2,ANTIOQUIA,1387,960,195,16,5,2,2565,46,137,52,36,271
YALI,2021,3,ANTIOQUIA,1394,963,198,15,5,2,2577,46,153,51,36,286
YALI,2021,4,ANTIOQUIA,1402,966,196,15,5,2,2586,45,152,51,36,284
YALI,2021,5,ANTIOQUIA,1407,968,196,15,5,2,2593,44,152,51,36,283
YALI,2021,6,ANTIOQUIA,1405,969,196,15,5,2,2592,44,152,51,36,283
YALI,2021,7,ANTIOQUIA,1412,973,200,15,5,3,2608,44,152,51,36,283
YALI,2021,8,ANTIOQUIA,1415,978,199,15,5,3,2615,44,152,51,36,283
YALI,2021,9,ANTIOQUIA,1420,980,198,15,5,3,2621,44,152,51,36,283
YALI,2022,1,ANTIOQUIA,1427,989,197,14,5,3,2635,43,153,51,36,283
YALI,2022,10,ANTIOQUIA,1498,1013,192,12,4,4,2723,40,155,53,36,284
YALI,2022,11,ANTIOQUIA,1508,1016,192,13,4,8,2741,40,155,53,36,284
YALI,2022,12,ANTIOQUIA,1511,1017,191,12,4,8,2743,40,155,53,37,285
YALI,2022,2,ANTIOQUIA,1447,997,195,13,5,3,2660,43,153,51,36,283
YALI,2022,3,ANTIOQUIA,1456,999,196,13,5,3,2672,41,153,53,36,283
YALI,2022,4,ANTIOQUIA,1468,1002,196,13,5,3,2687,41,153,53,36,283
YALI,2022,5,ANTIOQUIA,1469,1001,196,13,5,3,2687,41,155,53,36,285
YALI,2022,6,ANTIOQUIA,1475,1004,196,13,5,4,2697,41,155,53,36,285
YALI,2022,7,ANTIOQUIA,1484,1005,195,13,4,4,2705,41,155,53,36,285
YALI,2022,8,ANTIOQUIA,1492,1005,195,12,4,4,2712,40,155,53,36,284
YALI,2022,9,ANTIOQUIA,1493,1008,194,12,4,4,2715,40,155,53,36,284
YALI,2023,1,ANTIOQUIA,1509,1023,189,12,4,9,2746,40,155,53,37,285
YALI,2023,2,ANTIOQUIA,1519,1029,185,14,4,8,2759,40,154,53,37,284
YALI,2023,3,ANTIOQUIA,1518,1034,185,14,3,8,2762,41,153,52,37,283
YALI,2023,4,ANTIOQUIA,1523,1036,185,14,3,7,2768,41,153,52,37,283
YALI,2023,5,ANTIOQUIA,1531,1043,185,13,3,6,2781,41,154,52,37,284
YALI,2023,6,ANTIOQUIA,1536,1047,185,11,3,6,2788,41,154,52,37,284
YALI,2023,7,ANTIOQUIA,1542,1055,180,12,3,6,2798,41,154,52,37,284
YALI,2023,8,ANTIOQUIA,1545,1057,178,12,3,5,2800,41,155,52,38,286
YALI,2023,9,ANTIOQUIA,1547,1061,177,12,3,5,2805,42,156,52,38,288
YARUMAL,2018,1,ANTIOQUIA,2387,5781,4962,254,2,3,13389,430,1460,150,5,2045
YARUMAL,2018,10,ANTIOQUIA,2428,5888,5026,258,3,3,13606,455,1504,150,5,2114
YARUMAL,2018,11,ANTIOQUIA,2435,5888,5039,258,2,3,13625,454,1511,150,5,2120
YARUMAL,2018,12,ANTIOQUIA,2459,5897,5083,260,2,3,13704,456,1511,150,5,2122
YARUMAL,2018,2,ANTIOQUIA,2395,5801,4991,261,2,3,13453,432,1460,150,5,2047
YARUMAL,2018,3,ANTIOQUIA,2397,5824,4993,262,2,3,13481,436,1462,149,5,2052
YARUMAL,2018,4,ANTIOQUIA,2407,5833,5005,263,2,3,13513,437,1460,150,5,2052
YARUMAL,2018,5,ANTIOQUIA,2403,5816,4999,261,2,3,13484,435,1455,149,5,2044
YARUMAL,2018,6,ANTIOQUIA,2416,5836,5014,260,2,3,13531,437,1456,149,5,2047
YARUMAL,2018,7,ANTIOQUIA,2422,5874,5012,264,2,3,13577,446,1472,149,5,2072
YARUMAL,2018,8,ANTIOQUIA,2434,5877,5017,264,2,3,13597,452,1472,149,5,2078
YARUMAL,2018,9,ANTIOQUIA,2419,5871,5010,264,2,3,13569,453,1471,150,5,2079
YARUMAL,2019,1,ANTIOQUIA,2467,5910,5087,260,2,3,13729,454,1512,150,5,2121
YARUMAL,2019,10,ANTIOQUIA,2537,6050,5142,325,0,3,14057,480,1539,151,5,2175
YARUMAL,2019,11,ANTIOQUIA,2543,6079,5144,303,0,3,14072,487,1539,151,5,2182
YARUMAL,2019,12,ANTIOQUIA,2557,6105,5188,290,0,3,14143,490,1548,151,5,2194
YARUMAL,2019,2,ANTIOQUIA,2481,5914,5094,279,2,3,13773,459,1503,150,5,2117
YARUMAL,2019,3,ANTIOQUIA,2483,5943,5095,274,2,3,13800,463,1506,150,5,2124
YARUMAL,2019,4,ANTIOQUIA,2495,5955,5109,275,2,3,13839,464,1506,151,5,2126
YARUMAL,2019,5,ANTIOQUIA,2532,5984,5137,277,2,3,13935,470,1508,151,5,2134
YARUMAL,2019,6,ANTIOQUIA,2517,5972,5116,293,1,3,13902,472,1530,151,5,2158
YARUMAL,2019,7,ANTIOQUIA,2527,6009,5131,281,1,3,13952,471,1530,150,5,2156
YARUMAL,2019,8,ANTIOQUIA,2538,6019,5144,297,0,3,14001,473,1532,150,5,2160
YARUMAL,2019,9,ANTIOQUIA,2536,6030,5143,302,0,3,14014,475,1530,151,5,2161
YARUMAL,2020,1,ANTIOQUIA,2547,6101,5188,294,0,3,14133,495,1558,151,5,2209
YARUMAL,2020,10,ANTIOQUIA,2594,6216,5301,302,1,3,14417,529,1595,152,304,2580
YARUMAL,2020,11,ANTIOQUIA,2599,6227,5302,299,1,3,14431,535,1596,152,304,2587
YARUMAL,2020,12,ANTIOQUIA,2600,6242,5303,300,1,3,14449,541,1615,152,304,2612
YARUMAL,2020,2,ANTIOQUIA,2554,6099,5186,296,0,3,14138,504,1556,156,304,2520
YARUMAL,2020,3,ANTIOQUIA,2556,6104,5190,297,0,3,14150,509,1558,156,304,2527
YARUMAL,2020,4,ANTIOQUIA,2559,6118,5196,291,0,3,14167,514,1560,152,304,2530
YARUMAL,2020,5,ANTIOQUIA,2575,6152,5221,296,3,3,14250,508,1598,153,304,2563
YARUMAL,2020,6,ANTIOQUIA,2564,6149,5217,299,1,3,14233,517,1574,152,304,2547
YARUMAL,2020,7,ANTIOQUIA,2572,6164,5243,298,1,3,14281,517,1578,152,304,2551
YARUMAL,2020,8,ANTIOQUIA,2577,6180,5251,306,1,3,14318,521,1575,152,304,2552
YARUMAL,2020,9,ANTIOQUIA,2586,6190,5290,303,1,3,14373,525,1576,152,304,2557
YARUMAL,2021,1,ANTIOQUIA,2610,6249,5314,294,1,3,14471,544,1612,152,304,2612
YARUMAL,2021,10,ANTIOQUIA,2684,6420,5428,299,0,2,14833,570,1638,153,305,2666
YARUMAL,2021,11,ANTIOQUIA,2693,6432,5430,300,0,2,14857,572,1637,153,305,2667
YARUMAL,2021,12,ANTIOQUIA,2707,6465,5444,301,0,2,14919,576,1644,153,305,2678
YARUMAL,2021,2,ANTIOQUIA,2611,6258,5336,295,0,3,14503,543,1612,152,304,2611
YARUMAL,2021,3,ANTIOQUIA,2627,6275,5351,296,0,3,14552,549,1616,152,304,2621
YARUMAL,2021,4,ANTIOQUIA,2632,6289,5358,293,0,3,14575,552,1621,152,304,2629
YARUMAL,2021,5,ANTIOQUIA,2642,6311,5377,292,0,3,14625,556,1629,152,301,2638
YARUMAL,2021,6,ANTIOQUIA,2643,6310,5381,291,0,3,14628,553,1629,152,304,2638
YARUMAL,2021,7,ANTIOQUIA,2649,6357,5408,294,0,3,14711,554,1631,151,304,2640
YARUMAL,2021,8,ANTIOQUIA,2661,6385,5415,294,0,2,14757,559,1634,151,302,2646
YARUMAL,2021,9,ANTIOQUIA,2667,6403,5415,297,0,2,14784,566,1637,152,304,2659
YARUMAL,2022,1,ANTIOQUIA,2710,6475,5445,301,0,2,14933,575,1646,153,305,2679
YARUMAL,2022,10,ANTIOQUIA,2823,7044,5588,316,0,2,15773,622,1736,158,305,2821
YARUMAL,2022,11,ANTIOQUIA,2826,7049,5592,313,0,2,15782,623,1739,158,305,2825
YARUMAL,2022,12,ANTIOQUIA,2831,7079,5596,311,0,2,15819,623,1740,158,305,2826
YARUMAL,2022,2,ANTIOQUIA,2717,6488,5446,297,0,2,14950,579,1644,153,305,2681
YARUMAL,2022,3,ANTIOQUIA,2723,6544,5470,305,0,2,15044,583,1647,153,305,2688
YARUMAL,2022,4,ANTIOQUIA,2730,6559,5472,306,0,2,15069,588,1698,153,305,2744
YARUMAL,2022,5,ANTIOQUIA,2731,6802,5492,306,0,2,15333,605,1725,159,305,2794
YARUMAL,2022,6,ANTIOQUIA,2800,7011,5561,307,0,2,15681,611,1730,159,305,2805
YARUMAL,2022,7,ANTIOQUIA,2795,7015,5567,307,0,2,15686,617,1729,158,305,2809
YARUMAL,2022,8,ANTIOQUIA,2811,7028,5576,307,0,2,15724,618,1732,158,305,2813
YARUMAL,2022,9,ANTIOQUIA,2818,7039,5580,313,0,2,15752,620,1735,158,305,2818
YARUMAL,2023,1,ANTIOQUIA,2833,7099,5596,327,0,2,15857,623,1741,158,305,2827
YARUMAL,2023,2,ANTIOQUIA,2846,7117,5604,327,0,2,15896,625,1738,158,305,2826
YARUMAL,2023,3,ANTIOQUIA,2851,7177,5617,329,0,2,15976,627,1740,158,305,2830
YARUMAL,2023,4,ANTIOQUIA,2852,7186,5635,308,0,2,15983,630,1738,159,305,2832
YARUMAL,2023,5,ANTIOQUIA,2861,7195,5637,307,0,2,16002,629,1738,159,305,2831
YARUMAL,2023,6,ANTIOQUIA,2865,7194,5640,308,0,2,16009,634,1735,159,305,2833
YARUMAL,2023,7,ANTIOQUIA,2864,7198,5624,309,0,2,15997,635,1733,159,305,2832
YARUMAL,2023,8,ANTIOQUIA,2870,7204,5633,308,0,2,16017,640,1734,159,305,2838
YARUMAL,2023,9,ANTIOQUIA,2865,7216,5634,306,0,2,16023,638,1733,159,305,2835
YOLOMBO,2018,1,ANTIOQUIA,2587,3760,858,35,4,2,7246,100,396,115,14,625
YOLOMBO,2018,10,ANTIOQUIA,2623,3846,866,31,4,2,7372,99,397,113,14,623
YOLOMBO,2018,11,ANTIOQUIA,2632,3851,864,31,4,2,7384,99,399,113,14,625
YOLOMBO,2018,12,ANTIOQUIA,2632,3865,865,31,4,2,7399,99,399,113,14,625
YOLOMBO,2018,2,ANTIOQUIA,2591,3764,858,36,4,2,7255,99,397,117,14,627
YOLOMBO,2018,3,ANTIOQUIA,2587,3768,856,35,4,2,7252,100,397,116,14,627
YOLOMBO,2018,4,ANTIOQUIA,2598,3779,858,36,4,2,7277,99,401,117,14,631
YOLOMBO,2018,5,ANTIOQUIA,2593,3773,858,34,4,2,7264,99,396,116,14,625
YOLOMBO,2018,6,ANTIOQUIA,2595,3787,869,34,4,2,7291,99,397,114,14,624
YOLOMBO,2018,7,ANTIOQUIA,2608,3794,867,34,4,2,7309,100,399,114,14,627
YOLOMBO,2018,8,ANTIOQUIA,2618,3824,862,32,4,2,7342,99,400,114,14,627
YOLOMBO,2018,9,ANTIOQUIA,2617,3834,865,32,4,2,7354,98,397,114,14,623
YOLOMBO,2019,1,ANTIOQUIA,2660,3867,869,31,4,2,7433,99,393,113,14,619
YOLOMBO,2019,10,ANTIOQUIA,2758,3931,869,35,3,2,7598,103,383,114,13,613
YOLOMBO,2019,11,ANTIOQUIA,2764,3937,870,35,3,2,7611,103,386,115,13,617
YOLOMBO,2019,12,ANTIOQUIA,2766,3954,867,35,3,2,7627,104,384,115,13,616
YOLOMBO,2019,2,ANTIOQUIA,2669,3871,865,31,4,2,7442,101,389,113,13,616
YOLOMBO,2019,3,ANTIOQUIA,2683,3881,869,31,4,2,7470,101,387,113,13,614
YOLOMBO,2019,4,ANTIOQUIA,2683,3890,868,30,4,2,7477,101,383,113,13,610
YOLOMBO,2019,5,ANTIOQUIA,2701,3893,872,30,4,2,7502,102,383,113,13,611
YOLOMBO,2019,6,ANTIOQUIA,2722,3901,868,30,4,2,7527,102,383,113,13,611
YOLOMBO,2019,7,ANTIOQUIA,2729,3910,869,30,4,2,7544,103,383,114,13,613
YOLOMBO,2019,8,ANTIOQUIA,2745,3922,869,30,4,2,7572,104,388,114,13,619
YOLOMBO,2019,9,ANTIOQUIA,2754,3925,868,30,4,2,7583,103,384,114,13,614
YOLOMBO,2020,1,ANTIOQUIA,2769,3950,866,46,3,2,7636,105,384,115,13,617
YOLOMBO,2020,10,ANTIOQUIA,2873,4039,879,42,3,2,7838,109,402,114,154,779
YOLOMBO,2020,11,ANTIOQUIA,2877,4084,846,41,3,2,7853,109,404,114,154,781
YOLOMBO,2020,12,ANTIOQUIA,2892,4097,846,43,3,2,7883,108,404,114,154,780
YOLOMBO,2020,2,ANTIOQUIA,2780,3963,874,51,2,2,7672,107,384,125,154,770
YOLOMBO,2020,3,ANTIOQUIA,2791,3970,874,51,2,2,7690,107,387,125,154,773
YOLOMBO,2020,4,ANTIOQUIA,2800,3986,870,37,3,2,7698,106,398,114,154,772
YOLOMBO,2020,5,ANTIOQUIA,2838,3995,872,38,3,2,7748,110,398,115,154,777
YOLOMBO,2020,6,ANTIOQUIA,2813,3995,871,39,3,2,7723,109,398,114,154,775
YOLOMBO,2020,7,ANTIOQUIA,2828,3999,876,38,3,2,7746,110,398,114,154,776
YOLOMBO,2020,8,ANTIOQUIA,2853,4001,875,39,3,2,7773,109,398,114,154,775
YOLOMBO,2020,9,ANTIOQUIA,2857,4029,878,40,3,2,7809,109,398,114,154,775
YOLOMBO,2021,1,ANTIOQUIA,2901,4107,844,44,3,2,7901,109,405,114,153,781
YOLOMBO,2021,10,ANTIOQUIA,2944,4230,848,40,3,2,8067,109,415,115,155,794
YOLOMBO,2021,11,ANTIOQUIA,2948,4243,847,40,3,2,8083,110,417,116,155,798
YOLOMBO,2021,12,ANTIOQUIA,2951,4261,843,40,3,2,8100,111,418,116,155,800
YOLOMBO,2021,2,ANTIOQUIA,2904,4115,844,44,3,2,7912,110,405,115,154,784
YOLOMBO,2021,3,ANTIOQUIA,2924,4131,846,42,3,2,7948,110,405,115,154,784
YOLOMBO,2021,4,ANTIOQUIA,2937,4150,846,42,3,2,7980,110,405,115,154,784
YOLOMBO,2021,5,ANTIOQUIA,2939,4159,845,44,3,2,7992,110,407,115,154,786
YOLOMBO,2021,6,ANTIOQUIA,2938,4167,844,46,3,2,8000,109,409,114,154,786
YOLOMBO,2021,7,ANTIOQUIA,2943,4199,847,44,3,2,8038,109,410,114,154,787
YOLOMBO,2021,8,ANTIOQUIA,2942,4208,850,42,3,2,8047,111,413,115,155,794
YOLOMBO,2021,9,ANTIOQUIA,2942,4214,852,40,3,2,8053,111,415,115,155,796
YOLOMBO,2022,1,ANTIOQUIA,2958,4282,843,40,3,2,8128,109,422,117,154,802
YOLOMBO,2022,10,ANTIOQUIA,2999,4444,842,40,2,2,8329,118,427,117,153,815
YOLOMBO,2022,11,ANTIOQUIA,3009,4464,845,42,2,2,8364,118,426,118,156,818
YOLOMBO,2022,12,ANTIOQUIA,3008,4465,844,42,2,2,8363,117,426,118,156,817
YOLOMBO,2022,2,ANTIOQUIA,2967,4311,845,41,3,2,8169,109,422,117,154,802
YOLOMBO,2022,3,ANTIOQUIA,2981,4334,845,41,3,2,8206,109,422,118,154,803
YOLOMBO,2022,4,ANTIOQUIA,2988,4355,845,41,2,2,8233,114,422,118,154,808
YOLOMBO,2022,5,ANTIOQUIA,2976,4372,848,41,2,2,8241,118,422,118,155,813
YOLOMBO,2022,6,ANTIOQUIA,2981,4386,849,41,2,2,8261,121,422,118,155,816
YOLOMBO,2022,7,ANTIOQUIA,2983,4388,844,41,2,2,8260,119,423,117,155,814
YOLOMBO,2022,8,ANTIOQUIA,2989,4401,841,41,2,2,8276,119,423,117,155,814
YOLOMBO,2022,9,ANTIOQUIA,2991,4407,845,41,2,2,8288,118,424,118,156,816
YOLOMBO,2023,1,ANTIOQUIA,3014,4486,846,45,2,2,8395,118,427,118,156,819
YOLOMBO,2023,2,ANTIOQUIA,3019,4508,848,45,2,2,8424,120,428,118,156,822
YOLOMBO,2023,3,ANTIOQUIA,3026,4533,850,46,3,2,8460,120,428,118,156,822
YOLOMBO,2023,4,ANTIOQUIA,3030,4548,848,45,3,2,8476,120,428,118,156,822
YOLOMBO,2023,5,ANTIOQUIA,3039,4564,847,46,3,2,8501,120,429,118,156,823
YOLOMBO,2023,6,ANTIOQUIA,3045,4579,845,47,3,2,8521,118,427,118,156,819
YOLOMBO,2023,7,ANTIOQUIA,3052,4596,844,47,3,2,8544,120,427,117,156,820
YOLOMBO,2023,8,ANTIOQUIA,3053,4607,842,48,3,2,8555,120,426,118,156,820
YOLOMBO,2023,9,ANTIOQUIA,3062,4625,839,49,2,2,8579,120,425,117,156,818
YONDO,2018,1,ANTIOQUIA,4449,1438,204,10,2,0,6103,18,252,88,25,383
YONDO,2018,10,ANTIOQUIA,4575,1462,203,13,2,0,6255,20,249,88,26,383
YONDO,2018,11,ANTIOQUIA,4571,1452,201,14,2,0,6240,20,246,88,27,381
YONDO,2018,12,ANTIOQUIA,4726,1464,201,25,2,0,6418,20,247,88,27,382
YONDO,2018,2,ANTIOQUIA,4449,1439,206,10,2,0,6106,18,252,89,25,384
YONDO,2018,3,ANTIOQUIA,4475,1442,204,9,2,0,6132,18,250,88,25,381
YONDO,2018,4,ANTIOQUIA,4527,1455,205,11,2,0,6200,18,250,89,25,382
YONDO,2018,5,ANTIOQUIA,4484,1438,203,8,2,0,6135,18,247,87,26,378
YONDO,2018,6,ANTIOQUIA,4502,1439,203,8,2,0,6154,20,249,88,27,384
YONDO,2018,7,ANTIOQUIA,4515,1449,204,8,2,0,6178,20,249,88,27,384
YONDO,2018,8,ANTIOQUIA,4533,1454,204,9,2,0,6202,20,249,88,27,384
YONDO,2018,9,ANTIOQUIA,4527,1448,201,12,2,0,6190,20,247,88,26,381
YONDO,2019,1,ANTIOQUIA,4740,1461,200,24,2,0,6427,20,245,88,26,379
YONDO,2019,10,ANTIOQUIA,4949,1503,204,13,2,0,6671,22,249,93,25,389
YONDO,2019,11,ANTIOQUIA,4970,1511,207,14,2,0,6704,22,250,94,26,392
YONDO,2019,12,ANTIOQUIA,4985,1515,209,15,2,0,6726,23,250,94,26,393
YONDO,2019,2,ANTIOQUIA,4762,1457,201,16,2,0,6438,20,245,88,26,379
YONDO,2019,3,ANTIOQUIA,4770,1457,201,11,2,0,6441,20,245,88,26,379
YONDO,2019,4,ANTIOQUIA,4785,1467,201,12,2,0,6467,20,247,88,25,380
YONDO,2019,5,ANTIOQUIA,4825,1475,202,12,2,0,6516,20,251,88,25,384
YONDO,2019,6,ANTIOQUIA,4836,1475,202,13,2,0,6528,20,251,90,25,386
YONDO,2019,7,ANTIOQUIA,4847,1485,203,13,2,0,6550,21,250,90,25,386
YONDO,2019,8,ANTIOQUIA,4872,1494,205,13,2,0,6586,21,251,90,25,387
YONDO,2019,9,ANTIOQUIA,4892,1500,205,14,2,0,6613,21,249,90,25,385
YONDO,2020,1,ANTIOQUIA,4982,1511,209,25,2,0,6729,23,248,94,26,391
YONDO,2020,10,ANTIOQUIA,5208,1557,221,16,2,0,7004,29,266,100,168,563
YONDO,2020,11,ANTIOQUIA,5199,1586,221,17,2,0,7025,32,275,101,168,576
YONDO,2020,12,ANTIOQUIA,5204,1588,221,17,2,0,7032,31,276,102,168,577
YONDO,2020,2,ANTIOQUIA,4990,1519,211,22,2,0,6744,29,251,115,168,563
YONDO,2020,3,ANTIOQUIA,4997,1521,211,23,2,0,6754,29,252,116,168,565
YONDO,2020,4,ANTIOQUIA,5007,1525,211,15,2,0,6760,29,270,97,168,564
YONDO,2020,5,ANTIOQUIA,5060,1533,212,15,2,0,6822,31,270,97,168,566
YONDO,2020,6,ANTIOQUIA,5061,1537,218,14,2,0,6832,30,270,97,168,565
YONDO,2020,7,ANTIOQUIA,5076,1549,219,16,2,0,6862,30,271,99,168,568
YONDO,2020,8,ANTIOQUIA,5189,1550,221,16,2,0,6978,28,270,99,168,565
YONDO,2020,9,ANTIOQUIA,5195,1554,221,17,2,0,6989,29,266,99,168,562
YONDO,2021,1,ANTIOQUIA,5213,1595,222,17,2,0,7049,31,276,102,165,574
YONDO,2021,10,ANTIOQUIA,5334,1635,239,25,2,0,7235,35,290,101,164,590
YONDO,2021,11,ANTIOQUIA,5340,1638,240,25,2,0,7245,34,290,101,164,589
YONDO,2021,12,ANTIOQUIA,5356,1643,242,24,2,0,7267,35,289,101,164,589
YONDO,2021,2,ANTIOQUIA,5219,1598,223,18,2,0,7060,32,280,102,165,579
YONDO,2021,3,ANTIOQUIA,5276,1597,223,19,2,0,7117,33,280,101,164,578
YONDO,2021,4,ANTIOQUIA,5297,1606,226,19,2,0,7150,34,282,101,163,580
YONDO,2021,5,ANTIOQUIA,5302,1609,230,20,2,0,7163,34,282,101,159,576
YONDO,2021,6,ANTIOQUIA,5311,1609,233,22,2,0,7177,34,281,101,164,580
YONDO,2021,7,ANTIOQUIA,5319,1612,233,25,2,0,7191,33,282,101,164,580
YONDO,2021,8,ANTIOQUIA,5321,1621,236,25,2,0,7205,33,283,101,164,581
YONDO,2021,9,ANTIOQUIA,5324,1625,238,23,2,0,7212,35,283,101,164,583
YONDO,2022,1,ANTIOQUIA,5363,1649,244,23,2,0,7281,33,291,101,163,588
YONDO,2022,10,ANTIOQUIA,5419,1691,253,20,2,0,7385,29,303,110,164,606
YONDO,2022,11,ANTIOQUIA,5548,1697,253,20,2,0,7520,29,307,110,164,610
YONDO,2022,12,ANTIOQUIA,5531,1692,252,20,2,0,7497,29,308,109,164,610
YONDO,2022,2,ANTIOQUIA,5371,1649,245,23,2,0,7290,33,292,101,163,589
YONDO,2022,3,ANTIOQUIA,5383,1653,245,23,2,0,7306,27,293,107,163,590
YONDO,2022,4,ANTIOQUIA,5389,1657,250,22,2,0,7320,27,294,108,163,592
YONDO,2022,5,ANTIOQUIA,5381,1671,251,21,2,0,7326,26,293,109,163,591
YONDO,2022,6,ANTIOQUIA,5394,1672,250,21,2,0,7339,27,295,109,163,594
YONDO,2022,7,ANTIOQUIA,5398,1674,249,21,2,0,7344,29,295,109,164,597
YONDO,2022,8,ANTIOQUIA,5397,1675,249,21,2,0,7344,29,298,109,164,600
YONDO,2022,9,ANTIOQUIA,5408,1683,251,21,2,0,7365,29,298,109,164,600
YONDO,2023,1,ANTIOQUIA,5543,1697,253,20,2,0,7515,28,309,109,164,610
YONDO,2023,2,ANTIOQUIA,5572,1708,253,20,2,0,7555,28,314,111,164,617
YONDO,2023,3,ANTIOQUIA,5589,1710,252,20,2,0,7573,28,314,112,164,618
YONDO,2023,4,ANTIOQUIA,5589,1710,248,19,2,0,7568,28,315,111,165,619
YONDO,2023,5,ANTIOQUIA,5602,1713,248,19,2,0,7584,30,315,112,165,622
YONDO,2023,6,ANTIOQUIA,5612,1720,247,19,2,0,7600,30,320,112,165,627
YONDO,2023,7,ANTIOQUIA,5594,1720,246,20,2,0,7582,30,319,112,165,626
YONDO,2023,8,ANTIOQUIA,5609,1745,244,21,2,0,7621,30,321,112,165,628
YONDO,2023,9,ANTIOQUIA,5610,1743,241,21,2,0,7617,30,323,112,165,630
ZARAGOZA,2018,1,ANTIOQUIA,5583,1740,24,6,0,0,7353,24,425,81,3,533
ZARAGOZA,2018,10,ANTIOQUIA,5857,1732,23,9,0,0,7621,25,449,82,3,559
ZARAGOZA,2018,11,ANTIOQUIA,5838,1722,23,9,0,0,7592,24,448,82,3,557
ZARAGOZA,2018,12,ANTIOQUIA,5850,1716,23,9,0,0,7598,25,446,82,3,556
ZARAGOZA,2018,2,ANTIOQUIA,5647,1746,24,9,0,0,7426,24,417,81,3,525
ZARAGOZA,2018,3,ANTIOQUIA,5660,1745,23,8,0,0,7436,24,423,81,3,531
ZARAGOZA,2018,4,ANTIOQUIA,5698,1754,23,9,0,0,7484,23,422,82,3,530
ZARAGOZA,2018,5,ANTIOQUIA,5640,1742,23,9,0,0,7414,23,421,80,3,527
ZARAGOZA,2018,6,ANTIOQUIA,5664,1736,23,9,0,0,7432,24,421,82,3,530
ZARAGOZA,2018,7,ANTIOQUIA,5746,1723,23,9,0,0,7501,24,451,82,3,560
ZARAGOZA,2018,8,ANTIOQUIA,5798,1725,23,9,0,0,7555,24,450,82,3,559
ZARAGOZA,2018,9,ANTIOQUIA,5811,1725,23,9,0,0,7568,25,447,82,3,557
ZARAGOZA,2019,1,ANTIOQUIA,5895,1718,23,9,0,0,7645,25,450,83,3,561
ZARAGOZA,2019,10,ANTIOQUIA,6227,1715,24,258,0,0,8224,28,491,84,4,607
ZARAGOZA,2019,11,ANTIOQUIA,6256,1712,24,258,0,0,8250,28,490,84,4,606
ZARAGOZA,2019,12,ANTIOQUIA,6349,1725,24,256,0,0,8354,29,499,83,4,615
ZARAGOZA,2019,2,ANTIOQUIA,5872,1718,23,9,0,0,7622,25,450,82,3,560
ZARAGOZA,2019,3,ANTIOQUIA,5944,1719,23,10,0,0,7696,25,460,83,4,572
ZARAGOZA,2019,4,ANTIOQUIA,5977,1720,23,11,0,0,7731,27,458,83,4,572
ZARAGOZA,2019,5,ANTIOQUIA,6056,1723,23,11,0,0,7813,27,460,83,4,574
ZARAGOZA,2019,6,ANTIOQUIA,6030,1727,23,11,0,0,7791,27,456,83,4,570
ZARAGOZA,2019,7,ANTIOQUIA,6080,1729,22,254,0,0,8085,27,462,83,4,576
ZARAGOZA,2019,8,ANTIOQUIA,6090,1728,22,254,0,0,8094,27,477,83,4,591
ZARAGOZA,2019,9,ANTIOQUIA,6157,1718,24,254,0,0,8153,27,480,83,4,594
ZARAGOZA,2020,1,ANTIOQUIA,6397,1716,24,167,0,0,8304,28,494,83,4,609
ZARAGOZA,2020,10,ANTIOQUIA,6954,1738,23,20,0,0,8735,31,526,88,254,899
ZARAGOZA,2020,11,ANTIOQUIA,6968,1739,23,21,0,0,8751,32,526,88,254,900
ZARAGOZA,2020,12,ANTIOQUIA,6986,1749,23,21,0,0,8779,32,525,88,254,899
ZARAGOZA,2020,2,ANTIOQUIA,6309,1716,24,261,0,0,8310,29,495,85,254,863
ZARAGOZA,2020,3,ANTIOQUIA,6335,1720,24,261,0,0,8340,30,498,85,254,867
ZARAGOZA,2020,4,ANTIOQUIA,6595,1722,24,12,0,0,8353,29,501,83,254,867
ZARAGOZA,2020,5,ANTIOQUIA,6825,1737,24,12,0,0,8598,31,507,83,254,875
ZARAGOZA,2020,6,ANTIOQUIA,6833,1738,24,16,0,0,8611,31,508,87,254,880
ZARAGOZA,2020,7,ANTIOQUIA,6873,1741,24,19,0,0,8657,31,506,87,254,878
ZARAGOZA,2020,8,ANTIOQUIA,6923,1747,24,19,0,0,8713,31,508,88,254,881
ZARAGOZA,2020,9,ANTIOQUIA,6946,1743,23,18,0,0,8730,31,525,88,254,898
ZARAGOZA,2021,1,ANTIOQUIA,6999,1752,23,23,0,0,8797,32,527,88,254,901
ZARAGOZA,2021,10,ANTIOQUIA,7333,1764,24,26,0,0,9147,31,562,89,254,936
ZARAGOZA,2021,11,ANTIOQUIA,7347,1769,24,25,0,0,9165,31,565,90,254,940
ZARAGOZA,2021,12,ANTIOQUIA,7397,1777,24,24,0,0,9222,31,571,90,254,946
ZARAGOZA,2021,2,ANTIOQUIA,7028,1755,23,22,0,0,8828,32,530,88,254,904
ZARAGOZA,2021,3,ANTIOQUIA,7152,1761,23,30,0,0,8966,32,534,89,254,909
ZARAGOZA,2021,4,ANTIOQUIA,7204,1767,23,29,0,0,9023,32,540,89,253,914
ZARAGOZA,2021,5,ANTIOQUIA,7211,1770,23,47,0,0,9051,32,540,89,252,913
ZARAGOZA,2021,6,ANTIOQUIA,7249,1770,23,42,0,0,9084,32,542,89,253,916
ZARAGOZA,2021,7,ANTIOQUIA,7270,1774,23,27,0,0,9094,32,544,88,253,917
ZARAGOZA,2021,8,ANTIOQUIA,7293,1767,23,26,0,0,9109,32,546,89,252,919
ZARAGOZA,2021,9,ANTIOQUIA,7305,1760,24,26,0,0,9115,31,558,89,254,932
ZARAGOZA,2022,1,ANTIOQUIA,7431,1777,24,28,0,0,9260,31,573,90,254,948
ZARAGOZA,2022,10,ANTIOQUIA,7648,1808,24,24,0,0,9504,31,598,94,253,976
ZARAGOZA,2022,11,ANTIOQUIA,7684,1810,24,23,0,0,9541,31,602,94,253,980
ZARAGOZA,2022,12,ANTIOQUIA,7716,1811,24,24,0,0,9575,32,601,94,253,980
ZARAGOZA,2022,2,ANTIOQUIA,7469,1780,25,30,0,0,9304,32,576,90,254,952
ZARAGOZA,2022,3,ANTIOQUIA,7488,1786,25,34,0,0,9333,30,580,91,253,954
ZARAGOZA,2022,4,ANTIOQUIA,7515,1787,25,31,0,0,9358,30,580,91,253,954
ZARAGOZA,2022,5,ANTIOQUIA,7521,1792,24,31,0,0,9368,31,585,91,253,960
ZARAGOZA,2022,6,ANTIOQUIA,7560,1791,24,31,0,0,9406,30,588,91,253,962
ZARAGOZA,2022,7,ANTIOQUIA,7567,1792,24,28,0,0,9411,31,585,92,252,960
ZARAGOZA,2022,8,ANTIOQUIA,7584,1790,24,27,0,0,9425,31,588,93,252,964
ZARAGOZA,2022,9,ANTIOQUIA,7628,1798,24,24,0,0,9474,32,592,94,253,971
ZARAGOZA,2023,1,ANTIOQUIA,7746,1814,24,24,0,0,9608,32,600,94,253,979
ZARAGOZA,2023,2,ANTIOQUIA,7769,1817,25,24,0,0,9635,32,600,94,253,979
ZARAGOZA,2023,3,ANTIOQUIA,7777,1817,25,23,0,0,9642,32,600,94,253,979
ZARAGOZA,2023,4,ANTIOQUIA,7780,1817,25,26,0,0,9648,32,600,94,253,979
ZARAGOZA,2023,5,ANTIOQUIA,7678,1809,25,24,0,0,9536,30,596,94,253,973
ZARAGOZA,2023,6,ANTIOQUIA,7620,1787,26,24,0,0,9457,29,588,94,254,965
ZARAGOZA,2023,7,ANTIOQUIA,7673,1789,25,24,0,0,9511,29,590,94,254,967
ZARAGOZA,2023,8,ANTIOQUIA,7659,1793,24,26,0,0,9502,29,594,95,254,972
ZARAGOZA,2023,9,ANTIOQUIA,7668,1794,24,131,0,0,9617,29,596,95,257,977
